Application ID,Loan No.,Repaid Date,Mpesa Code,Amount,Balance
D1001,1,,,,"9300"
D1001,1,07/15/2020,OGF2S40I0C,300.00,"9000"
D1001,1,07/16/2020,OGG4T3LG0K,380.00,"8620"
D1001,1,07/17/2020,OGH2TZ0OOK,340.00,"8280"
D1001,1,07/18/2020,OGI7V0FQ73,340.00,"7940"
D1001,1,07/19/2020,OGJ5VTK04B,340.00,"7600"
D1001,1,07/21/2020,OGL2WZDOH6,340.00,"7260"
D1001,1,07/22/2020,OGM3XTLQP9,340.00,"6920"
D1001,1,07/22/2020,OGM9YE0FVZ,340.00,"6580"
D1001,1,07/24/2020,OGOZQCUU6,340.00,"6240"
D1001,1,07/27/2020,OGR83SVNS0,900.00,"5340"
D1001,1,07/29/2020,OGT75C806V,600.00,"4740"
D1001,1,07/31/2020,OGV77ARDWX,650.00,"4090"
D1001,1,08/02/2020,OH28A95GK8,740.00,"3350"
D1001,1,08/07/2020,OH74ENONJ6,"3350.00",0
D1001,2,08/11/2020,OHB2IKLZPH2,310.00,"8790"
D1001,2,08/17/2020,OHH5P4F5FB,320.00,"8470"
D1001,2,08/18/2020,OHJ0QWQ7XQ,340.00,"8130"
D1001,2,08/21/2020,OHL5SW4Y61,800.00,"7330"
D1001,2,09/02/2020,OI2969D62X,"7330.00",0
D1001,3,09/10/2020,OIA6EZG7T0,"2275.00","6265"
D1001,3,09/17/2020,OIH2MM2X08,"2275.00","3990"
D1001,3,09/23/2020,OIN9SLUZMX,"3990.00",0
D1001,4,10/02/2020,OJ233QDV0F,"2275.00","6225"
D1001,4,10/14/2020,OJE7HLDPWT,"6225.00",0
D1001,5,11/04/2020,OK405ZBQZS,"8610.00",0
D1001,6,11/28/2020,OKS3Z1PQB5,977.00,"10083"
D1001,6,12/08/2020,OL89CHTZWJ,"1000.00","9083"
D1001,6,12/09/2020,OL90DBT6DI,"1000.00","8083"
D1001,6,12/16/2020,OLG0LRZZ16,"1500.00","6583"
D1001,6,12/19/2020,OLJ2PM1YKK,"2000.00","4583"
D1001,6,12/22/2020,OLM2TFEYRS,"2000.00","2583"
D1001,6,12/23/2020,0LN3VNU2YD,"2580.00",3
D1001,6,12/24/2020,OL07WFFZ7D,3.00,0
D1001,7,04/05/2021,PD59HZDFMR,"2000","7100"
D1001,7,04/13/2021,PDD9RP2FXH,"1000","6100"
D1001,7,04/19/2021,PDJ1ZEWXHZ,"1400","4700"
D1001,7,04/21/2021,PDL02SYJK2,500,"4200"
D1001,7,4/26/2021,PDQ298WAKI,"1600","2600"
D1001,7,4/26/2021,PDQ69LIYYU,"2600",0
D1001,8,05/07/2021,PE71O105GP,870,"8650"
D1001,8,05/10/2021,PEA9T36DVH,"1400","7250"
D1001,8,05/19/2021,PEJ94O6VDB,"1000","6250"
D1001,8,05/25/2021,PEP2CN0MHI,"6250",0
D1001,9,06/07/2021,PF76TV8EV8,"1250","8270"
D1001,9,06/12/2021,PFC71PMW4D,"1000","7270"
D1001,9,06/23/2021,PFN4GZLXMC,"7270",0
D1001,10,07/07/2021,PG721Y4X46,100,"9420"
D1001,10,07/11/2021,PGB48GMWU6,"1100","8320"
D1001,10,07/22/2021,PGM9NV86ZL,"8320",0
D1001,11,03/17/2022,QCH0T2VFGC,217,"7683"
D1001,11,03/18/2022,QCI1W7XBW1,434,"7249"
D1001,11,03/22/2022,QCM24EFAQI,100,"7149"
D1001,11,03/22/2022,QCM34EJSMB,100,"7049"
D1001,11,03/22/2022,QCM04ENSB0,100,"6949"
D1001,11,03/24/2022,QCO686NEM8,400.00,"6549"
D1001,11,03/25/2022,QCP296SC9S,217.00,"6332"
D1001,11,03/28/2022,QCS1ECUEJH,100.00,"6232"
D1001,11,03/28/2022,QCS2ECXNC8,100.00,"6132"
D1001,11,03/28/2022,QCS4ED6NYO,100.00,"6032"
D1001,11,03/29/2022,QCT1GGGEQ3,100.00,"5932"
D1001,11,03/29/2022,QCT2GGKCLC,100.00,"5832"
D1001,11,03/29/2022,QCT1GGP3NN,100.00,"5732"
D1001,11,03/29/2022,QCT8HAJQC4,100.00,"5632"
D1001,11,03/29/2022,QCT3HB8P8J,70.00,"5562"
D1001,11,04/14/2022,QDE7CPCUUX,200.00,"5362"
D1001,11,04/15/2022,QDF3F625AF,470.00,"4892"
D1001,11,04/19/2022,QDJ1LVDXKN,217.00,"4675"
D1001,11,04/21/2022,QDL9R1VN07,300.00,"4375"
D1001,11,04/26/2022,QDQ31JL0OD,500.00,"3875"
D1001,11,04/27/2022,QDS23K7HMS,200.00,"3675"
D1001,11,04/29/2022,QDT972KNWF,200.00,"3475"
D1001,11,05/04/2022,QE49GLJJ13,500.00,"2975"
D1001,11,05/06/2022,QE68IYG8TI,100.00,"2875"
D1001,11,05/06/2022,QE69IYL0MJ,100.00,"2775"
D1001,11,05/08/2022,QE83NZ72X3,500.00,"2275"
D1001,11,05/09/2022,QE91QB54WN,700.00,"1575"
D1001,11,05/12/2022,QEC0WD0AZA,475.00,"1100"
D1002,1,07/17/2020,OGH9TUUWCV,"1500.00","9700"
D1002,1,07/19/2020,OGJ7VNCKIX,"1500.00","8200"
D1002,1,07/20/2020,OGK9WR4STJ,"1000.00","7200"
D1002,1,07/21/2020,OGL4XP40HA,700.00,"6500"
D1002,1,07/22/2020,OGM2YL1240,"1000.00","5500"
D1002,1,07/23/2020,OGN5ZJTYO9,"1000.00","4500"
D1002,1,07/26/2020,OGQ73DRA4F,"2000.00","2500"
D1002,1,07/27/2020,OGR74AW2NB,"1000.00","1500"
D1002,1,07/28/2020,OGS84UJ8YS,"1500.00",0
D1002,2,07/30/2020,OGU677GTEI,"1000.00","10200"
D1002,2,08/02/2020,OH20A4P740,"1500.00","8700"
D1002,2,08/04/2020,OH40C7T4KI,"1000.00","7700"
D1002,2,08/06/2020,OH68ED0EDE,"1000.00","6700"
D1002,2,08/07/2020,OH71F0N5CB,"6700.00",0
D1002,3,08/17/2020,0HH7P2FM5X,"11200.00",0
D1002,3,,,,
D1002,3,,,,
D1002,3,,,,
D1002,3,,,,
D1002,4,08/28/2020,OHS418BPWW,"11200.00",0
D1002,5,09/08/2020,OI86CU7490,"11200.00",0
D1002,6,09/21/2020,OIL4Q9AI7E,"11400.00",0
D1002,7,10/02/2020,OJ243MVTTA,"11200.00",0
D1002,8,10/13/2020,OJD8GH0Q0Y,"11200.00",0
D1002,9,10/24/2020,OJO5T576IZ,"5700.00","7980"
D1002,9,10/27/2020,OJQ1URK7D9,"7980.00",0
D1002,10,11/06/2020,OK658L5GBT,"13440.00",
D1002,11,11/17/2020,OKH2LDHC04,"13440.00",
D1002,12,11/30/2020,OKU21XN4KG,"13680.00",
D1002,13,12/11/2020,OLB0FPYYZM,"13440.00",
D1002,14,12/22/2020,OLM7TQDZ3V,"13440.00",
D1002,15,01/04/2021,PA48AHAGSC,"13680.00",
D1002,16,01/15/2021,PAF4N2JDGG,"16800.00",
D1002,17,01/26/2021,PAQ4ZVA78S,"16800.00",
D1002,18,02/06/2021,PB60E4Q8F8,"16800.00",
D1002,19,02/18/2021,PBI6SODZ5G,"16950.00",0
D1002,20,03/02/2021,PC218OQV93,"19210.00",0
D1002,21,03/15/2021,PCF3PIQ469,"20520.00",0
D1002,22,03/27/2021,PCR75PU66Z,"22600.00",0
D1002,23,04/08/2021,PD82LGQAJA,"22600.00",0
D1002,24,04/20/2021,PDK6Y4B0G,"22600.00",0
D1002,25,06/03/2021,PF31P9TOP9,"1000.00","32180"
D1002,25,06/08/2021,PF88VKWYQU,"1000.00","31180"
D1002,25,06/09/2021,PF98X6EGKO,"1000.00","30180"
D1002,25,06/10/2021,PFB8ZS67ZW,1000,"29180"
D1002,25,06/14/2021,PFE94QY8DT,1000,"28180"
D1002,25,06/17/2021,PFH68TDDSA,1000,"27180"
D1002,25,06/22/2021,PFM8FHTYBM,1000,"26180"
D1002,25,06/26/2021,PFQ9LGI4J1,300,"25880"
D1002,25,07/07/2021,PG7723BLRX,1000,"24880"
D1002,25,07/14/2021,PGE4BJJXFC,1000,"23880"
D1002,25,07/22/2021,PGM6N5M1K0,500,"23380"
D1002,25,09/15/2021,PIF3XFFIBV,100,"23280"
D1002,25,09/15/2021,PIF3XH9U0T,100,"23180"
D1002,25,09/22/2021,PIM98VTWIL,200,"22980"
D1002,25,10/01/2021,PJ12MXERL0,150,"22830"
D1002,25,10/01/2021,PJ10MYMPSO,50,"22780"
D1002,25,10/05/2021,PJ56SUI5JQ,100,"22680"
D1002,25,10/28/2021,PJS7U3B6QL,220,"22460"
D1002,25,11/11/2021,PKB9IFG4HT,250,"22210"
D1002,25,11/17/2021,PKH4S06VIQ,250,"21960"
D1002,25,11/23/2021,PKN030KKJ8,250,"21710"
D1002,25,11/24/2021,PKO84VC2O0,200,"21510"
D1002,25,11/26/2021,PKQ57TFAGD,100,"21410"
D1002,25,11/26/2021,PKQ281M574,100,"21310"
D1002,25,12/01/2021,PL19GJUWTN,200,"21110"
D1002,25,12/07/2021,PL79R8620L,150,"20960"
D1002,25,12/10/2021,PLA5WEUAQD,150,"20810"
D1002,25,12/23/2021,PLN1JZOGK7,150,"20660"
D1002,25,12/24/2021,PLO7M2Q6FB,100,"20560"
D1002,25,01/25/2022,QAP34Q2SFX,200,"20360"
D1002,25,02/03/2022,QB30KCOF18,200,"20160"
D1002,25,02/22/2022,QBM1K2ZNXD,150,"20010"
D1002,25,03/03/2022,QC483WS4B0,200,"19810"
D1002,25,03/18/2022,QCI8V31EGI,200,"19610"
D1002,25,03/17/2023,RCH914CNHH,250,"19360"
D1002,25,06/15/2023,RFF53XSUWJ,200,"19160"
D1002,25,06/29/2023,RFT391MF65,200,"18960"
D1003,1,08/03/2020,OH30AT0L8M,"22800.00",0
D1003,2,08/14/2020,OHE2M5O53S,"22400.00",0
D1003,3,08/28/2020,OHS714BMXV,"22800.00",0
D1003,4,09/10/2020,OIA9F0BIYL,"22800.00",0
D1003,5,09/24/2020,OIO7UC6J6T,"23000.00",0
D1003,6,10/07/2020,OJ79A8JMWX,"22800.00",0
D1003,7,10/21/2020,OJL0PQZYW8,"22800.00",0
D1003,8,11/04/2020,OK486PWL4A,"22800.00",0
D1003,9,11/18/2020,OKI5N67TF5,"22800.00",0
D1003,10,12/03/2020,OL396BD3IX,"34500.00",0
D1003,11,12/17/2020,OLH3O1AELX,"34200.00",0
D1003,12,01/02/2020,PA2681BTJS,"34500.00",0
D1003,13,01/14/2021,PAE1MRZNQD,"33900.00",0
D1003,14,01/29/2021,PAT74LQQZZ,"40250.00",0
D1003,15,02/12/2021,PBC9L5XXGL,"40250.00",0
D1003,16,02/26/2021,PBQ147RMOR,"46000.00",0
D1003,17,12/28/2021,PLS3T5J5HX,"56000.00",0
D1003,18,02/28/2022,QBS8UF9EJG,"58000.00",500
D1003,18,02/28/2022,QBS7UOA9GX,500.00,0
D1003,19,04/09/2022,QD9953WDRT,"56500.00",0
D1003,20,05/06/2022,QE60J8T0EU,"5000.00","60000"
D1003,20,05/25/2022,QEP1KG6C7P,"2000.00","58000"
D1003,20,05/26/2022,QEQ2MB5P3G,"2000.00","56000"
D1003,20,05/27/2022,QER0OEW186,2000,"54000"
D1003,20,05/28/2022,QES2QK64HO,2000,"52000"
D1003,20,05/30/2022,QEU7VYOASP,10000,"42000"
D1003,20,06/08/2022,QF81DGML6X,10000,"32000"
D1003,20,06/13/2022,QFD4OKHD7I,2000,"30000"
D1003,20,06/16/2022,QFG5T78KQP,2000,"28000"
D1003,20,06/18/2022,QFI3YRDJSR,2000,"26000"
D1003,20,07/03/2022,QG30T5QESI,5000,"21000"
D1003,20,07/07/2022,QG772U9R13,1000,"20000"
D1003,20,08/01/2022,QH11GEC5SL,5000,"15000"
D1003,20,08/11/2022,QHB01KGYZY,2000,"13000"
D1003,20,08/22/2022,QHM4MHG7A2,13000,0
D1003,21,12/03/2022,QL358Z1QZ5,"56500.00",0
D1003,21,12/16/2022,QLG9CLW5BN,"57000.00",0
D1003,22,12/30/2022,QLU3D6JMYJ,"57000.00",0
D1003,23,01/13/2023,RAD1C6NRDF,"57000.00",0
D1003,24,01/13/2023,RAR5CDHO7R,"57000.00",0
D1003,25,02/10/2023,RBA9DS9V49,"57000.00",0
D1003,26,03/02/2023,RC25V82OV9,"57500.00",0
D1003,27,03/17/2023,RCH9YD1WJF,"57000.00",500
D1003,27,03/17/2023,INTEREST WAIVER,500.00,0
D1003,28,05/11/2023,REB6BTPKRE,"61500.00",0
D1003,29,06/07/2023,RF70I3PT6Y,"63500.00",0
D1003,30,06/26/2023,RFQ929VTY9,"59500.00",0
D1004,1,07/31/2020,OGV17TKKAF,"2000.00","10000"
D1004,1,08/03/2020,OH31B2XAVT,"5000.00","5000"
D1004,1,08/11/2020,OHB9J2S3AH,"5000.00",0
D1004,2,08/25/2020,OHP3XCQCL9,"7000.00","5000"
D1004,2,08/31/2020,OHV84CJGDE,"5000.00",0
D1004,3,09/21/2020,OIL7QZLFZF,"11900.00",0
D1004,4,12/02/2020,OL244H8AS2,"12000.00",0
D1004,5,12/21/2020,OLL7S5F4Z5,"14040.00",0
D1004,6,01/14/2021,PAE8MDSVFE,"15000.00",0
D1004,7,02/08/2021,PB87H7IWFN,"15120.00",0
D1004,8,03/09/2021,PC93HI155H,"19350.00",0
D1004,9,03/29/2021,PCT38DKLAB,"18150.00",0
D1004,10,04/17/2021,PDH0XFIFIQ,"20400.00",0
D1004,11,05/12/2021,PEC7VOGZDD,"18600.00",0
D1004,12,06/03/2021,PF32OFA6OS,"18450.00",150
D1004,13,06/03/2021,PF32OFA6OS_D2,150.00,"25650"
D1004,13,07/01/2021,PG17S06GGL,"25650.00",0
D1004,14,08/24/2021,PHO9Z3LHXF,"1000.00","30600"
D1004,14,08/26/2021,PHQ6413FTE,"1000.00","29600"
D1004,14,08/29/2021,PHT486B58G,"1500.00","28100"
D1004,14,09/01/2021,PI19C165FP,1600,"26500"
D1004,14,10/17/2021,PJH4DZVVQS,1500,"25000"
D1004,14,10/25/2021,PJP8OZFI8I,450,"24550"
D1004,14,10/26/2021,PJQ3RMUJCD,500,"24050"
D1004,14,10/27/2021,PJR9T7RUTR,500,"23550"
D1004,14,10/28/2021,PJS3V25R35,500,"23050"
D1004,14,11/02/2021,PK2231D3AM,700,"22350"
D1004,14,11/17/2021,PKH6S1PSB8,120,"22230"
D1004,14,11/22/2021,PKM81WDQ0Q,1000,"21230"
D1004,14,11/28/2021,PKS7C7LB6P,900,"20330"
D1004,14,12/06/2021,PL65OPJV6F,950,"19380"
D1004,14,12/13/2021,PLD1280Q8H,1700,"17680"
D1004,14,12/27/2021,PLR4QBAB1U,1400,"16280"
D1004,14,01/26/2022,QAQ5607W5P,700,"15580"
D1004,14,02/26/2022,QBQ2R2FY0O,500,"15080"
D1004,14,03/04/2022,QC423W5BN8,200,"14880"
D1004,14,03/14/2022,QCE1NSKYCT,100,"14780"
D1004,14,03/15/2022,QCF7PQS229,300,"14480"
D1004,14,03/25/2022,QCP4903K48,250,"14230"
D1004,14,04/04/2022,QD40S41J12,500,"13730"
D1004,14,08/08/2022,QH83UYDNCL,500,"13230"
D1004,14,08/29/2022,QHT4ZM3BBM,500,"12730"
D1004,14,09/12/2022,QIC6UM958W,3000,"9730"
D1004,14,03/27/2023,RCR3PQ405N,700,"9030"
D1004,14,08/14/2023,RHE04FR7A2,2000,"7030"
D1005,1,07/30/2020,OGU8775LO4,700.00,"3020"
D1005,1,07/31/2020,OGV37T7END,100.00,"2920"
D1005,1,08/03/2020,OH39AJ5IST,125.00,"2795"
D1005,1,08/03/2020,OH31AJKP39,50.00,"2745"
D1005,1,08/06/2020,OH67DFA1Z3,975.00,"1770"
D1005,1,08/12/2020,OHC5KJEBA1,850.00,920
D1005,1,08/15/2020,OHF9N1HYEF,920.00,0
D1005,2,08/23/2020,OHN4VMPABK,900.00,"2940"
D1005,2,08/26/2020,OHQ5Y2ISMV,73.00,"2867"
D1005,2,09/03/2020,OI397QHWJN,977.00,"1890"
D1005,2,09/07/2020,OI71BLN2RR,975.00,915
D1005,2,09/10/2020,OIA3EQC9UH,915.00,0
D1005,3,09/14/2020,OIE4JEASOO,900.00,"2730"
D1005,3,09/18/2020,OII5N53EUP,75.00,"2655"
D1005,3,09/25/2020,OIP0UO574K,975.00,"1680"
D1005,3,09/30/2020,OIU217W8WW,"1680.00",0
D1005,4,10/08/2020,OJ82AXPG12,975.00,"2685"
D1005,4,10/17/2020,OJH7KI1F71,975.00,"1710"
D1005,4,10/21/2020,0JL9P93WYB,"1710.00",0
D1005,5,10/30/2020,OJU1ZGNQFB,975.00,"2625"
D1005,5,11/07/2020,OK76A5CVKS,875.00,"1750"
D1005,5,11/07/2020,OK77ABN765,10.00,"1740"
D1005,5,11/07/2020,OK80BCZPQ6,90.00,"1650"
D1005,5,11/09/2020,OK90BUSAY2,"1650.00",0
D1005,6,11/18/2020,OKI9MKCXRP,900.00,"3000"
D1005,6,11/24/2020,OKO3TUMYGR,975.00,"2025"
D1005,6,12/07/2020,OL71AHUJYB,975.00,"1050"
D1005,6,12/07/2020,OL73AW83L9,975.00,75
D1005,6,12/07/2020,OL78AWBR8K,50.00,25
D1005,6,12/07/2020,OL74AX6P50,25.00,0
D1005,7,12/14/2020,OLE5JS75UV,800.00,"3100"
D1005,7,12/26/2020,OLQ7ZJ8GQN,975.00,"2125"
D1005,7,01/01/2021,PA196QUOMB,975.00,"1150"
D1005,7,01/04/2021,PA40APAZG4,"1150.00",0
D1005,8,01/17/2021,PAH0PBE8VG,975.00,"2925"
D1005,8,01/23/2021,PAN8X3B9U2,975.00,"1950"
D1005,8,01/31/2021,PAV1765887,"2000.00",50
D1005,9,02/17/2021,PBH9RAWQ5T,975.00,"2925"
D1005,9,02/17/2021,PBH1RAUJC3,975.00,"1950"
D1005,9,02/21/2021,PBL1WYNMEV,975.00,975
D1005,9,02/21/2021,PBL3WYT91X,975.00,0
D1005,10,03/06/2021,PC69EA6HQL,975.00,"2925"
D1005,10,03/14/2021,PCE2OMUUWE,975.00,"1950"
D1005,10,03/20/2021,PCK5WABFHP,"1100.00",850
D1005,10,03/21/2021,PCL0XGN2XS,500.00,350
D1005,10,03/22/2021,PCL7XTL4BT,400.00,50
D1005,11,04/05/2021,PD57I0ZLIF,600.00,"4930"
D1005,11,04/05/2021,PD59I19W13,490.00,"4440"
D1005,11,04/21/2021,PDL82PZ98O,480.00,"3960"
D1005,11,04/24/2021,PDO37KLDJD,500.00,"3460"
D1005,11,05/02/2021,PE22HT5ARE,400.00,"3060"
D1005,11,05/15/2021,PEF6YRXSEK,450.00,"2610"
D1005,11,05/15/2021,PEK569RXGJ,800,"1810"
D1005,11,05/27/2021,PER2FZXIRE,500,"1310"
D1005,11,05/29/2021,PET1IHQH9T,330,980
D1006,1,,,,
D1006,2,08/17/2020,OHH4PDLFG4,"1675.00","4425"
D1006,2,08/24/2020,OHO8WHQS8W,"1675.00","2750"
D1006,2,08/31/2020,OHV745X7G7,"2750.00",0
D1006,3,09/07/2020,OI76BZQ5H2,"1625.00","4225"
D1006,3,09/13/2020,OID4IL99XO,800.00,"3425"
D1006,3,09/14/2020,OIE8JE73N2,825.00,"2600"
D1006,3,09/16/2020,OIG5LJEU8N,"2600.00",0
D1006,4,09/23/2020,OIN7T25X3Z,"1625.00","4175"
D1006,4,09/30/2020,OIU21XA1KW,"1625.00","2550"
D1006,4,10/01/2020,0J172JWEGT,"2550.00",0
D1006,5,10/08/2020,OJ83ASBT8R,"1625.00","4425"
D1006,5,10/15/2020,OJF0IQ7V3U,"2025.00","2400"
D1006,5,10/19/2020,OJJ6N38K4I,"2400.00",0
D1006,6,10/26/2020,OJQ3V1THJB,"2000.00","5020"
D1006,6,11/02/2020,OK22451I3G,"2500.00","2520"
D1006,6,11/04/2020,OK4468BXNI,"2520.00",0
D1006,7,11/12/2020,OKC4FHV36M,"1950.00","5010"
D1006,7,11/19/2020,OKJ4NMBL2A,"5010.00",0
D1006,8,11/26/2020,OKQ8WIP5J4,"1700.00","5380"
D1006,8,12/03/2020,OL395ZRL4H,"1800.00","3580"
D1006,8,12/05/2020,OL5982VUNZ,"3580.00",0
D1006,9,12/15/2020,OLF2LCPM6G,800.00,"7360"
D1006,9,01/04/2021,PA44AC3MK2,"7360.00",0
D1006,10,02/01/2021,PB107ZQT3A,"7800.00",0
D1006,11,03/02/2021,PC288BIXV2,"8160.00",0
D1006,12,03/31/2021,PCV7B09ZAR,"9520.00",0
D1006,13,05/04/2021,PE40JRXOAC,"1000.00","9220"
D1006,13,05/07/2021,PE74OM30SW,"9220.00",0
D1006,14,06/08/2021,PF86VDIO00,"9520.00",0
D1006,15,06/23/2021,PFN8GRY7L8,"8190.00",0
D1006,16,07/21/2021,PGL0LMAKFM,"10400.00",0
D1006,17,08/17/2021,PHH9PHWAE1,"10320.00",0
D1006,18,09/13/2021,PID0U6QPAS,"10320.00",0
D1006,19,10/12/2021,PJC35JOTH9,"10880.00",0
D1006,20,01/29/2022,QAT0BCAJ76,540.00,"5300"
D1006,20,02/22/2022,QBM4KFA0EU,"2040.00","3260"
D1006,20,02/28/2022,QBS2V65I5M,3260,0
D1006,21,03/05/2022,QC537KFWOP,400.00,"4800"
D1006,21,03/09/2022,QC98DJR8JM,560.00,"4240"
D1006,21,03/10/2022,QCA2H7KYO0,500,"3740"
D1006,21,03/25/2022,QCP994S1PH,500,"3240"
D1006,21,03/28/2022,QCS0ETWL1I,3240,0
D1006,22,04/21/2022,QDL4PPCKTS,"5080.00",0
D1006,23,05/17/2022,QEH966CZOV,"5160.00",0
D1006,24,06/13/2022,QFD7NV04J5,"6500.00",0
D1006,25,07/11/2022,QGB9A5EWT9,"6500.00",0
D1006,26,08/08/2022,QH88VO89NS,"6500.00",0
D1006,27,09/05/2022,QI56FFCTFU,"6500.00",0
D1006,28,10/02/2022,QJ254QRCWT,"5500.00","1000"
D1006,28,10/03/2022,QJ345O8BAQ,"1000.00",0
D1006,29,11/01/2022,QK161DGPR4,"8160.00",0
D1006,30,11/29/2022,QKT2VSDSJ8,"7800.00",0
D1006,31,12/29/2022,QLT693CDJA,"5000.00","3160"
D1006,31,12/29/2022,QLT493HBFO,"2000.00","1160"
D1006,31,12/29/2022,QLT593M5SN,1160,0
D1006,32,01/27/2023,RAR6AK3WBA,"8160.00",0
D1006,33,02/27/2023,RBR0L9OA0Q,"6160.00","2000"
D1006,33,02/27/2023,RBR8L9TYQO,"2000.00",0
D1006,34,03/24/2023,RCO1ITN9H5,"7620.00",0
D1006,35,04/21/2023,RDL1Q9Y8L3,"7800.00",0
D1006,36,05/16/2023,REG1PRSF5B,"7560.00",0
D1006,37,06/15/2023,RFF84X5XBW,"2500.00","5660"
D1006,37,06/16/2023,RFG77Y4VWT,"1500.00","4160"
D1006,37,06/17/2023,RFH29Z0IAK,4180,20
D1006,38,07/20/2023,RGK6ZKGABO,"8180.00",20
D1007,1,07/31/2020,OGV27W5JFE,"1625.00","4125"
D1007,1,08/07/2020,,"4125.00",0
D1007,2,08/14/2020,OHE5M2BYM9,"1625.00","4275"
D1007,2,08/21/2020,OHL7TP9EL9,"1625.00","2650"
D1007,2,08/24/2020,OHO3W8TRRF,"1000.00","1650"
D1007,2,08/24/2020,OHO0W8N55W,"1650.00",0
D1007,3,08/31/2020,OHV34C7IDT,"1625.00","3975"
D1007,3,09/03/2020,OI367E494S,"3975.00",0
D1007,4,09/10/2020,OIA1FAEW9B,"1625.00","4225"
D1007,4,09/17/2020,OIH2MX0M9G,"1400.00","2825"
D1007,4,09/19/2020,OIJ1O8IKNN,"2825.00",0
D1007,5,09/26/2020,OIQ2WKQN3S,600.00,"5300"
D1007,5,09/29/2020,OIT4YS6NNA,"1025.00","4275"
D1007,5,10/05/2020,OJ596UP4S1,"1450.00","2825"
D1007,5,10/06/2020,OJ6688V126,"2825.00",0
D1007,6,10/15/2020,OJF3JA4857,850.00,"5350"
D1007,6,10/29/2020,OJT7Y68MBV,"5350.00",0
D1007,7,11/05/2020,OK597WM1CF,"1000.00","5800"
D1007,7,11/26/2020,OKQ5WNL8VP,"4200.00","1600"
D1007,7,11/27/2020,OKR0WYEPC8,"1600.00",0
D1007,8,12/05/2020,OL597XSM1N,"1000.00","5800"
D1007,8,12/28/2020,OLS3201785,"2900.00","2900"
D1007,8,12/29/2020,OLT935PQUZ,"1800.00","1100"
D1007,8,12/30/2020,OLU14O2TLV,"1100.00",0
D1007,9,01/27/2021,PAR11ZTD35,"6500.00",0
D1007,10,03/01/2021,PC187K5QIW,"6800.00",0
D1007,11,03/16/2021,PCG0QMOOYK,"6960.00",0
D1007,12,04/14/2021,PDE2TCUPQA,"8160.00",0
D1007,13,05/15/2021,PEF4ZA6DZK,"3800.00","4360"
D1007,13,05/17/2021,PEH42PSAJK,"4360.00",0
D1007,14,06/16/2021,PFG57W94GR,"8150.00",10
D1007,14,06/16/2021,PFG17WEK5N,10.00,0
D1007,15,07/15/2021,PGF4DH64A4,"6800.00","1000"
D1007,15,07/15/2021,PGF1DHAF4H,"1000.00",0
D1007,16,08/20/2021,PHK5TMRK4X,"2000.00","8880"
D1007,16,08/24/2021,PHO6Z8F7EC,"8800.00",80
D1007,16,08/24/2021,PHO4Z8J840,80,0
D1007,17,10/16/2021,PJG9BJGON1,950.00,"6950"
D1007,17,10/23/2021,PJN3M9DVHB,500.00,"6450"
D1007,17,10/26/2021,PJQ3QL6O4R,1000,"5450"
D1007,17,11/08/2021,PK83CY2HAN,1050,"4400"
D1007,17,11/09/2021,PK97F76DP1,1000,"3400"
D1007,17,11/10/2021,PKA7GH5I3X,300,"3100"
D1007,17,11/15/2021,PKF7OOJNIT,1050,"2050"
D1007,17,11/17/2021,PKH4RDAU0A,1050,"1000"
D1007,17,11/24/2021,PKO84IGW94,300,700
D1007,17,11/29/2021,PKT2CJ6T24,400,300
D1007,17,12/03/2021,PL33JF4TOH,300,0
D1007,18,12/08/2022,QL83NLVOBX,"1300.00","3660"
D1007,18,12/15/2022,QLF97K1IIP,"1000.00","2660"
D1007,18,12/22/2022,QLM5PWPOTF,1300,"1360"
D1007,18,12/22/2022,QLM4QT64OA,1360,0
D1007,19,01/05/2023,RA50PTQTBA,"1000.00","4080"
D1007,19,01/09/2023,RA94ZZE75I,900.00,"3180"
D1007,19,01/13/2023,RAD3A95OJL,1000,"2180"
D1007,19,01/16/2022,RAG3IPWTMR,2180,0
D1007,20,01/25/2023,RAP25DOSZM,750.00,"4450"
D1007,20,02/01/2023,RB19MUND7T,550.00,"3900"
D1007,20,02/13/2023,RBD2JL9VUW,3900,0
D1007,21,03/07/2023,RC797DR3G3,500.00,"4700"
D1007,21,03/13/2023,RCD5PEL8DJ,"4700.00",0
D1007,22,04/10/2023,RDA5ULCVT7,"5200.00",0
D1007,23,05/08/2023,RE8923S7BN,"5200.00",0
D1007,24,06/05/2023,RF55AGAJHD,"5200.00",0
D1007,25,07/10/2023,RGA86YOIBK,"5440.00",0
D1007,26,08/08/2023,RH88L9PGV6,"5200.00",0
D1008,1,08/04/2020,OH47BHHYOT,"1700.00","4800"
D1008,1,08/12/2020,OHB5JAWD9R,"1000.00","3800"
D1008,1,08/19/2020,OHJ4RIPIEC,"1000.00","2800"
D1008,1,08/25/2020,OHP6X714ZQ,"2800.00",0
D1008,2,09/02/2020,OI236P3D5V,515.00,"6285"
D1008,2,09/24/2020,OIO6TELJ6M,"2944.00","3341"
D1008,2,09/24/2020,OIO4TTD5HQ,"3341.00",0
D1008,3,10/05/2020,OJ556XEIPJ,"1000.00","5500"
D1008,3,10/08/2020,OJ85BAKEFZ,"1500.00","4000"
D1008,3,10/21/2020,0JL4P95VDQ,"4000.00",0
D1008,4,11/02/2020,OK293CLMXD,"1200.00","5300"
D1008,4,11/18/2020,OKI9MGY61Z,"5300.00",0
D1008,5,12/17/2020,OLH3N1L30P,"3981.00","2819"
D1008,5,12/17/2020,OLH8NEYCOQ,"2819.00",0
D1008,6,01/15/2021,PAF5NEXQPT,"6800.00",0
D1008,7,02/11/2021,PBB4K4Z352,"6500.00",0
D1008,8,03/08/2021,PC88GR7NE6,"6400.00",0
D1008,9,05/20/2021,PEK85Y5DWE,300.00,"10760"
D1008,9,07/07/2021,PG732OVJUH,100.00,"10660"
D1009,1,7/29/2020,OGT65GUP4Q,500.00,"2600"
D1009,1,0,,0.00,"2600"
D1009,1,0,0,360.00,"2240"
D1009,1,08/04/2020,OH43BPE84V,"2240.00",0
D1009,2,08/08/2020,OH89FO1B9T,200.00,"5000"
D1009,2,08/11/2020,OHB9IM2GBF,480.00,"4520"
D1009,2,08/12/2020,OHC2JN4PIS,280.00,"4240"
D1009,2,08/13/2020,OHD9KNW4R3,280.00,"3960"
D1009,2,08/19/2020,OHJ8QX1TUY,300.00,"3660"
D1009,2,08/21/2020,OHL2STYWYU,500.00,"3160"
D1009,2,08/27/2020,OHR5YYK6RT,"2000.00","1160"
D1009,2,09/03/2020,OI317G1YV7,"1160.00",0
D1009,3,,,,
D1009,4,,,,
D1010,1,08/06/2020,OH69EAQ9YV,"1300.00","3900"
D1010,1,08/13/2020,OHD3LKI7NJ,"1300.00","2600"
D1010,1,08/20/2020,OHK0SOKFIA,900.00,"1700"
D1010,1,08/27/2020,OHR6ZG1WB6,"1700.00",0
D1010,2,09/04/2020,OI4391KQEN,"1300.00","3820"
D1010,2,09/14/2020,OIE2JP23C6,"1300.00","2520"
D1010,2,09/23/2020,OIN0T98JC8,"2520.00",0
D1010,3,10/02/2020,OJ223S710S,"1300.00","3620"
D1010,3,10/14/2020,OJE7H773LR,"2560.00","1060"
D1010,3,10/17/2020,OJH6KIAX96,100.00,960
D1010,3,10/17/2020,OJH4KIC3OC,60,900
D1010,3,10/17/2020,OJH2KIFH98,900,0
D1010,4,10/30/2020,OJU9Z86695,900.00,"3980"
D1010,4,10/30/2020,OJU3Z892TF,100.00,"3880"
D1010,4,11/07/2020,OK709IAYB8,"3880.00",0
D1010,5,11/30/2020,OKU41D3YGC,975.00,"2925"
D1010,5,12/12/2020,OLC4GRL8I4,975.00,"1950"
D1010,5,12/18/2020,OLI2PAK58O,"1950.00",0
D1010,6,02/06/2021,PB65EHFBHL,"4800.00",0
D1011,1,08/25/2020,OHP5XECJBB,"9450.00",0
D1011,2,09/14/2020,OIE5J45I0J,"9000.00",0
D1011,3,10/07/2020,OJ789RR4V0,"9375.00",0
D1011,4,10/23/2020,OJN9RKBETD,"6000.00","3000"
D1011,4,10/26/2020,OJQ4UG4SAQ,"3000.00",0
D1011,5,11/24/2020,OKO8TNSZO4,"11050.00",0
D1011,6,12/28/2020,OLS820EPRA,"10560.00","1000"
D1011,6,12/28/2020,OLS920KIUT,"1000.00",0
D1011,7,02/06/2021,PB67E4KD5B,"11050.00",0
D1011,8,03/02/2021,PC238O8NAP,"11970.00",0
D1011,9,04/06/2021,PD67IGPO5J,"1000.00","14010"
D1011,9,04/07/2021,PD74JWQDJK,"1500.00","12510"
D1011,9,04/11/2021,PDB3PXVS29,1500,"11010"
D1011,9,04/14/2021,PDE4T91SY8,"2000","9010"
D1011,9,04/18/2021,PDI1YQ9QWT,1000,"8010"
D1011,9,04/21/2021,PDL62N1PPU,1000,"7010"
D1011,9,04/30/2021,PDU4FJGV9O,500,"6510"
D1011,9,05/03/2021,PE39ISRD2B,1000,"5510"
D1011,9,01/03/2022,QA303FIS42,450,"5060"
D1011,9,01/05/2022,QA5961CLVN,1000,"4060"
D1012,1,08/10/2020,OHA2IIR9PA,"1625.00","4575"
D1012,1,08/16/2020,OHG3OFSXDZ,600.00,"3975"
D1012,1,08/18/2020,OHI5QB0RVF,"1025.00","2950"
D1012,1,08/27/2020,OHR4YVP1GM,"2950.00",0
D1012,2,09/03/2020,OI317LHDWB,"1625.00","4375"
D1012,2,09/10/2020,OIA5EYH99R,"1625.00","2750"
D1012,2,09/15/2020,OIF2K23OC6,"2750.00",0
D1012,3,09/22/2020,OIM7RU0JS3,"1625.00","4475"
D1012,3,09/29/2020,OIT7ZJ3LK9,"1625.00","2850"
D1012,3,10/06/2020,OJ6787MP5P,"2850.00",0
D1012,4,10/15/2020,OJF5J185AH,"1000.00","7760"
D1012,4,11/03/2020,OK3454XJIK,"2000.00","5760"
D1012,4,11/04/2020,OK4862MLHA,"1000.00","4760"
D1012,4,11/04/2020,OK4462OASY,1000,"3760"
D1012,4,11/04/2020,OK44636CJS,400,"3360"
D1012,4,11/08/2020,OK88B9QSQI,1000,"2360"
D1012,4,11/11/2020,OKB2EU519I,500,"1860"
D1012,4,11/11/2020,OKB1F0M333,1000,860
D1012,4,11/13/2020,OKD1GSCE47,500,360
D1012,4,11/17/2020,OKH0LCSRO8,360,0
D1012,5,06/16/2021,PFG18EB0P3,"1950.00","5850"
D1012,5,06/23/2021,PFN2HS46RA,"1900.00","3950"
D1012,5,07/01/2021,PG17S4XQO7,"2000.00","1950"
D1012,5,07/07/2021,PG722713PY,1950,0
D1012,6,07/15/2021,PGF8E3PK24,"1900.00","6570"
D1012,6,07/23/2021,PGN2OI9NTO,"2250.00","4320"
D1012,6,07/27/2021,PGR1V5DZRF,"4320.00",0
D1012,7,08/06/2021,PH64AD3C5Q,"2250.00","6360"
D1012,7,08/18/2021,PHI0RB0IP4,"6360.00",0
D1012,8,09/09/2021,PI98OR5YI0,"9300.00",0
D1012,9,10/06/2021,PJ65UWIDYX,"9675.00",0
D1012,10,10/27/2021,PJR6SOVHFG,"12300.00",0
D1012,11,11/15/2021,PKF6P0AW8G,"12200.00",0
D1012,15,12/02/2021,PL20IKE6R0,"12000.00","1000"
D1012,16,12/24/2021,PLO2LQ2BR0,"12400.00",0
D1013,1,08/11/2020,OHB8J6D9EW,"3250.00","9650"
D1013,1,08/18/2020,OHI8PR3A3A,"3250.00","6400"
D1013,1,08/25/2020,OHP7XBICRV,"1000.00","5400"
D1013,1,08/26/2020,OHQ1YEZ477,"2250.00","3150"
D1013,1,08/31/2020,OHV03YYMN4,"3250.00",100
D1013,2,09/23/2020,0,600.00,"12400"
D1013,2,09/08/2020,OI84D00Q6O,"3200.00","9200"
D1013,2,09/15/2020,OIF1K2LNBJ,"3300.00","5900"
D1013,2,09/23/2020,OIN5SJRVGJ,"6500.00",600
D1013,3,10/01/2020,OJ1333OT8B,"2900.00","10700"
D1013,3,09/23/2020,OIN5SJRVGJ_D2,600.00,"10100"
D1013,3,10/12/2020,OJC0FBUEBY,"3250.00","6850"
D1013,3,10/21/2020,OJL8OURG6K,2400,"4450"
D1013,3,10/22/2020,OJM5PZTOTD,2000,"2450"
D1013,3,10/22/2020,OJM6QE8YLI,2450,0
D1014,1,08/05/2020,OH59DAFEYX,350.00,"12650"
D1014,1,08/07/2020,OH75EI929N,350.00,"12300"
D1014,1,08/08/2020,OH85FKD0N9,350.00,"11950"
D1014,1,08/09/2020,OH98HFW7HK,700.00,"11250"
D1014,1,08/10/2020,OHA8IC6QE2,350.00,"10900"
D1014,1,08/12/2020,OHC0KJJBR4,700.00,"10200"
D1014,1,08/14/2020,OHE9MJBIE5,700.00,"9500"
D1014,1,08/16/2020,OHG20LEMKG,700.00,"8800"
D1014,1,08/18/2020,OHI2QHBEC2,700.00,"8100"
D1014,1,08/21/2020,OHL0SSJIBQ,700,"7400"
D1014,1,08/23/2020,OHN0VO7HOM,800,"6600"
D1014,1,08/24/2020,OHO1WFSZ2J,800,"5800"
D1014,1,08/26/2020,OHQ7YIZQGD,800,"5000"
D1014,1,08/29/2020,OHT31W8GZV,800,"4200"
D1014,1,08/30/2020,OHU13KQKK7,800,"3400"
D1014,1,09/01/2020,OI115YEFE9,800,"2600"
D1014,1,09/03/2020,OI347BMDSI,2600,0
D1014,2,09/07/2020,OI77BD216T,800.00,"12200"
D1014,2,09/05/2020,OI5899PDOS,800.00,"11400"
D1014,2,09/09/2020,OI98DIABCY,800.00,"10600"
D1014,2,09/11/2020,OIB4FP5IXI,800,"9800"
D1014,2,09/14/2020,OID4IOJ1KC,800,"9000"
D1014,2,09/17/2020,OIH5M00PO9,800,"8200"
D1014,2,09/21/2020,OIL1QAKDYN,800,"7400"
D1014,2,09/22/2020,OIM4S5ZAC4,800,"6600"
D1014,2,09/24/2020,OIO2TFDS34,800,"5800"
D1014,2,09/27/2020,OIR0XLSS1O,"1600","4200"
D1014,2,09/29/2020,OIT8ZVU2ZU,800,"3400"
D1014,2,10/02/2020,OJ273IJONP,3400,0
D1014,3,10/05/2020,OJ506W8N92,"1200.00","11800"
D1014,3,10/05/2020,OJ517VKBUH,400.00,"11400"
D1014,3,10/06/2020,OJ6491XYNY,400,"11000"
D1014,3,10/09/2020,OJ92BJ8PDG,800,"10200"
D1014,3,10/11/2020,OJB5ESBFRZ,1200,"9000"
D1014,3,10/13/2020,OJD7G4QPSN,800,"8200"
D1014,3,10/15/2020,OJF0I7VI06,800,"7400"
D1014,3,10/17/2020,OJH8KGKFMU,800,"6600"
D1014,3,10/18/2020,OJI2MJFVSC,800,"5800"
D1014,3,10/20/2020,OJK6OOLUMK,800,"5000"
D1014,3,10/21/2020,OJL6PRC3HW,800,"4200"
D1014,3,10/22/2020,OJM6QQDSQC,800,"3400"
D1014,3,10/23/2020,OJN7RWVSGN,800,"2600"
D1014,3,10/25/2020,OJP7U549I1,1600,"1000"
D1014,3,10/28/2020,OJS3X87MDP,2000,"1000"
D1014,4,10/28/2020,OJS3X87MDP_D2,"1000","12000"
D1014,4,11/02/2020,OK243LGFHC,600.00,"11400"
D1014,4,11/05/2020,OK547NZGIK,800,"10600"
D1014,4,11/06/2020,OK628XKMKY,400,"10200"
D1014,4,11/08/2020,OK87BEAS4Z,800,"9400"
D1014,4,11/09/2020,OK93CNVDE5,400,"9000"
D1014,4,11/12/2020,OKC8F8LFOU,800,"8200"
D1014,4,11/14/2020,OKE6IJ4WH6,1200,"7000"
D1014,4,11/15/2020,OKF5JKEI59,400,"6600"
D1014,4,11/17/2020,OKH9LWJ3ZT,"1200.00","5400"
D1014,4,11/19/2020,OKJ7O634C3,1200,"4200"
D1014,4,11/22/2020,OKM0ROO122,1200,"3000"
D1014,4,11/26/2020,OKQ9VVBPKL,"3000",0
D1014,5,11/27/2020,OKR7XTLVJ9,500,"18800"
D1014,5,11/29/2020,OKT9154KDL,500,"18300"
D1014,5,12/01/2020,OL133IVKLP,500,"17800"
D1014,5,12/02/2020,OL204ZJICC,500,"17300"
D1014,5,12/03/2020,OL3364OR93,500,"16800"
D1014,5,12/04/2020,OL497KXLWV,500,"16300"
D1014,5,12/06/2020,OL63A08KKP,"1000","15300"
D1014,5,12/08/2020,OL80CIQ0RC,1000,"14300"
D1014,5,12/10/2020,OLA7F0YB8J,1000,"13300"
D1014,5,12/12/2020,OLC2HU0GKY,"1000","12300"
D1014,5,12/15/2020,OLF2KVYSSQ,"1000","11300"
D1014,5,12/17/2020,OLH5MZ305P,1000,"10300"
D1014,5,12/21/2020,OLL5SYGRHD,"2000","8300"
D1014,5,12/23/2020,OLN6UU1EBU,"8300",0
D1014,6,12/25/2020,OLP4XH2C8W,500,"19000"
D1014,6,12/26/2020,OLQ0ZLELWC,500,"18500"
D1014,6,12/28/2020,OLS21S1944,500,"18000"
D1014,6,12/31/2020,OLV15C9W8Z,500,"17500"
D1014,6,01/01/2021,PA146UYV9E,1000,"16500"
D1014,6,01/04/2021,PA45A7LLUV,1000,"15500"
D1014,6,01/05/2021,PA52BCD150,500,"15000"
D1014,6,01/07/2021,PA77DR7G4F,1000,"14000"
D1014,6,01/10/2021,PAA8HUGAZA,"1000","13000"
D1014,6,01/12/2021,PAC4JFQHXO,500,"12500"
D1014,6,01/13/2021,PAD2KJUBQG,500,"12000"
D1014,6,01/14/2021,PAE7LS9YDH,500,"11500"
D1014,6,1/15/2021,PAF1MXU2B3,500,"11000"
D1014,6,1/17/2021,PAH8Q16RW6,"1500","9500"
D1014,6,12/30/2020,OLU043YIE2,500,"9000"
D1014,6,01/20/2021,PAK1SUYHT3,9000,
D1014,7,1/25/2021,PAP0YENGLM,"1000","18500"
D1014,7,01/25/2021,PAP5Z86ERZ,"1000","17500"
D1014,7,01/28/2021,PAS33MSE5V,500,"17000"
D1014,7,01/29/2021,PAT84X7C5W,500,"16500"
D1014,7,02/01/2021,PB187SCH22,"1000","15500"
D1014,7,02/03/2021,PB31A2NWG3,"1000","14500"
D1014,7,02/04/2021,PB49C9G3XL,"1000","13500"
D1014,7,02/08/2021,PB87G7BSW3,"1000","12500"
D1014,7,02/09/2021,PB99HFX4PP,"1000","11500"
D1014,7,02/10/2021,PBA7JTI0AL,"1000","10500"
D1014,7,02/12/2021,PBB6KWRTZI,500,"10000"
D1014,7,02/15/2021,PBF6OSY2SA,"2000","8000"
D1014,7,2/18/2021,PBI2SEYUR4,"10000","2000"
D1014,8,2/18/2021,PBI2SEYUR4_D2,"1000","18500"
D1014,8,02/22/2021,PBM4XEVFYC,"1000","17500"
D1014,8,02/24/2021,PBO01JT5RE,"1000","16500"
D1014,8,02/27/2021,PBR44VKOBE,500,"16000"
D1014,8,03/05/2021,PC59C73NT5,"2000","14000"
D1014,8,03/08/2021,PC89FZBO09,"1000","13000"
D1014,8,03/12/2021,PCC5L6DGLN,"2000","11000"
D1014,8,03/15/2021,PCF0Q6ZOWW,"1000","10000"
D1014,8,03/19/2021,PCJ6U99S96,"10000",0
D1014,9,3/26/2021,PCQ241O90Y,500,"19000"
D1014,9,03/31/2021,PCV3BEADTV,200,"18800"
D1014,9,03/29/2021,PCT28UJI1Q,"1000","17800"
D1014,9,04/02/2021,PD27CXKZTD,800,"17000"
D1014,9,04/03/2021,PD38FNZ01O,"1000","16000"
D1014,9,04/05/2021,PD51HTRHBF,500,"15500"
D1014,9,04/08/2021,PD83KZYO23,"1000","14500"
D1014,9,04/11/2021,PDB6PZM9GY,"1000","13500"
D1014,9,04/17/2021,PDH7WXVOF7,"13500",0
D1014,10,5/8/2021,PE80Q5EVVS,"3000","20400"
D1014,10,05/16/2021,PEG81M4T7K,"21500","1100"
D1014,11,6/15/2021,PFF55UPNAH,"26000",0
D1014,12,7/14/2021,PGE5BF058L,"26000",0
D1014,13,8/7/2021,,"1300.00","32500"
D1014,13,7/16/2021,PGG9FLE18F,500,"32000"
D1014,13,07/19/2021,PGJ9JMLO3F,500,"31500"
D1014,13,07/22/2021,PGM6NWT2DW,500,"31000"
D1014,13,07/23/2021,PGN4PG5UX0,500,"30500"
D1014,13,07/25/2021,PGP7R7G0RP,500,"30000"
D1014,13,07/25/2021,PGP8S811F0,500,"29500"
D1014,13,07/27/2021,PGR9V2ZGPF,1000,"28500"
D1014,13,08/03/2021,PH3864QLT2,3000,"25500"
D1014,13,08/07/2021,PH77BAXQ61,25500,0
D1014,14,8/13/2021,PHD9JIYKD5,500,"41100"
D1014,14,08/15/2021,PHF5NLSPOJ,"1000","40100"
D1014,14,08/19/2021,PHJ9T0SGBZ,500,"39600"
D1014,14,08/23/2021,PHN1YMQRF7,500,"39100"
D1014,14,08/25/2021,PHP52JZX15,1000,"38100"
D1014,14,08/27/2021,PHR55P9D7L,700,"37400"
D1014,14,09/01/2021,PI19D1LAOZ,500,"36900"
D1014,14,09/02/2021,PI23EKBWRJ,500,"36400"
D1014,14,09/03/2021,PI38G9DDC0,500,"35900"
D1014,14,09/05/2021,PI53ITTMLJ,2100,"33800"
D1014,14,09/07/2021,PI74KXUG3C,500,"33300"
D1014,14,09/09/2021,PI98NY1DH0,1000,"32300"
D1014,14,09/09/2021,PI91P4OJ2R,500,"31800"
D1014,14,09/14/2021,PIE1WK4E8D,1500,"30300"
D1014,14,09/17/2021,PIH613RVEK,500,"29800"
D1014,14,09/20/2021,PIK15DXCXP,500,"29300"
D1014,14,09/22/2021,PIM68CKXOO,500,"28800"
D1014,14,09/24/2021,PIO4BLWXU2,500,"28300"
D1014,14,09/26/2021,PIQ0FJA1VE,1000,"27300"
D1014,14,09/30/2021,PIU8KMVP1O,500,"26800"
D1014,14,10/03/2021,PJ31QSWXG1,1000,"25800"
D1014,14,10/08/2021,PJ88XPES8A,500,"25300"
D1014,14,10/10/2021,PJA22WLD2M,1000,"24300"
D1014,14,10/14/2021,PJF69H06LI,500,"23800"
D1014,14,10/17/2021,PJH3DV2ONF,1000,"22800"
D1014,14,10/21/2021,PJL1IRH00T,500,"22300"
D1014,14,10/22/2021,PJM9LJZRHF,500,"21800"
D1014,14,10/24/2021,PJO6OMSEAS,1000,"20800"
D1014,14,10/26/2021,PJQ4RTXKFA,500,"20300"
D1014,14,10/27/2021,PJS8TOU2QC,500,"19800"
D1014,14,10/31/2021,PJV5ZYVNYX,500,"19300"
D1014,14,11/03/2021,PK364TBICC,500,"18800"
D1014,14,11/11/2021,PKB9HSGCAV,400,"18400"
D1014,14,11/17/2021,PKH1SO3GWX,500,"17900"
D1014,14,11/19/2021,PKJ8UKFVH0,300,"17600"
D1014,14,11/22/2021,PKM7ZQI96X,500,"17100"
D1014,14,11/29/2021,PKT0D8O83E,317,"16783"
D1014,14,12/02/2021,PL23J0X7QX,200,"16583"
D1014,14,12/11/2021,PLB8YI1YD8,477,"16106"
D1014,14,12/28/2021,PLS9SCJEI3,477,"15629"
D1014,14,01/11/2022,QAB8GQ0A2O,477,"15152"
D1014,14,01/21/2022,QAL4WJT3KQ,477,"14675"
D1014,14,01/26/2022,QAQ66UY1IM,100,"14575"
D1014,14,02/02/2022,QB23J6270T,100,"14475"
D1014,14,02/02/2022,QB29J65UP9,100,"14375"
D1014,14,02/02/2022,QB27J6F7S7,18,"14357"
D1014,14,02/09/2022,QB92VYDMYI,200,"14157"
D1014,14,02/28/2022,QBS7VJUI1D,300,"13857"
D1014,14,03/15/2022,QCF0POJIV8,100,"13757"
D1014,14,03/21/2022,QCM03MJK7O,100,"13657"
D1014,14,03/23/2022,QCN85DCQQ6,100,"13557"
D1014,14,03/26/2022,QCQ9BL9ZO9,100,"13457"
D1014,14,04/05/2022,QD53V8NRNB,200,"13257"
D1014,14,04/09/2022,QD9246FK5M,100,"13157"
D1014,14,05/10/2022,QEA5REE2BH,100,"13057"
D1014,14,05/10/2022,QEA0REIGFA,100,"12957"
D1014,14,08/19/2022,QHJ3GC9303,100,"12857"
D1014,14,09/21/2022,QIL9EKFNH5,100,"12757"
D1014,14,11/26/2022,QKQ4PBU562,100,"12657"
D1014,14,12/24/2022,QLR44U4MNQ,100,"12557"
D1014,14,07/20/2023,RGK1ZRFPLN,100,"12457"
D1015,1,08/06/2020,OH62DV3NQQ,100.00,"6100"
D1015,1,08/06/2020,OH63DV5Q6H,100.00,"6000"
D1015,1,08/06/2020,OH66DV7THE,17.00,"5983"
D1015,1,08/07/2020,OH77F0XFTF,100.00,"5883"
D1015,1,08/07/2020,OH71F4WV59,100.00,"5783"
D1015,1,08/07/2020,OH75F56SOR,17.00,"5766"
D1015,1,08/09/2020,OH93H262KL,100.00,"5666"
D1015,1,08/09/2020,OH94H285WA,100.00,"5566"
D1015,1,08/09/2020,OH98H2ACN4,17.00,"5549"
D1015,1,08/10/2020,OHA0I1SNPU,100,"5449"
D1015,1,08/10/2020,OHA41PMQC,100,"5349"
D1015,1,08/10/2020,OHA6I1YVV6,17,"5332"
D1015,1,08/11/2020,OHB3IWH3UD,100,"5232"
D1015,1,08/11/2020,OHB6IWIS1E,100,"5132"
D1015,1,08/11/2020,OHB4IWLBL6,17,"5115"
D1015,1,08/12/2020,OHC7JZ8W53,100,"5015"
D1015,1,08/12/2020,OHC8JZANQK,100,"4915"
D1015,1,08/12/2020,OHC7JZDOZ1,17,"4898"
D1015,1,08/14/2020,OHE0LNMDK6,100,"4798"
D1015,1,08/14/2020,OHE5LNNGP7,100,"4698"
D1015,1,08/14/2020,OHE0LNOVUQ,17,"4681"
D1015,1,08/15/2020,OHF7N1ACNX,100,"4581"
D1015,1,08/15/2020,OHF0N1DAQ2,100,"4481"
D1015,1,08/15/2020,OHF3N1GNSH,17,"4464"
D1015,1,08/16/2020,OHG6O1WA86,100,"4364"
D1015,1,08/16/2020,OHG601Y2ZK,100,"4264"
D1015,1,08/16/2020,OHG001ZZ5U,17,"4247"
D1015,1,08/17/2020,OHH9P3TWFZ,100,"4147"
D1015,1,08/17/2020,OHH1P3VL1P,100,"4047"
D1015,1,08/17/2020,OHH3P3XJ2B,17,"4030"
D1015,1,08/18/2020,OHI4PYVMFM,100,"3930"
D1015,1,08/18/2020,OHI9PYXD1X,100,"3830"
D1015,1,08/18/2020,OHI6PZ3260,17,"3813"
D1015,1,08/19/2020,OHJ0RA0MII,100,"3713"
D1015,1,08/19/2020,OHJ5RA3889,100,"3613"
D1015,1,08/19/2020,OHJ1RA73HH,17,"3596"
D1015,1,08/20/2020,OHK7S92NYV,100,"3496"
D1015,1,08/20/2020,OHK9S90SJ5,100,"3396"
D1015,1,08/20/2020,OHK8S94GYM,17,"3379"
D1015,1,08/21/2020,OHL2T6CP9Q,17,"3362"
D1015,1,08/21/2020,OHL0T6B9XC,100,"3262"
D1015,1,08/21/2020,OHL1T69OPD,100,"3162"
D1015,1,08/08/2020,OH86FQV6BC,100,"3062"
D1015,1,08/08/2020,OH85FQX55V,100,"2962"
D1015,1,08/08/2020,OH84FQYYYG,17,"2945"
D1015,1,08/22/2020,OHM7UEHNM1,100,"2845"
D1015,1,08/22/2020,OHM6UEK8GI,100,"2745"
D1015,1,08/22/2020,OHM3UEMPON,17,"2728"
D1015,1,08/24/2020,OHO4VZZ3BO,100,"2628"
D1015,1,08/24/2020,OHO7VZX6HF,100,"2528"
D1015,1,08/24/2020,OHO0W00TFE,17,"2511"
D1015,1,08/25/2020,OHP9XAO949,100,"2411"
D1015,1,08/25/2020,OHP6XAQEP8,100,"2311"
D1015,1,08/25/2020,OHP3XASLDD,17,"2294"
D1015,1,08/26/2020,OHQ0Y0JOQW,100,"2194"
D1015,1,08/26/2020,OHQ9Y0M373,100,"2094"
D1015,1,08/26/2020,OHQ5Y0OKM5,17,"2077"
D1015,2,08/28/2020,OHS711XFDT,100.00,"6050"
D1015,2,08/28/2020,OHS811Z86C,100.00,"5950"
D1015,2,08/28/2020,OHS212160M,17.00,"5933"
D1015,2,08/29/2020,OHT62LX65Y,100,"5833"
D1015,2,08/29/2020,OHT62M10O2,100,"5733"
D1015,2,08/29/2020,OHT92M6T3H,17,"5716"
D1015,2,08/31/2020,OHV9447XV5,100,"5616"
D1015,2,08/31/2020,OHV044B0CO,100,"5516"
D1015,2,08/31/2020,OHV244D16O,17,"5499"
D1015,2,09/02/2020,OI236QKLPF,100,"5399"
D1015,2,09/02/2020,OI286QTK66,100,"5299"
D1015,2,09/02/2020,OI246QOOMC,17,"5282"
D1015,2,09/03/2020,OI397RTP0L,17,"5265"
D1015,2,09/03/2020,OI357RRT19,100,"5165"
D1015,2,09/03/2020,OI377RPCBP,100,"5065"
D1015,2,09/04/2020,OI418NM0YT,17,"5048"
D1015,2,09/04/2020,OI498NJ1KN,100,"4948"
D1015,2,09/04/2020,OI4990F8SJ,100,"4848"
D1015,2,09/07/2020,OI73BMJVC3,100,"4748"
D1015,2,09/07/2020,OI75BMNHNT,100,"4648"
D1015,2,09/07/2020,OI78BMPJN8,17,"4631"
D1015,2,09/08/2020,OI89CTIJBP,100,"4531"
D1015,2,09/08/2020,OI83CTJZTJ,100,"4431"
D1015,2,09/08/2020,OI82CTMDV0,17,"4414"
D1015,2,09/09/2020,OI91DLVDK3,100,"4314"
D1015,2,09/09/2020,OI97DLWXPD,100,"4214"
D1015,2,09/09/2020,OI95DLYNO5,17,"4197"
D1015,2,09/13/2020,OID8IAD958,17,"4180"
D1015,2,09/13/2020,OID3IABF1X,100,"4080"
D1015,2,09/12/2020,OIC3H5WANL,100,"3980"
D1015,2,09/12/2020,OIC5H5ZSZF,100,"3880"
D1015,2,09/12/2020,OIC2H61NK0,17,"3863"
D1015,2,09/11/2020,OIB2G4OC24,100,"3763"
D1015,2,09/11/2020,OIB5G4Q3SN,100,"3663"
D1015,2,09/11/2020,OIB3G4T8Z1,100,"3563"
D1015,2,09/11/2020,OIB9G4Y0KP,17,"3546"
D1015,2,09/15/2020,OIF7JT0UEP,100,"3446"
D1015,2,09/15/2020,OIF0JT20Z0,100,"3346"
D1015,2,09/15/2020,OIF2JT3LOQ,17,"3329"
D1015,2,09/15/2020,OIF8JT8OT4,100,"3229"
D1015,2,09/15/2020,OIF3JT9S9J,100,"3129"
D1015,2,09/16/2020,OIG9LIVF81,100,"3029"
D1015,2,09/16/2020,OIG0LIZASI,17,"3012"
D1015,2,09/16/2020,OIG0LJ2F9E,100,"2912"
D1015,2,09/19/2020,OIJ2O9GQMA,"3079",167
D1015,3,09/21/2020,OIL3Q82VID,100.00,"5750"
D1015,3,09/21/2020,OIL9Q848NP,100.00,"5650"
D1015,3,09/21/2020,OIL7Q86QAL,17.00,"5633"
D1015,3,09/22/2020,OIM0RLCKKA,100,"5533"
D1015,3,09/22/2020,OIM8RLEM0Y,100,"5433"
D1015,3,09/22/2020,OIM3RLZZQJ,17,"5416"
D1015,3,09/23/2020,OIN5SF5YWL,100,"5316"
D1015,3,09/23/2020,OIN2SF7I54,100,"5216"
D1015,3,09/23/2020,OIN1SFD8ZH,17,"5199"
D1015,3,09/24/2020,OIO9TRA5A3,100,"5099"
D1015,3,09/24/2020,OIO5TRBUUX,100,"4999"
D1015,3,09/24/2020,OIO6TRE1X2,17,"4982"
D1015,3,09/26/2020,OIQ2VW0SME,100,"4882"
D1015,3,09/26/2020,OIQ3VW2XUP,100,"4782"
D1015,3,09/26/2020,OIQ6VW60VG,17,"4765"
D1015,3,09/30/2020,OIU11HSTNN,434,"4331"
D1015,3,09/28/2020,OIS1YQ4RYV,100,"4231"
D1015,3,09/28/2020,OIS5YQ5GM7,100,"4131"
D1015,3,09/28/2020,OIS7YQ64EN,17,"4114"
D1015,3,10/01/2020,OJ182ME9N8,100,"4014"
D1015,3,10/01/2020,OJ152MFYJ3,100,"3914"
D1015,3,10/01/2020,OJ192MHQQV,17,"3897"
D1015,3,10/01/2020,OJ192P1B69,90,"3807"
D1015,3,10/02/2020,OJ243YN1NK,100,"3707"
D1015,3,10/02/2020,OJ213YPRGL,100,"3607"
D1015,3,10/02/2020,OJ273YTD71,17,"3590"
D1015,3,10/03/2020,OJ31551L09,100,"3490"
D1015,3,10/03/2020,OJ33553GV3,100,"3390"
D1015,3,10/03/2020,OJ33555EV3,17,"3373"
D1015,3,10/05/2020,OJ5773TRB5,3373,0
D1015,4,10/06/2020,OJ6480AFDS,100.00,"9000"
D1015,4,10/06/2020,OJ6280BOWW,100.00,"8900"
D1015,4,10/06/2020,OJ6980DS0P,104.00,"8796"
D1015,4,10/08/2020,OJ81AEAMH3,608,"8188"
D1015,4,10/09/2020,OJ96C8JT4O,100,"8088"
D1015,4,10/09/2020,OJ90C8LTLE,100,"7988"
D1015,4,10/09/2020,OJ92C8U2HS,104,"7884"
D1015,4,10/10/2020,OJA3DARQKH,100,"7784"
D1015,4,10/10/2020,OJA2DATLNQ,100,"7684"
D1015,4,10/10/2020,OJA7DAVEZ9,106,"7578"
D1015,4,10/14/2020,OJE2I67FJC,100,"7478"
D1015,4,10/14/2020,OJE3I681XH,104,"7374"
D1015,4,10/12/2020,OJC4F8QJHY,100,"7274"
D1015,4,10/12/2020,OJC0F8SHPC,100,"7174"
D1015,4,10/12/2020,OJC4F8U858,104,"7070"
D1015,4,10/15/2020,OJF0J3E3MY,100,"6970"
D1015,4,10/15/2020,OJF0J3GYO4,100,"6870"
D1015,4,10/15/2020,OJF7J3LXWJ,70,"6800"
D1015,4,10/16/2020,OJG3K3FAQT,100,"6700"
D1015,4,10/16/2020,OJG0K3PLHE,100,"6600"
D1015,4,10/16/2020,OJG0K4UTMU,104,"6496"
D1015,4,10/17/2020,OJH9L3N1M9,100,"6396"
D1015,4,10/17/2020,OJH2L3SNSY,100,"6296"
D1015,4,10/17/2020,OJH0L3X7HE,104,"6192"
D1015,4,10/17/2020,OJJ4N5FH5Y,100,"6092"
D1015,4,10/17/2020,OJJ1N5HMBD,100,"5992"
D1015,4,10/17/2020,OJJ9N5JL7T,100,"5892"
D1015,4,10/17/2020,OJJ3N5Q0R7,4,"5888"
D1015,4,10/21/2020,OJL2OZM0M4,100,"5788"
D1015,4,10/21/2020,OJL2OZNJE2,100,"5688"
D1015,4,10/21/2020,OJL1OZPJ3F,104,"5584"
D1015,4,10/23/2020,OJN6RS6VWM,100,"5484"
D1015,4,10/23/2020,OJN3RS9H7Z,100,"5384"
D1015,4,10/23/2020,OJN6RSDJXQ,104,"5280"
D1015,4,10/24/2020,OJO2SZHPLQ,100,"5180"
D1015,4,10/24/2020,OJO8SZKW3K,100,"5080"
D1015,4,10/24/2020,OJO1SZMXSP,104,"4976"
D1015,4,10/27/2020,OJR6VB67TM,100,"4876"
D1015,4,10/27/2020,OJR7VB6F1N,100,"4776"
D1015,4,10/27/2020,OJR9VB6R27,100,"4676"
D1015,4,10/27/2020,OJR9VB782Z,4,"4672"
D1015,4,10/28/2020,OJS4WYFLXY,100,"4572"
D1015,4,10/28/2020,OJS9WYHVXR,250,"4322"
D1015,4,10/30/2020,OJU1ZQ17S9,304,"4018"
D1015,4,11/02/2020,OK213FZIJB,4018,0
D1015,5,11/02/2020,OK2141DXHN,100.00,"9000"
D1015,5,11/02/2020,OK2641H6US,100.00,"8900"
D1015,5,11/02/2020,OK2141S9KJ,204.00,"8696"
D1015,5,11/04/2020,OK436H77TH,204,"8492"
D1015,5,11/05/2020,OK557OENGL,304,"8188"
D1015,5,11/07/2020,OK70A4TBCE,304,"7884"
D1015,5,11/09/2020,OK92CF8B7Y,304,"7580"
D1015,5,11/12/2020,OKC1FHEMVH,304,"7276"
D1015,5,11/14/2020,OKE0I7K0B4,304,"6972"
D1015,5,11/16/2020,OKG7KGJ985,304,"6668"
D1015,5,11/18/2020,OKI9MZFZHZ,280,"6388"
D1015,5,11/20/2020,OKK9P93OD5,230,"6158"
D1015,5,11/20/2020,OKK6PDDTYM,100,"6058"
D1015,5,11/21/2020,OKL3QNLPB7,304,"5754"
D1015,5,11/23/2020,OKN2SV5QRK,304,"5450"
D1015,5,11/25/2020,OKP2V7QQE8,100,"5350"
D1015,5,11/25/2020,OKP8V7TBLO,100,"5250"
D1015,5,11/25/2020,OKP1V7XRWV,104,"5146"
D1015,5,11/28/2020,OKS4Y4CN9M,604,"4542"
D1015,5,11/28/2020,OKS4Y59CIG,4,"4538"
D1015,5,12/01/2020,OL1238PNR6,4568,30
D1015,6,12/03/2020,OL375INLP5,304.00,"8796"
D1015,6,12/05/2020,OL527UHG2K,604.00,"8192"
D1015,6,12/07/2020,OL73BEOKN1,100.00,"8092"
D1015,6,12/07/2020,OL76BESPG2,100,"7992"
D1015,6,12/09/2020,OL94DPAXHG,100,"7892"
D1015,6,12/09/2020,OL91DPE60N,100,"7792"
D1015,6,12/09/2020,OL92DPHFWU,104,"7688"
D1015,6,12/11/2020,OLB8GJ62R8,100,"7588"
D1015,6,12/11/2020,OLB9GJ7X4F,100,"7488"
D1015,6,12/11/2020,OLB4GJB3P0,104,"7384"
D1015,6,12/14/2020,OLE3J67IE9,304,"7080"
D1015,6,12/16/2020,OLG8MCBRVA,304,"6776"
D1015,6,12/18/2020,OLI5OZN64D,204,"6572"
D1015,6,12/22/2020,OLM9THWJXT,912,"5660"
D1015,6,12/23/2020,0LN2VNM9GQ,304,"5356"
D1015,6,12/25/2020,OLP2Y5MRGS,304,"5052"
D1015,6,12/29/2020,OLT53JKF4T,5052,0
D1015,7,12/31/2020,OLV25AYMX8,100.00,"9000"
D1015,7,12/31/2020,OLV05AZR76,100.00,"8900"
D1015,7,12/31/2020,OLV75B5O61,100.00,"8800"
D1015,7,01/04/2021,PA47ACM5HB,100,"8700"
D1015,7,01/04/2021,PA40ADI784,100,"8600"
D1015,7,01/04/2021,PA45ADY79H,100,"8500"
D1015,7,01/04/2021,PA45AE2GT9,8,"8492"
D1015,7,01/13/2021,PAD4KORLBQ,304,"8188"
D1015,7,01/15/2021,PAF2MX8SNI,100,"8088"
D1015,7,01/15/2021,PAF4MXDJB6,100,"7988"
D1015,7,01/15/2021,PAF5MXH76P,100,"7888"
D1015,7,01/15/2021,PAF4MXJVTU,8,"7880"
D1015,7,01/18/2021,PAI1R3C1PX,100,"7780"
D1015,7,01/18/2021,PAI3R3OXH9,100,"7680"
D1015,7,01/18/2021,PAI4R4JC34,100,"7580"
D1015,7,01/18/2021,PAI9R4Y0HH,4,"7576"
D1015,7,01/21/2021,PAL7UHPH35,100,"7476"
D1015,7,01/21/2021,PAL0UHXDZ2,100,"7376"
D1015,7,01/21/2021,PAL2UI9RTY,100,"7276"
D1015,7,01/21/2021,PAL4UILDQG,4,"7272"
D1015,7,01/22/2021,PAM1V89GQ1,100,"7172"
D1015,7,01/22/2021,PAM3V8FGKD,100,"7072"
D1015,7,01/22/2021,PAM2V8KWYW,100,"6972"
D1015,7,01/22/2021,PAM3V8S6Q9,100,"6872"
D1015,7,01/22/2021,PAM8V8YZK0,100,"6772"
D1015,7,01/22/2021,PAM1V9ABWD,100,"6672"
D1015,7,01/22/2021,PAM8VA7C2G,100,"6572"
D1015,7,01/22/2021,PAM7VALH03,100,"6472"
D1015,7,01/22/2021,PAM1VATGJ1,100,"6372"
D1015,7,01/22/2021,PAM8VAXJBY,10,"6362"
D1015,7,01/26/2021,PAQ5ZJJMGT,6362,0
D1015,8,01/27/2021,PAR32IRVHX,100.00,"9000"
D1015,8,01/27/2021,PAR52IYV4B,100.00,"8900"
D1015,8,01/27/2021,PAR82J68H6,100.00,"8800"
D1015,8,01/27/2021,PAR12JMNCX,4,"8796"
D1015,8,02/01/2021,PB198O7GJP,100,"8696"
D1015,8,02/01/2021,PB168ODPX8,100,"8596"
D1015,8,02/01/2021,PB138OT3QD,100,"8496"
D1015,8,02/01/2021,PB198P2W07,100,"8396"
D1015,8,02/01/2021,PB148P8JU4,100,"8296"
D1015,8,02/04/2021,PB48C8PPIA,100,"8196"
D1015,8,02/04/2021,PB46C95N5C,100,"8096"
D1015,8,02/04/2021,PB47C9POYD,100,"7996"
D1015,8,02/24/2021,PBO413N8OK,"7996",0
D1015,9,03/31/2021,,"10880.00",0
D1016,1,08/14/2020,OHE3MJNTX7,975.00,"2895"
D1016,1,08/23/2020,OHN1V9KVV9,975.00,"1920"
D1016,1,09/02/2020,OI236JZOSV,"1920.00",0
D1016,2,09/13/2020,OID8ILRP20,975.00,"2865"
D1016,2,09/18/2020,OII1NIEK29,975.00,"1890"
D1016,2,09/24/2020,OIO7TRU59R,975.00,915
D1016,2,09/28/2020,OIS1XX6LBH,915,0
D1016,3,10/07/2020,OJ7497RLFA,500.00,"3580"
D1016,3,10/21/2020,OJL5PT8CUL,200.00,"3380"
D1016,3,10/28/2020,OJS4WVRWEI,"3380.00",0
D1016,4,11/26/2020,OKQ4VXLW4S,"4080.00",0
D1016,5,12/24/2020,0LO2WT1RIU,"3900.00",0
D1016,6,01/25/2021,PAP0YRP0HC,"4080.00",0
D1016,7,02/23/2021,PBN9YMLT4T,"4080.00",0
D1016,8,03/22/2021,PCM4YJWJ00,"4515.00",0
D1016,9,04/16/2021,PDG1W49IIZ,"4445.00",0
D1016,10,05/25/2021,PEP1DBOICX,100.00,"5010"
D1016,10,05/31/2021,PEV3K88WIR,100.00,"4910"
D1016,10,05/31/2021,PEV7K8AVKD,100,"4810"
D1016,10,06/02/2021,PF26N0DCW6,2000,"2810"
D1016,10,06/04/2021,PF40QFVUK8,2810,0
D1016,11,07/07/2021,PG7828GW00,"4760.00",0
D1016,12,08/17/2021,PHH5PE8VZH,"4760.00",0
D1016,13,09/24/2021,PIO5BLVD4Z,"5110.00",0
D1016,14,11/08/2021,PK89D4YJNB,"5100.00",10
D1016,14,11/08/2021,PK88D53IW2,10.00,0
D1016,15,12/13/2021,PLD22SH0NM,"5110.00",0
D1016,16,25/01/2022,QAP04GCSJQ,100.00,"5010"
D1016,16,25/01/2022,QAP84G7KQ,100.00,"4910"
D1016,16,26/01/2022,QAQ76D2YPH,50.00,"4860"
D1016,16,04/05/2022,QD59V69FS5,100.00,"4760"
D1016,16,04/19/2022,QDJ2M87J2O,60.00,"4700"
D1016,16,04/27/2022,QDR736YN5V,100.00,"4600"
D1016,16,04/27/2022,QDR2371YIO,50.00,"4550"
D1016,16,05/10/2022,QEA6RAD5P6,100.00,"4450"
D1016,16,05/10/2022,QEA0RAGS90,100.00,"4350"
D1016,16,05/23/2022,QEN5HLSOU5,100,"4250"
D1016,16,06/10/2022,QFA7I1KINH,100,"4150"
D1016,16,08/20/2022,QHK9IKXYN1,20,"4130"
D1016,16,08/24/2022,QHO0Q5R1F6,30,"4100"
D1016,16,08/29/2022,QHT818GN3C,50,"4050"
D1016,16,10/29/2022,QJT2UBYCQE,40,"4010"
D1016,16,06/30/2023,QHK9IKXYN1_D2,50,"3960"
D1016,16,07/25/2023,RGP5ENZ8GJ,50,"3910"
D1017,1,08/12/2020,OHC6K9IXME,100.00,"6400"
D1017,1,08/12/2020,OHC0K9M6WG,100.00,"6300"
D1017,1,08/12/2020,OHC9K9T0CT,50.00,"6250"
D1017,1,08/17/2020,OHH8OYIRNC,"1276.00","4974"
D1017,1,08/21/2020,OHL5T5BCET,707.00,"4267"
D1017,1,08/27/2020,OHR4ZABHEM,527.00,"3740"
D1017,1,08/28/2020,OHS516BTTT,500.00,"3240"
D1017,1,09/01/2020,OI1854KBVC,500.00,"2740"
D1017,1,09/03/2020,OI3983E0LN,50.00,"2690"
D1017,1,09/03/2020,OI3283CNQU,100,"2590"
D1017,1,09/03/2020,OI31838SGD,100,"2490"
D1017,1,09/03/2020,OI328379FU,100,"2390"
D1017,1,09/03/2020,OI378368VV,100,"2290"
D1017,1,09/03/2020,OI35833VVT,100,"2190"
D1017,1,09/04/2020,OI478X7P3L,100,"2090"
D1017,1,09/04/2020,OI479202N1,100,"1990"
D1017,1,09/06/2020,OI62B8SOG0,100,"1890"
D1017,1,09/06/2020,OI65B8R2ON,100,"1790"
D1017,1,09/06/2020,OI69B8Q013,100,"1690"
D1017,1,09/06/2020,OI67B8OTMN,100,"1590"
D1017,1,09/07/2020,OI77CAW83H,1000,590
D1017,1,09/08/2020,OI89CTS92T,590,0
D1017,2,09/16/2020,OIG1L78SO3,"1350.00","5150"
D1017,2,09/17/2020,OIH3M12S9V,100.00,"5050"
D1017,2,09/17/2020,OIH0M10XQ8,100.00,"4950"
D1017,2,09/17/2020,OIH9M16997,100,"4850"
D1017,2,09/23/2020,OIN1SB52OL,800,"4050"
D1017,2,09/24/2020,OIO5TD63GX,400,"3650"
D1017,2,09/28/2020,OIS5XQ8CEH,550,"3100"
D1017,2,09/30/2020,OIU110J41V,500,"2600"
D1017,2,10/01/2020,OJ12276IPY,400,"2200"
D1017,2,10/03/2020,OJ344JQANC,500,"1700"
D1017,2,10/06/2020,OJ638EUNG7,700,"1000"
D1017,2,10/06/2020,OJ668J5U9K,1016,16
D1017,3,10/15/2020,OJF5IA9Q75,"1000.00","5500"
D1017,3,10/06/2020,OJ668J5U9K_D2,16.00,"5484"
D1017,3,10/26/2020,OJQ2UBARI6,"1000.00","4484"
D1017,3,11/02/2020,OK253NA32T,1600,"2884"
D1017,3,11/03/2020,OK314WTL3R,2884,0
D1017,4,11/26/2020,OKQ5WMMN5B,450.00,"6050"
D1017,4,11/27/2020,OKR0X7VWYI,"1000.00","5050"
D1017,4,12/01/2020,OL1536H7MF,"5050.00",0
D1017,5,12/28/2020,OLS528YE8T,"6500.00",0
D1017,6,01/21/2021,PAL6U8AXBO,"6500.00",0
D1017,7,02/18/2021,PBI1SWR9LT,"6500.00",0
D1017,8,03/23/2021,PCN7ZJ7KVP,"8160.00",0
D1017,9,04/26/2021,PDO76TZYRV,"8160.00",0
D1017,10,05/24/2021,PEO2BFDNQY,"8160.00",0
D1017,11,06/21/2021,PFL7EGCG5T,"7800.00",0
D1017,12,07/19/2021,PGJ9J5N35J,"10400.00",0
D1017,13,08/16/2021,PHG5OGGF1N,"10200.00",200
D1017,13,08/16/2021,PHG0OGM9BS,200.00,0
D1017,14,09/13/2021,PID8UGO1HA,"10400.00",0
D1017,15,10/11/2021,PJB34ETZR9,"10400.00",0
D1017,16,11/18/2021,PKI8TQTSVA,"10400.00",0
D1017,17,12/17/2021,PLH29ZOAHC,"10880.00",0
D1017,18,01/15/2022,QAF1ND44V1,"10400.00",0
D1017,19,10/25/2022,QJP8KTCEEY,"10400.00",0
D1017,20,11/23/2022,QKN6IGN03Q,"6500.00",0
D1017,21,12/21/2022,QLL1OEMPW9,"6500.00",0
D1017,22,01/18/2023,RAI1NLGDCV,"10400.00",0
D1017,23,02/24/2023,RBO4DW05YA,"6500.00",800
D1017,23,02/24/2023,PENALTIES WAIVED,800.00,0
D1017,24,03/24/2023,RCO2JA5F4O,"6300.00",200
D1017,24,03/24/2023,RCO8JF5SEC,200.00,0
D1017,25,04/21/2023,RDL9QD097J,"6500.00",0
D1017,26,05/08/2023,RE852JTV2R,"4000.00","5760"
D1017,26,05/12/2023,REC1C1B80T,"5680.00",80
D1017,26,05/18/2023,REI9U7L0AL,80,0
D1018,1,08/12/2020,OHC4JSZ8DQ,100.00,"2140"
D1018,1,08/13/2020,OHD8KYKQBM,100.00,"2040"
D1018,1,08/14/2020,OHE7LXZ0BR,100.00,"1940"
D1018,1,08/15/2020,OHF4N1YB7I,100.00,"1840"
D1018,1,08/16/2020,OHG102KMJJ,100.00,"1740"
D1018,1,08/17/2020,OHH7OXSFKH,100.00,"1640"
D1018,1,08/18/2020,OHI7Q1C8V9,100.00,"1540"
D1018,1,08/19/2020,OHJ8R2W7LE,100.00,"1440"
D1018,1,08/20/2020,OHK2S4SNY0,100.00,"1340"
D1018,1,08/21/2020,OHL6T9NDAW,1000,340
D1018,1,08/21/2020,OHL7T9VYD1,100,240
D1018,1,08/21/2020,OHL1T9ZGL1,100,140
D1018,1,08/21/2020,OHL7TA43FL,100,40
D1018,1,08/21/2020,OHL9TAVRX9,40,0
D1018,2,08/22/2020,OHM8U1M2L2,100.00,"2280"
D1018,2,08/23/2020,OHN6V4D0MG,100.00,"2180"
D1018,2,08/24/2020,OHO9W5J0GH,100.00,"2080"
D1018,2,08/25/2020,OHP7XKQVY3,100,"1980"
D1018,2,08/26/2020,OHQ6Y0REYW,100,"1880"
D1018,2,08/27/2020,OHR7Z5KBH9,100,"1780"
D1018,2,08/28/2020,OHS71PNOQ3,100,"1680"
D1018,2,08/29/2020,OHT92H79GN,100,"1580"
D1018,2,08/30/2020,OHU83HMDM6,100,"1480"
D1018,2,08/31/2020,OHV74R4F93,100,"1380"
D1018,2,09/01/2020,OI135ST8MV,100,"1280"
D1018,2,09/02/2020,OI286GV3MA,100,"1180"
D1018,2,09/03/2020,OI367ZF3PG,100,"1080"
D1018,2,09/04/2020,OI4793HDUZ,100,980
D1018,2,09/05/2020,OI58A7U35S,100,880
D1018,2,09/06/2020,OI61B991TR,100,780
D1018,2,09/07/2020,OI78CCF7UC,100,680
D1018,2,09/08/2020,OI88CQGO2S,100,580
D1018,2,09/08/2020,OI89CQITSB,100,480
D1018,2,09/08/2020,OI87CQKJQT,100,380
D1018,2,09/08/2020,OI80CQN6MG,100,280
D1018,2,09/08/2020,OI86CQP242,100,180
D1018,2,09/08/2020,OI86CQQX54,100,80
D1018,2,09/08/2020,OI88CQSY08,80,0
D1018,3,09/09/2020,OI91EC6I0V,130.00,"3590"
D1018,3,09/10/2020,OIA0FGDQYG,100.00,"3490"
D1018,3,09/10/2020,OIA5FGGMSD,30.00,"3460"
D1018,3,09/13/2020,OID9HYH82L,100,"3360"
D1018,3,09/13/2020,OID0HYFGBM,30,"3330"
D1018,3,09/12/2020,OIC7HFZAUF,100,"3230"
D1018,3,09/12/2020,OIC7HFWBU7,30,"3200"
D1018,3,09/12/2020,OIC5GZB8PP,100,"3100"
D1018,3,09/12/2020,OIC2GZDMZQ,30,"3070"
D1018,3,09/14/2020,OIE7JOJS3J,100,"2970"
D1018,3,09/14/2020,OIE1JO4GWL,30,"2940"
D1018,3,09/15/2020,OIF4KR8P1I,30,"2910"
D1018,3,09/15/2020,OIF8KRAKG0,100,"2810"
D1018,3,09/16/2020,OIG1LUAT0B,30,"2780"
D1018,3,09/16/2020,OIG9LUCE89,100,"2680"
D1018,3,09/18/2020,OII2N13OKQ,30,"2650"
D1018,3,09/18/2020,OII2N15Q7K,100,"2550"
D1018,3,09/18/2020,OII5NWOYG1,30,"2520"
D1018,3,09/18/2020,OII9NWR93P,100,"2420"
D1018,3,09/19/2020,OIJ7ONP159,30,"2390"
D1018,3,09/19/2020,OIJ5ONQYD5,100,"2290"
D1018,3,09/20/2020,OIK6Q34KPS,30,"2260"
D1018,3,09/20/2020,OIK9Q35NLL,100,"2160"
D1018,3,09/23/2020,OIN1STRL1F,30,"2130"
D1018,3,09/23/2020,OIN8STTMAU,100,"2030"
D1018,3,09/23/2020,OIN2STVSF6,100,"1930"
D1018,3,09/23/2020,OIN4STXU7C,30,"1900"
D1018,3,09/23/2020,OIN9T896Q1,30,"1870"
D1018,3,09/23/2020,OIN6T8AQQC,100,"1770"
D1018,3,09/24/2020,OIO9U8QJPB,30,"1740"
D1018,3,09/24/2020,OIO5U8WURX,100,"1640"
D1018,3,09/25/2020,OIP0V7HH3K,30,"1610"
D1018,3,09/25/2020,OIP2V7LJ72,100,"1510"
D1018,3,09/26/2020,OIQ6WJ0UD2,30,"1480"
D1018,3,09/26/2020,OIQ5WJ2BYH,100,"1380"
D1018,3,09/28/2020,OIS2XY1C02,30,"1350"
D1018,3,09/28/2020,OIS9XY3ET1,100,"1250"
D1018,3,09/28/2020,OIS3Y9V8EH,30,"1220"
D1018,3,09/28/2020,OIS1Y9XEP1,100,"1120"
D1018,3,09/30/2020,OIU9125VQJ,100,"1020"
D1018,3,09/30/2020,OIU2127XJ0,30,990
D1018,3,10/01/2020,OJ162NDXNM,100,890
D1018,3,10/01/2020,OJ132NGL8X,100,790
D1018,3,10/01/2020,OJ102NIIRC,100,690
D1018,3,10/01/2020,OJ122NKH28,100,590
D1018,3,10/01/2020,OJ192NMAK7,100,490
D1018,3,10/01/2020,OJ162NNZRG,100,390
D1018,3,10/01/2020,OJ152NQ53L,100,290
D1018,3,10/01/2020,OJ172NZ8QN,100,190
D1018,3,10/01/2020,OJ152O32UJ,50,140
D1018,3,10/01/2020,OJ122O8KYY,50,90
D1018,3,10/01/2020,OJ192P1B69_D2,90,0
D1018,4,10/02/2020,OJ263RPHQI,30.00,"3690"
D1018,4,10/02/2020,OJ203RRM9M,100.00,"3590"
D1018,4,10/04/2020,OJ496KI57D,100.00,"3490"
D1018,4,10/04/2020,OJ446KKANU,100,"3390"
D1018,4,10/04/2020,OJ486KP034,60,"3330"
D1018,4,10/06/2020,OJ678YAWK3,60,"3270"
D1018,4,10/06/2020,OJ658Y8BR7,100,"3170"
D1018,4,10/06/2020,OJ668Y5P3G,100,"3070"
D1018,4,10/08/2020,OJ89AFDJ2Z,100,"2970"
D1018,4,10/08/2020,OJ85AFFP7N,30,"2940"
D1018,4,10/08/2020,OJ80BAPNDI,100,"2840"
D1018,4,10/08/2020,OJ80BAVID2,30,"2810"
D1018,4,10/10/2020,OJA2DPYN2A,100,"2710"
D1018,4,10/10/2020,OJA2DPZNM4,30,"2680"
D1018,4,10/11/2020,OJB7EMLYL5,100,"2580"
D1018,4,10/11/2020,OJC0F14FGO,100,"2480"
D1018,4,10/11/2020,OJC8F16LDM,60,"2420"
D1018,4,10/14/2020,OJE9H7KH0D,100,"2320"
D1018,4,10/14/2020,OJE6H7LUJ2,100,"2220"
D1018,4,10/14/2020,OJE3H7PRZH,60,"2160"
D1018,4,10/14/2020,OJE4I4QJHA,30,"2130"
D1018,4,10/14/2020,OJE8I4RXA6,100,"2030"
D1018,4,10/15/2020,OJF4J9OZS4,30,"2000"
D1018,4,10/15/2020,OJF0J9PQVA,100,"1900"
D1018,4,10/19/2020,OJJ7MQDBEB,100,"1800"
D1018,4,10/19/2020,OJJ8MQFY5G,100,"1700"
D1018,4,10/19/2020,OJJ1MQIH8F,60,"1640"
D1018,4,10/20/2020,OJK1NRBUOL,100,"1540"
D1018,4,10/20/2020,OJK0NRDEOO,100,"1440"
D1018,4,10/20/2020,OJK4NRETH4,60,"1380"
D1018,4,10/20/2020,OJK6ONEQAY,30,"1350"
D1018,4,10/20/2020,OJK5ONGJ7V,100,"1250"
D1018,4,10/24/2020,OJO2SG4LXK,100,"1150"
D1018,4,10/24/2020,OJO1SG6821,100,"1050"
D1018,4,10/24/2020,OJO3SG83RB,100,950
D1018,4,10/24/2020,OJO4SGH7XS,950,0
D1018,5,01/16/2021,PAG8P329CC,100.00,"2460"
D1018,5,01/17/2021,PAH6Q4KHMM,100.00,"2360"
D1018,5,01/18/2021,PAI5RA6X5J,100.00,"2260"
D1018,5,01/20/2021,PAK1TL7JZP,100,"2160"
D1018,5,01/22/2021,PAM0VWKPY8,100,"2060"
D1018,5,01/22/2021,PAM7VWOSJD,100,"1960"
D1018,5,01/23/2021,PAN8X1AU2M,100,"1860"
D1018,5,01/26/2021,PAQ3ZUBTCL,100,"1760"
D1018,5,01/26/2021,PAQ2ZUDW5C,100,"1660"
D1018,5,01/29/2021,PAT04DPF5I,100,"1560"
D1018,5,02/01/2021,PB128IBHCQ,100,"1460"
D1018,5,02/01/2021,PB138IL5W9,100,"1360"
D1018,5,02/06/2021,PB63E33C6Z,100,"1260"
D1018,5,02/06/2021,PB63E35ST9,100,"1160"
D1018,5,02/10/2021,PBA0JRQV9S,100,"1060"
D1018,5,02/11/2021,PBB2KAVZ88,100,960
D1018,5,02/11/2021,PBB4KB0CIS,100,860
D1018,5,02/11/2021,PBB5KB2O9J,860,0
D1018,6,02/12/2021,PBC2M802GO,100.00,"3050"
D1018,6,02/12/2021,PBC8M811L0,10.00,"3040"
D1018,6,02/14/2021,PBE6OK88MO,100.00,"2940"
D1018,6,02/14/2021,PBE5OK9PNJ,10,"2930"
D1018,6,02/17/2021,PBH7RI96QV,100,"2830"
D1018,6,02/17/2021,PBH1RIB2BH,100,"2730"
D1018,6,02/17/2021,PBH2RID6VC,20,"2710"
D1018,6,03/02/2021,PC248LO2YA,100,"2610"
D1018,6,03/02/2021,PC228LQHNC,10,"2600"
D1018,6,03/08/2021,PC80GL934C,"2600",0
D1018,7,03/23/2021,PCN11B647H,100.00,"3150"
D1018,7,03/24/2021,PCO22LLL20,100.00,"3050"
D1018,7,03/26/2021,PCQ24MV7J4,100.00,"2950"
D1018,7,03/30/2021,PCU99M160L,100,"2850"
D1018,7,03/31/2021,PCV0BIK2CM,100,"2750"
D1018,7,04/06/2021,PD60ILTP4S,2750,0
D1018,8,04/07/2021,PD78KNP82K,100.00,"3300"
D1018,8,04/08/2021,PD84M0BMLS,100.00,"3200"
D1018,8,04/20/2021,PDK72DZLH9,100.00,"3100"
D1018,8,04/21/2021,PDL23SPCW2,100,"3000"
D1018,8,04/23/2021,PDN95RLJXT,100,"2900"
D1018,8,05/05/2021,PE57LR54NH,900,"2000"
D1018,8,05/05/2021,PE53M9Y9IV,1550,450
D1018,8,05/06/2021,PE66N1CIA2,450,0
D1018,9,05/07/2021,PE78P0OCF2,100.00,"3150"
D1018,9,05/09/2021,PE92ROB0FK,98.00,"3052"
D1018,9,05/10/2021,PEA0SZW51O,102.00,"2950"
D1018,9,05/26/2021,PEQ8DQ825Y,100,"2850"
D1018,9,05/27/2021,PER9EZ74WH,200,"2650"
D1018,9,05/28/2021,PES2GA5L7S,100,"2550"
D1018,9,05/28/2021,PES5GAJD39,100,"2450"
D1018,9,05/29/2021,PET5HM6M3F,100,"2350"
D1018,9,06/01/2021,PF17LVIMRN,100,"2250"
D1018,9,06/04/2021,PF48Q533FQ,2250,0
D1018,10,06/05/2021,PF57S81IGV,100.00,"3125"
D1018,10,07/02/2021,PG22TTJUHI,"3125.00",0
D1018,11,07/03/2021,PG33W2VOQD,100.00,"3800"
D1018,11,07/31/2021,PGV210VOI8,100.00,"3700"
D1018,11,07/31/2021,PGV610YG2I,100.00,"3600"
D1018,11,07/31/2021,PGV6113RUE,3600,0
D1018,12,09/04/2021,PI45GM3WRP,300.00,"4500"
D1018,12,09/06/2021,PI62KO8U00,100.00,"4400"
D1018,12,09/06/2021,PI60KOAPVU,100.00,"4300"
D1018,12,09/08/2021,PI88MW6USA,100,"4200"
D1018,12,09/08/2021,PI83MW9Y9H,100,"4100"
D1018,12,09/09/2021,PI98O5BM56,100,"4000"
D1018,12,09/09/2021,PI96O5MA78,85,"3915"
D1018,12,09/13/2021,PID2TVNZUY,100,"3815"
D1018,12,09/13/2021,PID6TVQJVU,50,"3765"
D1018,12,09/15/2021,PIF4YCA5LC,100,"3665"
D1018,12,09/15/2021,PIF3YCC06T,40,"3625"
D1018,12,09/16/2021,PIG6ZM2R4Q,100,"3525"
D1018,12,09/16/2021,PIG7ZMACI5,40,"3485"
D1018,12,09/18/2021,PII03VA42A,100,"3385"
D1018,12,09/20/2021,PIK961QXD5,100,"3285"
D1018,12,09/30/2021,PIU0L6Z6PW,100,"3185"
D1018,12,09/30/2021,PIU7L71Y13,95,"3090"
D1018,12,10/04/2021,PJ45RPA48B,100,"2990"
D1018,12,10/05/2021,PJ54U3R1EO,100,"2890"
D1018,12,10/05/2021,PJ57U3RQOR,50,"2840"
D1018,12,10/08/2021,PJ87Y0CHTF,100,"2740"
D1018,12,10/08/2021,PJ88Y0GVXO,50,"2690"
D1018,12,10/14/2021,PJE98HALC1,100,"2590"
D1018,12,10/21/2021,PJL2JDB054,100,"2490"
D1018,12,10/21/2021,PJL7JDE6NH,50,"2440"
D1018,12,10/25/2021,PJP2PAMGW2,100,"2340"
D1018,12,10/25/2021,PJP6PAP0U6,50,"2290"
D1018,12,10/28/2021,PJS8V2QXCY,100,"2190"
D1018,12,10/29/2021,PJT8W0K3CG,100,"2090"
D1018,12,11/01/2021,PK131VVK41,100,"1990"
D1018,12,11/01/2021,PK101VYKLI,50,"1940"
D1018,12,11/04/2021,PK4070C0K6,100,"1840"
D1018,12,11/04/2021,PK4470EV2A,50,"1790"
D1018,12,11/10/2021,PKA8H218OG,100,"1690"
D1018,12,11/12/2021,PKC4KA8DXA,100,"1590"
D1018,12,11/13/2021,PKD5LPND2L,100,"1490"
D1018,12,11/18/2021,PKI1TB2KU9,1490,0
D1018,13,01/20/2022,QAK4VPHLNM,100.00,"3800"
D1018,13,01/20/2022,QAK8VPOUOY,30.00,"3770"
D1018,13,01/21/2022,QAL7XMXIQZ,100.00,"3670"
D1018,13,01/21/2022,QAL6XN55HS,30,"3640"
D1018,13,01/22/2022,QAM8ZNQMSO,100,"3540"
D1018,13,01/22/2022,QAM8ZO6T04,20,"3520"
D1018,13,01/23/2022,QAN325S8PZ,100,"3420"
D1018,13,01/23/2022,QAN225Y7E0,40,"3380"
D1018,13,01/24/2022,QAO73O3D59,100,"3280"
D1018,13,01/24/2022,QAO23O8SMC,30,"3250"
D1018,13,01/25/2022,QAP9562O75,100,"3150"
D1018,13,01/25/2022,QAP3565HW3,30,"3120"
D1018,13,01/26/2022,QAQ46GBHZY,30,"3090"
D1018,13,01/26/2022,QAQ06GSHQM,3,"3087"
D1018,13,01/26/2022,QAQ16GV7SD,97,"2990"
D1018,13,01/27/2022,QAR77Z8T8F,100,"2890"
D1018,13,01/27/2022,QAR67ZBMGU,30,"2860"
D1018,13,01/28/2022,QAS89YUZKU,100,"2760"
D1018,13,01/28/2022,QAS59YXVRB,30,"2730"
D1018,13,01/29/2022,QAT0CIJQIC,100,"2630"
D1018,13,01/29/2022,QAT9CINNFD,30,"2600"
D1018,13,01/30/2022,QAU8E7H1E0,100,"2500"
D1018,13,01/30/2022,QAU9E7O2IT,30,"2470"
D1018,13,1/31/2022,QAV1FY3YPZ,100,"2370"
D1018,13,1/31/2022,QAV8FYIVYQ,30,"2340"
D1018,13,2/2/2022,QB22JN3EEY,100,"2240"
D1018,13,2/4/2022,QB41LS767R,100,"2140"
D1018,13,2/4/2022,QB47LSB7KZ,60,"2080"
D1018,13,2/4/2022,QB42MZ2I1Y,100,"1980"
D1018,13,02/05/2022,QB58P90UMM,100,"1880"
D1018,13,02/05/2022,QB50P93A6C,60,"1820"
D1018,13,02/08/2022,QB80T6SGQA,60,"1760"
D1018,13,02/08/2022,QB85T6QWSJ,100,"1660"
D1018,13,2/8/2022,QB89U844P3,100,"1560"
D1018,13,2/9/2022,QB96WOKMOY,100,"1460"
D1018,13,2/14/2022,QBE75EFH4R,100,"1360"
D1018,13,2/14/2022,QBE95EISTZ,100,"1260"
D1018,13,02/16/2022,QBG28XJTFS,100,"1160"
D1018,13,02/16/2022,QBG38XPA2F,100,"1060"
D1018,13,02/16/2022,QBG18XSG47,100,960
D1018,13,02/15/2022,QBF177N9KP,100,860
D1018,13,02/15/2022,QBF077QWCQ,100,760
D1018,13,02/17/2022,QBH7BCI3UD,960,200
D1018,14,02/22/2022,QBM5KWZN37,100.00,"3800"
D1018,14,02/22/2022,QBM5KX7VFT,30.00,"3770"
D1018,14,02/23/2022,QBN2MQYOPG,100.00,"3670"
D1018,14,02/23/2022,QBN5MR54JX,30,"3640"
D1018,14,02/24/2022,QBO1OGLF5F,100,"3540"
D1018,14,02/24/2022,QBO7OH9S09,30,"3510"
D1018,14,02/25/2022,QBP6QNY66G,100,"3410"
D1018,14,02/25/2022,QBP7QNZK7B,30,"3380"
D1018,14,02/26/2022,QBQ0SLY6FG,100,"3280"
D1018,14,02/26/2022,QBQ9SM128N,30,"3250"
D1018,14,03/02/2022,QC22ZN4XLQ,100,"3150"
D1018,14,03/02/2022,QC20ZPWXVS,100,"3050"
D1018,14,08/17/2022,QHH4CK0O3K,3050,0
D1019,1,10/14/2020,OJE6HNY2VE,"27200.00",0
D1020,1,09/01/2020,OI145KCVZQ,"11600.00",0
D1020,2,09/29/2020,OIT4ZF915E,"12600.00",0
D1020,3,10/28/2020,OJS4WWPSDE,"19200.00",0
D1020,4,12/29/2020,OLS02Q7YW4,"19500.00",0
D1020,5,01/27/2021,PAR01MIJBE,"13900.00","5600"
D1020,5,01/27/2021,PAR11N3EYL,"5000",600
D1020,5,01/27/2021,PAR51NA9T3,700,100
D1020,6,02/24/2021,PBO01DXO5E,"19000.00","7000"
D1020,6,02/25/2021,PBP81VJCJ6,"6000","1000"
D1020,6,02/25/2021,PBP01VNZI2,"1000",0
D1020,7,03/25/2021,PCP136GP5V,"10000.00","16000"
D1020,7,03/25/2021,PCQ54ECCWB,"16000",0
D1020,8,04/24/2021,PDO56T2SVT,"39000.00",0
D1020,9,05/22/2021,PEM78TIIU9,"25800.00",0
D1020,10,06/18/2021,PFI7AMGPGD,"39000.00",0
D1020,11,07/12/2021,PGC094BLPK,"43750.00",0
D1020,12,09/02/2021,PENALTY WAIVED,"5600.00","45500"
D1020,12,09/02/2021,PI21DS3MG9,"45000",500
D1020,12,09/02/2021,PI24DSB3C2,500,0
D1020,13,12/06/2022,QL69I6ODZX,"26000.00",0
D1020,14,01/05/2023,RA51Q06987,"26000.00",0
D1020,15,02/04/2022,RB45W16MXL,"26000.00","1200"
D1020,15,02/06/2023,RB671PMKAJ,"1200",0
D1020,16,03/07/2023,RC778IZWXL,"6000.00","20000"
D1020,16,03/07/2023,RC788IZWOG,"20000",0
D1020,17,04/07/2023,RD78KU6NPY,"20000.00","7200"
D1020,17,04/07/2023,RD77MB44BF,"20000","12800"
D1020,17,04/11/2023,RDB6Y5NX3I,"5500","18300"
D1021,1,08/27/2020,OHR6YZW9R4,500.00,"4700"
D1021,1,09/03/2020,OI327O7BLM,250.00,"4450"
D1021,1,09/07/2020,OI73BL36ST,"1250.00","3200"
D1021,1,09/14/2020,OIE3J055NL,"3200.00",0
D1021,2,09/25/2020,OIP1UQOJC5,100.00,"5100"
D1021,2,09/25/2020,OIP2UQRQGW,100.00,"5000"
D1021,2,09/29/2020,OIT3ZWAR6D,300.00,"4700"
D1021,2,10/12/2020,OJC2FAGYCA,2700,"2000"
D1021,2,10/12/2020,OJC8FCA92U,2000,0
D1021,3,11/09/2020,OK98C0HA3Q,"5200.00",0
D1021,4,12/07/2020,OL73AP556R,"5200.00",0
D1021,5,01/04/2021,PA43ASAOSD,"5200.00",0
D1021,6,02/01/2021,PB1480YO5I,"6500.00",0
D1021,7,02/03/2021,PC298RCBSD,"6800.00",0
D1021,8,04/09/2021,PD96MS4B42,500.00,"7400"
D1021,8,05/04/2021,PE43JSWTCX,100.00,"7300"
D1021,8,05/05/2021,PE59LQZFZR,100,"7200"
D1021,8,05/19/2021,PEK76DXGVN,100,"7100"
D1021,8,05/19/2021,PEK46E18M8,100,"7000"
D1021,8,05/27/2021,PER3FQO5J9,100,"6900"
D1021,8,06/10/2021,PFA8YCTFRQ,100,"6800"
D1021,8,06/10/2021,PFA2YCW7L6,100,"6700"
D1021,8,07/23/2021,PGN7OKF6Z7,100,"6600"
D1021,8,09/16/2021,PIG3YXVCZD,100,"6500"
D1021,8,10/05/2021,PJ52SXP48Y,50,"6450"
D1021,8,10/07/2021,PJ72WJ4MEQ,50,"6400"
D1021,8,10/08/2021,PJ82XJLI24,100,"6300"
D1021,8,10/08/2021,PJ88Y0K8I8,20,"6280"
D1021,8,10/13/2021,PJD87FFR3Q,30,"6250"
D1021,8,10/15/2021,PJF6AI0TXQ,10,"6240"
D1021,8,10/14/2021,PJE78R9GD9,50,"6190"
D1021,8,10/16/2021,PJG5BL7RUT,20,"6170"
D1021,8,10/22/2021,PJM0LBM3SK,20,"6150"
D1021,8,10/29/2021,PJT9WBGR9T,50,"6100"
D1021,8,10/30/2021,PJU3XNEF99,100,"6000"
D1021,8,11/01/2021,PK152DLZVD,50,"5950"
D1021,8,11/03/2021,PK335FX7X5,50,"5900"
D1021,8,11/05/2021,PK5098MYOS,50,"5850"
D1021,8,11/09/2021,PK91FOA8VX,25,"5825"
D1021,8,11/10/2021,PKA0H6F63S,50,"5775"
D1021,8,11/11/2021,PKB6IM290K,50,"5725"
D1021,8,11/12/2021,PKC3KCRV1H,50,"5675"
D1021,8,11/13/2021,PKD9LLQ85N,50,"5625"
D1021,8,11/15/2021,PKF6P4J2ME,20,"5605"
D1021,8,11/15/2021,PKF5P6PIBZ,30,"5575"
D1021,8,11/16/2021,PKG9QNFH6R,50,"5525"
D1021,8,11/18/2021,PKI8TGBGOM,50,"5475"
D1021,8,11/18/2021,PKI7TLRE0V,100,"5375"
D1021,8,11/19/2021,PKJ5V99J25,50,"5325"
D1021,8,11/20/2021,PKK0X40YM2,50,"5275"
D1021,8,11/22/2021,PKM41QTKJ4,50,"5225"
D1021,8,11/24/2021,PKO84Y2LDY,100,"5125"
D1021,8,11/25/2021,PKP26R52WA,50,"5075"
D1021,8,11/26/2021,PKQ48KAQZA,50,"5025"
D1021,8,11/27/2021,PKR0A453AS,50,"4975"
D1021,8,11/29/2021,PKT5CYJK0F,100,"4875"
D1021,8,12/01/2021,PL10H1ZSOA,100,"4775"
D1021,8,12/06/2021,PL66PM2OLW,100,"4675"
D1021,8,12/04/2021,PL43LM4M7R,100,"4575"
D1021,8,12/07/2021,PL79RNTZHX,50,"4525"
D1021,8,12/09/2021,PL98V8MNAO,50,"4475"
D1021,8,12/10/2021,PLA2X3PAHO,100,"4375"
D1021,8,12/11/2021,PLB2YHAUPG,50,"4325"
D1021,8,12/13/2021,PLD92SY3L1,50,"4275"
D1021,8,12/18/2021,PLI0BBNA3M,50,"4225"
D1021,8,12/28/2021,PLS5SBYVN3,50,"4175"
D1021,8,01/06/2022,QA637VQV7V,100,"4075"
D1021,8,01/07/2022,QA78A0VB7Y,50,"4025"
D1021,8,01/08/2022,QA81BDS0JP,80,"3945"
D1021,8,01/11/2022,QAB0GP9AJG,70,"3875"
D1021,8,01/14/2022,QAE2LIPXTG,100,"3775"
D1021,8,01/26/2022,QAQ96UIQWH,50,"3725"
D1021,8,01/28/2022,QAS1A6JJ3J,20,"3705"
D1021,8,01/31/2022,QAV3FASEC9,50,"3655"
D1021,8,02/01/2022,QB19H4E0T5,50,"3605"
D1021,8,02/05/2022,QB57O9BG61,50,"3555"
D1021,8,02/07/2022,QB75SBOVBZ,50,"3505"
D1021,8,02/08/2022,QB86TVGLGI,50,"3455"
D1021,8,02/10/2022,QBA9XTS81Z,50,"3405"
D1021,8,02/16/2022,QBG39GQ4HV,50,"3355"
D1021,8,02/18/2022,QBI4CLFA2Y,50,"3305"
D1021,8,02/18/2022,QBI6DCC2UC,50,"3255"
D1021,8,02/23/2022,QBN4MDFALS,50,"3205"
D1021,8,02/28/2022,QBS2VIL4B2,50,"3155"
D1021,8,03/04/2022,QC493XAQN9,50,"3105"
D1021,8,03/14/2022,QCE9NT30HR,100,"3005"
D1021,8,03/23/2022,QCN35F1CDR,100,"2905"
D1021,8,03/26/2022,QCQ9BR5KO7,100,"2805"
D1021,8,04/05/2022,QD53V6YR7N,100,"2705"
D1021,8,04/09/2022,QD9644BIPY,100,"2605"
D1021,8,05/10/2022,QEA1RQDKBJ,50,"2555"
D1021,8,05/11/2022,QEB0TVQ8VU,40,"2515"
D1021,8,05/23/2022,QEN2HOA0EM,50,"2465"
D1021,8,06/10/2022,QFA5I1MMP7,50,"2415"
D1021,8,08/20/2022,QHK1IKL679,50,"2365"
D1021,8,08/29/2022,QHT9187PV7,50,"2315"
D1021,8,09/12/2022,QIC1TEWH6D,50,"2265"
D1022,1,08/18/2020,OHI5QHRZTV,217.00,"6283"
D1022,1,08/19/2020,OHJ6RKMVK6,217.00,"6066"
D1022,1,08/21/2020,OHL0TLREBS,217.00,"5849"
D1022,1,08/22/2020,OHM8UPD45Q,217.00,"5632"
D1022,1,08/24/2020,OHO3WI0CAL,217.00,"5415"
D1022,1,08/27/2020,OHR2YUL31I,886.00,"4529"
D1022,1,08/30/2020,OHU53QDJ77,434.00,"4095"
D1022,1,08/31/2020,OHV84OFQ5E,434.00,"3661"
D1022,1,09/03/2020,OI397VOFS9,434.00,"3227"
D1022,1,09/07/2020,OI71C7V41V,434,"2793"
D1022,1,09/10/2020,OIA3FE2X6N,434,"2359"
D1022,1,09/14/2020,OIE0JMOP9G,"2359",0
D1022,2,09/23/2020,OIN8SMF3PU,"1300.00","5200"
D1022,2,09/30/2020,OIU71WHPRZ,"2000.00","3200"
D1022,2,10/11/2020,OJB0EM4UPK,"3000.00",200
D1022,2,10/12/2020,OJC1F79G4F,200,0
D1022,3,10/30/2020,OJU3YNX8SH,"4000.00","2500"
D1022,3,11/09/2020,OK99CC9795,"2500.00",0
D1022,4,12/08/2020,OL81C3PKR9,"6500.00",0
D1022,5,12/24/2020,0LO5WAQDDB,"6500.00",0
D1022,6,01/19/2021,PAJ3RZ4OZX,"6500.00",0
D1022,7,01/28/2021,PAS33PW6AH,"1612.00","4888"
D1022,7,02/16/2021,PBG4QIGVM6,"5000.00",112
D1022,8,03/15/2021,PCF9PGFW8X,"6500.00",0
D1022,9,04/03/2021,PD36ES07BG,"7200.00",0
D1022,10,04/23/2021,PDN25YTK9U,"7300.00",20
D1022,10,04/23/2021,PDN75YZXV9,20.00,0
D1022,11,05/17/2021,PEH32E83QP,"7440.00",0
D1022,12,06/10/2021,PFA7YA4WJ3,"13000.00",0
D1022,13,06/30/2021,PFU6QL7QOW,"12100.00",0
D1022,14,07/22/2021,PGM5MU6CKZ,"14760.00",0
D1022,15,08/11/2021,PHB0HGGLJ6,"14520.00",0
D1022,16,09/02/2021,PI20DLF8NA,"2500.00","16700"
D1022,16,09/06/2021,PI67KP0E6H,"1600.00","15100"
D1022,16,09/14/2021,PIE8WSN32U,700,"14400"
D1022,16,09/17/2021,PIH8253R42,500,"13900"
D1022,16,09/21/2021,PIL576SO0Z,250,"13650"
D1022,16,10/08/2021,PJ84YFDBAQ,300,"13350"
D1022,16,10/18/2021,PJI4EM3LTA,600,"12750"
D1022,16,10/26/2021,PJQ1REJ4MP,200,"12550"
D1022,16,10/30/2021,PJU5Y24M9J,200,"12350"
D1022,16,11/08/2021,PK89DVI737,200,"12150"
D1022,16,11/12/2021,PKC1JPW4IN,200,"11950"
D1022,16,11/16/2021,PKG0Q97KXK,200,"11750"
D1022,16,11/16/2021,PKG1Q9HNNN,100,"11650"
D1022,16,11/18/2021,PKI2TE28TA,200,"11450"
D1022,16,11/20/2021,PKK1X7BQRH,100,"11350"
D1022,16,11/27/2021,PKR09WXW7C,357,"10993"
D1022,16,12/06/2021,PL60PIJSA0,302,"10691"
D1022,16,12/09/2021,PL92UU6V1O,300,"10391"
D1022,16,12/11/2021,PLB9YP8CXR,200,"10191"
D1022,16,01/06/2022,QA6080IK4K,477,"9714"
D1022,16,01/13/2022,QAD6J86508,200,"9514"
D1022,16,01/14/2022,QAE2LHABLC,207,"9307"
D1022,16,01/20/2022,QAK8V3KYX2,207,"9100"
D1022,16,01/31/2022,QAV6ELUK6A,207,"8893"
D1022,16,02/07/2022,QB77RWUX8H,200,"8693"
D1022,16,03/03/3033,QC3828ON7E,207,"8486"
D1022,16,03/07/2022,QC72AG35RG,207,"8279"
D1022,16,03/14/2022,QCE9NXBO0N,207,"8072"
D1022,16,03/28/2022,QCS3EMW25X,100,"7972"
D1022,16,03/28/2022,QCS6EN0R7K,100,"7872"
D1022,16,05/11/2022,QEB5TJ1S99,200,"7672"
D1022,16,07/18/2022,QGI8NN1ZXS,200,"7472"
D1022,16,08/24/2022,QHO0PWUDUU,150,"7322"
D1022,16,09/07/2022,QI78J8V4BU,150,"7172"
D1022,16,09/20/2022,QIK2C5JRZE,100,"7072"
D1022,16,09/23/2022,QIN5I1WD9H,100,"6972"
D1022,16,09/26/2022,QIQ1PGKDYD,100,"6872"
D1022,16,10/04/2022,QJ468H724I,100,"6772"
D1022,16,10/18/2022,QJI5545DQH,200,"6572"
D1022,16,10/25/2022,QJP4KEUSNE,100,"6472"
D1022,16,12/13/2022,QLD12RKYQH,100,"6372"
D1022,16,12/20/2022,QLK4LT2BDI,100,"6272"
D1022,16,12/31/2022,RAV0KRAWQ0,70,"6202"
D1022,16,02/10/2023,RBA0CAGUW0,100,"6102"
D1022,16,03/25/2023,RCP8LWALTA,100,"6002"
D1022,16,03/28/2023,RCS2T4QAYY,100,"5902"
D1022,16,04/15/2023,RDF98OTFEJ,100,"5802"
D1022,16,04/17/2023,RDH2EM57EK,100,"5702"
D1022,16,05/02/2023,RE25JJ0YEJ,50,"5652"
D1022,16,05/06/2023,RE67UY83AR,50,"5602"
D1022,16,05/25/2023,REP8EL0X32,50,"5552"
D1022,16,06/23/2023,RFN3R4OJ3V,100,"5452"
D1022,16,07/28/2023,RGS3MHLA17,100,"5352"
D1022,16,08/14/2023,RHE23T2MS8,100,"5252"
D1022,16,08/18/2023,RHI9FOZLYF,50,"5202"
D1023,1,08/25/2020,OHP9WWP217,"3250.00","10350"
D1023,1,09/10/2020,OIA8F0SBVI,"2000.00","8350"
D1023,1,09/16/2020,OIG7LAU0T7,"4500.00","3850"
D1023,1,09/17/2020,OIH9MIRZL1,"3850.00",0
D1023,2,09/28/2020,OIS7XR04KN,"3250.00","8950"
D1023,2,10/01/2020,OJ112BIN3J,"3250.00","5700"
D1023,2,10/07/2020,OJ709TALNI,"5000.00",700
D1023,2,10/08/2020,OJ82AJ5EIG,700,0
D1023,3,10/28/2020,OJS8WJADRW,"4000.00","10600"
D1023,3,11/13/2020,OKD3GNOWNZ,"1500.00","9100"
D1023,3,11/16/2020,OKG4KAY8CA,"4000.00","5100"
D1023,3,11/21/2020,OKL8PP23C6,2000,"3100"
D1023,3,11/23/2020,OKN6S12FO6,3100,0
D1023,4,12/15/2020,OLF4KBFA30,"3800.00","10800"
D1023,4,12/17/2020,OLH9MVMZYP,"4800.00","6000"
D1023,4,12/29/2020,OLT437XHKY,"6000.00",0
D1023,5,01/21/2021,PAL8U749IK,"1500.00","5000"
D1023,5,01/23/2021,PAN2WEXNPA,"5000.00",0
D1023,6,02/08/2021,PB97HFOVEV,"2000.00","7520"
D1023,6,02/15/2021,PBF3OUMFB1,"2500.00","5020"
D1023,6,02/18/2021,PBI0SHJT20,"2900.00","2120"
D1023,6,02/21/2021,PBL7W55XN9,"1700",420
D1023,6,2/22/2021,PBM8XK5514,430,10
D1023,7,03/15/2021,PCF8P2HRCA,"2000","7100"
D1023,7,03/22/2021,PCM0YA79IC,"7100.00",0
D1023,8,04/19/2021,PDJ0ZGHQNI,"13000",0
D1023,9,05/17/2021,PEH62KUU8G,"13000",0
D1023,10,06/15/2021,PFF15V289V,"8000","5600"
D1023,10,06/17/2021,PFH28S4GM4,"5600.00",0
D1023,11,07/12/2021,PGC78WWP8H,"13000",0
D1023,12,08/10/2021,PHA4FLFJKE,"16320",0
D1023,13,09/07/2021,PI77LEI2MF,"15600",0
D1023,14,10/02/2021,PJ22O374DG,"15240",0
D1023,15,11/01/2021,PK101O8C5K,"10000","6320"
D1023,15,11/03/2021,PK334W1V6T,"2300.00","4020"
D1023,15,11/03/2021,PK385GU1MY,"4030.00",10
D1023,16,11/26/2021,PKQ47KRT1K,"2200","14120"
D1023,16,12/01/2021,PL18G1529K,"6300.00","7820"
D1023,16,12/04/2021,PL43LX6T0J,"7820.00",0
D1023,17,01/06/2022,QA678DBAOL,"16320",0
D1023,18,02/05/2022,QB55NSPI4H,"3000","13320"
D1023,18,02/07/2022,QB79RIZTHX,"2300.00","11020"
D1023,18,02/08/2022,QB87TC9OVH,"11020.00",0
D1023,19,03/11/2022,QCB4I7KR6Q,"16320",0
D1023,20,04/12/2022,QDC89OMLHA,"16320",0
D1023,21,05/12/2022,QEC6VQHE6M,"16320",0
D1023,22,06/09/2022,QF91FDSLF9,"15600",0
D1023,23,08/03/2022,QH30KD2XPC,"2000","21700"
D1023,23,08/05/2022,QH57PECHE5,"1000.00","20700"
D1023,23,08/20/2022,QHK9ISU7ZB,"2000.00","18700"
D1023,23,09/10/2022,QIA5PTVMHB,2000,"16700"
D1024,1,09/08/2020,OI87DE177Z,800.00,"12200"
D1024,1,09/09/2020,OI93EG30YL,800.00,"11400"
D1024,1,09/10/2020,OIA1FJH6PJ,800.00,"10600"
D1024,1,09/14/2020,OIE0JPTJ26,800.00,"9800"
D1024,1,09/15/2020,OIF4JVYOJ2,"1000.00","8800"
D1024,1,09/15/2020,OIF8KT4GHC,540.00,"8260"
D1024,1,09/17/2020,OIH9M58FOZ,"8250.00",10
D1024,1,09/17/2020,OIH0M6DCAM,10.00,0
D1024,2,10/16/2020,OJG4JKJ39E,"13000.00",0
D1024,3,11/12/2020,OKC3FAACUV,600.00,"12400"
D1024,3,11/14/2020,OKE1HN7DT7,12400,0
D1024,4,12/05/2020,OL598TTW6Z,500.00,"12300"
D1024,4,12/7/2020,OL77A9FQ2F,500,"11800"
D1024,4,12/10/2020,OLA4F9Y09M,"11800",0
D1024,5,01/08/2021,PA82F09LRA,"12900.00",0
D1024,6,01/21/2021,PAL1US6KYX,500.00,"14980"
D1024,6,1/23/2021,PAN3X4NTOZ,250,"14730"
D1024,6,1/24/2021,PAO4XQZJJC,500,"14230"
D1024,6,02/05/2021,PB57CNJTL3,14224,6
D1024,6,02/05/2021,PB57CNMK9L,6,0
D1024,7,02/06/2021,PB69EXO4YZ,300.00,"15180"
D1024,7,3/5/2021,PC58CGMMLA,"15180",0
D1024,8,03/07/2021,PC78F7D9RC,250.00,"20150"
D1024,8,3/9/2021,PC92HFYTFW,400,"19750"
D1024,8,4/6/2021,PD67IUSW81,"19750",0
D1024,9,05/05/2021,PE59LGCQ7R,"19500.00",0
D1024,10,06/08/2021,PF86VSBILM,"2000.00","21700"
D1024,10,7/28/2021,PGS3WO1JQB,200,"21500"
D1024,10,8/2/2021,PH203O8NYS,"1000","20500"
D1024,10,11/05/2021,PK58875YCC,1000,"19500"
D1024,10,11/09/2021,PK93F2N8WN,5,"19495"
D1024,10,11/09/2021,PK92F2PTPQ,495,"19000"
D1024,10,11/16/2021,PKG3PL8EFP,500,"18500"
D1024,10,11/27/2021,PKR99N0CSH,50,"18450"
D1024,10,11/27/2021,PKR49N4BWA,950,"17500"
D1024,10,03/24/2022,QCO87NU7G0,100,"17400"
D1024,10,03/28/2022,QCS1FAFKKB,200,"17200"
D1025,1,08/26/2020,OHQ5XV3IT1,"2000.00","8080"
D1025,1,09/05/2020,OI569G9P0M,450.00,"7630"
D1025,1,09/09/2020,OI99DU1PTV,600.00,"7030"
D1025,1,09/14/2020,OIE9J9MNRT,"7030.00",0
D1025,2,10/13/2020,OJD5GNE3BD,"9760.00",0
D1025,3,11/03/2020,OK304LUF6E,"12200.00",0
D1025,4,11/30/2020,OKU810TLVC,"12800.00",0
D1025,5,12/31/2020,OLV85O578O,"13600.00",0
D1025,6,01/20/2021,PAK6SYMXOA,"10100.00","2000"
D1025,6,01/20/2021,PAK3T11EGR,2000,0
D1025,7,02/16/2021,PBG7Q9GCMR,"12800.00",0
D1025,8,03/17/2021,PCH3S818XP,"13000.00",0
D1025,9,04/09/2021,PD94MD5MMA,"14880.00",0
D1025,10,05/07/2021,PE71OHB351,"12900.00",0
D1025,11,06/04/2021,PF43Q5ENAZ,"12900.00",0
D1025,12,07/01/2021,PG13SIBFX3,"12800.00",0
D1025,13,07/31/2021,PGV416TJYU,"20400.00",0
D1026,1,08/29/2020,OHT91YV7NN,"11200.00",0
D1026,2,09/27/2020,OIR4WUPIKY,"12200.00",0
D1026,3,10/31/2020,OJV41XWRR4,"12700.00",0
D1026,4,12/06/2020,OL60A3JB1Q,"14800.00",320
D1026,4,12/07/2020,OL77AACTX3,320.00,0
D1026,5,12/10/2020,OLA8E5Z3AG,"5200.00",400
D1026,5,12/10/2020,OLA7E6SKN1,400.00,0
D1026,6,01/08/2021,PA86FBLONM,"15600.00",0
D1026,7,02/06/2021,PB65E0BRQH,"15600.00",0
D1026,8,02/20/2021,PBK7V2MGUL,"17250.00",0
D1026,9,03/18/2021,PCI9T1RUJD,"19050.00",0
D1026,10,04/07/2021,PD71JZT8NH,"18150.00",0
D1026,11,05/06/2021,PE61MMFOZN,"19500.00",0
D1026,12,05/29/2021,PET5HXKDPH,"25000.00",200
D1026,13,05/29/2021,PET5HXKDPH_D2,200.00,"31400"
D1026,13,11/17/2021,PKH5RRTYHB,100.00,"31300"
D1026,13,11/24/2021,PKO74JMW55,200.00,"31100"
D1026,13,01/03/2022,QA303601UU,150,"30950"
D1027,1,08/24/2020,OHO7W1OAOL,"3250.00","3250"
D1027,1,09/08/2020,OI85CR69H9,"1625.00","1625"
D1027,1,09/15/2020,OIF4KKNY9S,"1600.00",25
D1027,1,09/15/2020,OIF5KKS9MV,14.00,11
D1027,1,09/15/2020,OIF4KLOW8E,11.00,0
D1027,2,09/23/2020,OIN4SVYAM4,"1625.00","4875"
D1027,2,10/01/2020,OJ162885EY,"1625.00","3250"
D1027,2,10/03/2020,OJ304MFDTM,"1625.00","1625"
D1027,2,10/12/2020,OJC2F7D5D4,1625,0
D1027,3,10/21/2020,OJL4PBYZW2,"3250.00","3250"
D1027,3,10/26/2020,OJQ6V1CT5I,"1625.00","1625"
D1027,3,11/12/2020,OKC6F7MNN6,"1625.00",0
D1027,4,11/20/2020,OKK5OINAKP,"4876.00","4874"
D1027,4,11/27/2020,OKQ6VYMTFA,"2438.00","2436"
D1027,4,12/03/2020,OL335ASKG9,"2436.00",0
D1027,5,12/09/2020,OL97DP2D8B,"2438.00","7312"
D1027,5,12/17/2020,OLH8N37X02,"2438.00","4874"
D1027,5,12/23/2020,OLN6UPEHZK,"4874.00",0
D1027,6,12/29/2020,OLT93EK51B,"2438.00","7312"
D1027,6,01/06/2021,PA68D1VW42,"2275.00","5037"
D1027,6,01/07/2021,PA74DZP9CU,537.00,"4500"
D1027,6,01/07/2021,PA71DZYB7B,"4400",100
D1027,6,01/07/2021,PA74E048B2,50,50
D1027,6,01/07/2021,PA75E0ZX35,50,
D1027,7,01/14/2021,PAE0LUWO2Q,"2438.00","7312"
D1027,7,01/20/2021,PAK8SZC7QU,"2438.00","4874"
D1027,7,01/28/2021,PAS12UMVRJ,"2438.00","2436"
D1027,7,01/28/2021,PAS033FG9E,"2436",0
D1027,8,02/03/2021,PB35ANMUKF,"1625.00","4875"
D1027,8,02/10/2021,PBA3JP0NK1,"1625.00","3250"
D1027,8,02/17/2021,PBH6R94CJA,600.00,"2650"
D1027,8,02/18/2021,PBI3SOGQEF,"2650",0
D1027,9,02/23/2021,PBN3YIT44J,"1438.00","8312"
D1027,9,02/23/2021,PBN7YKUOWH,"1000.00","7312"
D1027,9,03/04/2021,PC49AZWJAN,"2438.00","4874"
D1027,9,03/11/2021,PCB4K1F166,"3400","1474"
D1027,9,03/11/2021,PCB0KG0MSE,1474,0
D1027,10,03/15/2021,PCF9PC3DPB,"3250.00","9750"
D1027,10,03/25/2021,PCP13SWMQZ,"3200.00","6550"
D1027,10,04/04/2021,PD40FVNT3E,400.00,"6150"
D1027,10,04/06/2021,PD65IV3LYX,500,"5650"
D1027,10,04/06/2021,PD65IWPY8X,3000,"2650"
D1027,10,04/07/2021,PD72KDQSR8,2600,50
D1027,10,04/08/2021,PD88LDLPQW,50,0
D1027,11,04/11/2021,PDB1PZN2U1,800.00,"8300"
D1027,11,04/13/2021,PDD8RBWNCS,"1000.00","7300"
D1027,11,04/14/2021,PDE5SWUPU5,600.00,"6700"
D1027,11,04/17/2021,PDH9XR568F,400,"6300"
D1027,11,04/19/2021,PDJ4Z1OPEA,400,"5900"
D1027,11,04/20/2021,PDK52A9V1H,1700,"4200"
D1027,11,04/22/2021,PDM23YR0TO,1500,"2700"
D1027,11,04/24/2021,PDO770K44R,1000,"1700"
D1027,11,04/30/2021,PDU3EHE4GX,1500,200
D1027,11,05/004/2021,PE48KCL9BK,200,0
D1027,12,05/09/2021,PE96QM2XN0,"3250.00","3250"
D1027,12,05/20/2021,PEK06FGKRQ,"1625.00","1625"
D1027,12,05/24/2021,PEO9BPB2AZ,"1625.00",0
D1027,13,05/28/2021,PES2H0WMPG,"1300.00","3900"
D1027,13,05/29/2021,PET2INNAX0,"1300.00","2600"
D1027,13,06/07/2021,PF72UWOASI,"1300.00","1300"
D1027,13,06/15/2021,PFF56GUZFX,1300,0
D1027,14,06/19/2021,PFJ8BO3UKA,"6500.00","6500"
D1027,14,07/03/2021,PG31VI5WO1,"4000.00","2500"
D1027,14,07/08/2021,PG803LS8VY,"2500.00",0
D1027,15,07/16/2021,PGG1EGU41B,"6500.00","6500"
D1027,15,07/18/2021,PGI4I8TEAK,"1000.00","5500"
D1027,15,07/29/2021,PGT1X7DSMX,"5500.00",0
D1027,16,08/05/2021,PH5395B4IV,"3900.00","11700"
D1027,16,08/05/2021,PH519A7YBZ,"3900.00","7800"
D1027,16,08/08/2021,PH82DI5QSW,"2000.00","5800"
D1027,16,08/10/2021,PHA9FZLFQH,4000,"1800"
D1027,16,08/13/2021,PHD8K9N08I,1800,0
D1027,17,08/17/2021,PHH1Q7DJE7,"6500.00","6500"
D1027,17,08/23/2021,PHN9YVFBSF,"3250.00","3250"
D1027,17,09/07/2021,PI75M3BYFF,"3250.00",0
D1027,18,09/16/2021,PIG4YSKIWW,"6500.00","6500"
D1027,18,10/08/2021,PJ82YD1GT4,"6500.00",0
D1027,19,10/16/2021,PJG9BGZ94J,"3900.00","12420"
D1027,19,11/06/2021,PK62B7F4LE,"7500.00","4920"
D1027,19,11/07/2021,PK76CMTN7I,"1000.00","3920"
D1027,19,11/08/2021,PK83DYTH23,3920,0
D1027,20,11/13/2021,PKD2LVWZYO,"6500.00","6500"
D1027,20,12/06/2021,PL66OVP40W,"6500.00",0
D1027,21,12/11/2021,PLB2Z312SI,"6500.00","6500"
D1027,21,12/21/2021,PLL5GJVCK7,"6500.00",0
D1027,22,12/28/2021,PLS5RXSJMB,"9100.00",0
D1027,23,01/08/2022,QA81C3BX2P,"3250.00","9750"
D1027,23,01/21/2022,QAL0WG1TWA,"9750.00",0
D1027,24,01/28/2022,QAS09NXLZE,"4875.00","14625"
D1027,24,02/04/2022,QB41N6G7OP,"4875.00","9750"
D1027,24,02/05/2022,QB56O53KJ0,"9750.00",0
D1027,25,02/12/2022,QBC039FPL2,"4875.00","14625"
D1027,25,02/16/2022,QBG4AB0W38,"2000.00","12625"
D1027,25,02/18/2022,QBI8CO3U4U,"12625.00",0
D1027,26,03/05/2022,QC526369YY,"19500.00",0
D1027,27,03/23/2022,QCN45G098Q,"3000.00","16500"
D1027,27,04/01/2022,QD10MUF4UO,16500,0
D1027,28,04/23/2022,QDN4TY5JL6,"5000.00","13900"
D1027,28,04/25/2022,QDP9X24KQJ,13900,0
D1027,29,05/23/2022,QEN4HK8572,"1000.00","20000"
D1027,29,06/04/2022,QF445JQUS6,500,"19500"
D1027,29,06/04/2022,QF456SKIA3,18000,"1500"
D1027,29,06/04/2022,QF496TL9SV,1500,0
D1028,1,08/25/2020,OHP9XDJUBD,625.00,"5875"
D1028,1,08/29/2020,OHT22F2LFC,"1000.00","4875"
D1028,1,09/03/2020,OI3877G5EE,"1625.00","3250"
D1028,1,09/12/2020,OIC4HI5E32,"1625.00","1625"
D1028,1,09/17/2020,OIH4M10JLG,825.00,800
D1028,1,09/18/2020,OII1NIES1H,100.00,700
D1028,1,09/18/2020,OII1NIHEXB,100.00,600
D1028,1,09/19/2020,OIJ2OBVG1O,600.00,0
D1028,2,09/26/2020,OIQ0WCEG6U,"1200.00","5300"
D1028,2,09/28/2020,OIS6YFM78A,100.00,"5200"
D1028,2,09/28/2020,OIS9YFV0EP,100.00,"5100"
D1028,2,09/28/2020,OIS0YG3EP8,100,"5000"
D1028,2,09/28/2020,OIS2YGCOL0,100,"4900"
D1028,2,09/28/2020,OIS8YGGRLO,25,"4875"
D1028,2,10/04/2020,OJ446PG44E,825,"4050"
D1028,2,10/05/2020,OJ537ROQEF,100,"3950"
D1028,2,10/05/2020,OJ547RVQ7Q,100,"3850"
D1028,2,10/05/2020,OJ557RYVND,100,"3750"
D1028,2,10/05/2020,OJ597S1JD1,100,"3650"
D1028,2,10/06/2020,OJ698W4HYT,100,"3550"
D1028,2,10/06/2020,OJ658W103B,100,"3450"
D1028,2,10/06/2020,OJ648VWX9G,100,"3350"
D1028,2,10/06/2020,OJ698VTVJL,100,"3250"
D1028,2,10/10/2020,OJA5DGUY1B,1625,"1625"
D1028,2,10/15/2020,OJF0IYSEGK,100,"1525"
D1028,2,10/15/2020,OJF2IYX778,100,"1425"
D1028,2,10/15/2020,OJF3IZ13VF,100,"1325"
D1028,2,10/15/2020,OJF6IZ6O58,25,"1300"
D1028,2,10/15/2020,OJF9IZJG01,100,"1200"
D1028,2,10/16/2020,OJG1K7RMZP,1200,0
D1028,3,10/23/2020,OJN9RR9JBB,"1850.00","7250"
D1028,3,11/01/2020,OK102SKHI0,100.00,"7150"
D1028,3,11/01/2020,OK192SPRJN,100.00,"7050"
D1028,3,11/01/2020,OK112SUUV5,100,"6950"
D1028,3,11/01/2020,OK112SYSLN,100,"6850"
D1028,3,11/01/2020,OK142T2RQI,100,"6750"
D1028,3,11/09/2020,OK93CB5XMP,1250,"5500"
D1028,3,11/13/2020,OKD4HHBW20,5500,0
D1028,4,12/08/2020,OL80BTU2ZS,"4500.00","4600"
D1028,4,12/08/2020,OL89CJ2K83,"4600.00",0
D1028,5,01/06/2021,PA58C23HJU,"9100.00",0
D1028,6,02/02/2021,PB289YSIG8,"9100.00",0
D1028,7,03/03/2021,PC37AN11Y3,"10400.00",0
D1028,8,04/01/2021,PD16BSBXFS,"13000.00",0
D1028,9,04/29/2021,PDT2D4DAIO,"13000.00",0
D1028,10,05/27/2021,PER8F94816,"13000.00",0
D1028,11,06/24/2021,PFO5IEL66Z,"15600.00",0
D1028,12,07/22/2021,PGM0N6493A,"15600.00",0
D1028,13,08/19/2021,PHJ9SAOUFH,"19500.00",0
D1028,14,09/16/2021,PIG0YYSUCW,"19500.00",0
D1028,15,10/09/2021,PJ94ZC6K1A,"21250.00",0
D1028,16,10/18/2021,PJI4EAUWN0,"19040.00",0
D1028,17,01/06/2022,QA657Y1P4T,"22100.00",0
D1028,18,02/17/2022,QBH3AUXVHR,"1000.00","30600"
D1028,18,02/19/2022,QBJ9FMETQN,"1150.00","29450"
D1028,18,02/21/2022,QBL0JAPK1K,1000,"28450"
D1028,18,02/22/2022,QBM1KL4C5J,1000,"27450"
D1028,18,02/24/2022,QBO1NWT5HZ,1000,"26450"
D1028,18,02/25/2022,QBP7PYEAM7,1000,"25450"
D1028,18,02/27/2022,QBR5T2R00H,1000,"24450"
D1028,18,02/28/2022,QBS4W8Y58C,1000,"23450"
D1028,18,03/01/2022,QC19YA0R3Z,850,"22600"
D1028,18,03/02/2022,QC251BFOE5,1000,"21600"
D1028,18,03/04/2022,QC415GM4GD,1000,"20600"
D1028,18,03/06/2022,QC609CDPC4,750,"19850"
D1028,18,03/07/2022,QC77BDQGGF,1000,"18850"
D1028,18,03/08/2022,QC83DEWIXD,850,"18000"
D1028,18,03/11/2022,QCB4J8DJYG,1000,"17000"
D1028,18,03/16/2022,QCG4SQ0KKK,1000,"16000"
D1028,18,03/21/2022,QCL731SL6D,1000,"15000"
D1028,18,03/23/2022,QCN86PGDBC,1000,"14000"
D1028,18,03/28/2022,QCS5FZGVKX,1000,"13000"
D1028,18,04/02/2022,QD24Q2LJ7Y,1000,"12000"
D1029,1,09/01/2020,OI195WG8LR,"1225.00","4625"
D1029,1,09/02/2020,OI256TJ9N9,400.00,"4225"
D1029,1,09/09/2020,OI91DVZJSP,500.00,"3725"
D1029,1,09/09/2020,OI96E0HANM,"1125.00","2600"
D1029,1,09/10/2020,OIA0ESHJPM,"2600.00",0
D1029,2,09/17/2020,OIH3MT5L6P,750.00,"5100"
D1029,2,09/18/2020,OII9NLI5VV,525.00,"4575"
D1029,2,09/19/2020,OIJ6O6RBFI,250.00,"4325"
D1029,2,09/19/2020,OIJ4O6W1FQ,95,"4230"
D1029,2,09/19/2020,OIJ3O8RPBD,30,"4200"
D1029,2,09/26/2020,OIQ6VQ5PGS,4200,0
D1029,3,10/08/2020,OJ81AJRPJ1,625.00,"5025"
D1029,3,10/08/2020,OJ81AJRPJ1_D2,"5025.00",0
D1029,4,10/21/2020,0JL8P9EMF8,"5700.00",0
D1029,5,11/01/2020,OK162OOV1O,"1650.00","4150"
D1029,5,11/04/2020,OK445V8JXS,"4150.00",0
D1029,6,11/18/2020,OKI8MMX54W,"5750.00",0
D1029,7,12/04/2020,OL40701XF4,"5850.00",0
D1029,8,12/24/2020,0LO5WCJZDJ,"6050.00",0
D1029,9,01/21/2021,PAL3U21F5Z,"6500.00",0
D1029,10,02/16/2021,PBG3QL6PPP,"6400.00",0
D1029,11,03/16/2021,PCG4QG0H2S,"7800.00",0
D1030,1,09/02/2020,OI216MYTUZ,"1350.00","5150"
D1030,1,09/03/2020,OI377LJ2E9,275.00,"4875"
D1030,1,09/08/2020,OI84DD3B1S,"1625.00","3250"
D1030,1,09/16/2020,OIG6L5E6MI,"1625.00","1625"
D1030,1,09/22/2020,OIM7RK814H,"1625.00",0
D1031,1,09/28/2020,OIS1Y29S5N,"6500.00",300
D1031,1,09/28/2020,OIS8Y84H14,300.00,0
D1031,2,10/30/2020,OJU4Z829FK,"6500.00",0
D1031,3,11/28/2020,OKS8YA7UN4,"6500.00",0
D1031,4,12/28/2020,OLS32DVMTL,"5000.00","2300"
D1031,4,01/02/2021,PA218CKNKX,500,"1800"
D1031,4,01/06/2021,PA62CXXHKW,400,"1400"
D1031,4,01/08/2021,PA89FDLO5L,400,"1000"
D1031,4,01/11/2021,PAB2IHNDH4,500,500
D1031,4,01/15/2021,PAF1N3XPST,500,0
D1031,5,02/12/2021,PBC0LP2LPQ,"6450.00",0
D1031,6,03/14/2021,PCE4OU1UE0,"6400.00",100
D1031,6,03/14/2021,PCE7OUPD4L,100,0
D1031,7,04/14/2021,PDE3SU526H,300.00,"6500"
D1031,7,04/17/2021,PDH6X1660A,6500,0
D1031,8,05/21/2021,PEL27YH2NO,100.00,"7200"
D1031,8,05/21/2021,PEL87ZUAR4,100,"7100"
D1031,8,05/26/2021,PEQ9E29WEN,200,"6900"
D1031,8,06/04/2021,PF40QEZ5BY,3944,"2956"
D1031,8,06/05/2021,PF50RBD5YK,2956,0
D1031,9,07/08/2021,PG944GMAXY,"1500.00","5800"
D1031,9,07/14/2021,PGE0BY9LNM,"5800",0
D1031,10,08/17/2021,PHH4PCZV06,"6500.00",300
D1031,11,08/18/2021,PHI0R99ZUU,300,0
D1031,11,10/05/2021,PJ53TH1GIH,100.00,"7800"
D1031,11,10/12/2021,PJC25K4IE6,100,"7700"
D1031,11,10/12/2021,PJC85K6LK6,7,"7693"
D1031,11,10/12/2021,PJC25K8ETG,100,"7593"
D1031,11,11/08/2021,PK86DOZGU8,60,"7533"
D1031,11,11/09/2021,PK97FGCKMH,40,"7493"
D1031,11,11/10/2021,PKA4HA9D5U,100,"7393"
D1031,11,11/11/2021,PKB6IVK01G,100,"7293"
D1031,11,11/13/2021,PKD9LLKLQF,100,"7193"
D1031,11,11/15/2021,PKF9P6Y12V,100,"7093"
D1031,11,11/16/2021,PKG6QNA86S,50,"7043"
D1031,11,11/18/2021,PKI9TLJT3N,100,"6943"
D1031,11,11/18/2021,PKI8U3I26E,5,"6938"
D1031,11,11/19/2021,PKJ2V8YL9E,100,"6838"
D1031,11,11/20/2021,PKK5X3X2RR,100,"6738"
D1031,11,11/22/2021,PKM11QKHP7,100,"6638"
D1031,11,11/23/2021,PKN13DS557,80,"6558"
D1031,11,11/24/2021,PKO857EVHO,90,"6468"
D1031,11,11/26/2021,PKQ38L3DBR,20,"6448"
D1031,11,11/27/2021,PKR9A4CIQJ,50,"6398"
D1031,11,11/30/2021,PKU2F2CCXI,20,"6378"
D1031,11,12/01/2021,PL13H1OM31,30,"6348"
D1031,11,12/04/2021,PL45LLYWNJ,65,"6283"
D1031,11,12/06/2021,PL66PT835G,100,"6183"
D1031,11,12/07/2021,PL77RNNUSL,50,"6133"
D1031,11,12/09/2021,PL92V88VQI,50,"6083"
D1031,11,12/10/2021,PLA6X3ZGRC,20,"6063"
D1031,11,12/11/2021,PLB7YH8KCL,70,"5993"
D1031,11,12/18/2021,PLI0BBE4GO,60,"5933"
D1031,11,12/22/2021,PLM6I4LYXG,10,"5923"
D1031,11,12/24/2021,PLO2LSWG3C,50,"5873"
D1031,11,12/30/2021,PLU7VXOTAP,50,"5823"
D1031,11,01/07/2022,QA769UQBU0,50,"5773"
D1031,11,01/08/2022,QA86BDWMLW,50,"5723"
D1031,11,01/11/2022,QAB6GPD2MS,50,"5673"
D1031,11,01/12/2022,QAC2IEJ4IO,50,"5623"
D1031,11,01/28/2022,QAS1A6F1S1,100,"5523"
D1031,11,01/31/2022,QAV9FGNIRF,20,"5503"
D1031,11,02/02/2022,QB21J5L1ZZ,50,"5453"
D1031,11,02/03/2022,QB36L349UO,50,"5403"
D1031,11,02/05/2022,QB51O96CPP,100,"5303"
D1031,11,02/08/2022,QB82UD47EY,50,"5253"
D1031,11,02/10/2022,QBA5XTFJT5,50,"5203"
D1031,11,02/11/2022,QBB3ZVUZMZ,50,"5153"
D1031,11,02/14/2022,QBE46BQ48E,50,"5103"
D1031,11,02/17/2022,QBH7BLYB87,50,"5053"
D1031,11,02/23/2022,QBN9MDAVP3,50,"5003"
D1031,11,02/25/2022,QBP5Q7Q23B,40,"4963"
D1031,11,03/26/2022,QCQ4BR9TRQ,50,"4913"
D1031,11,04/05/2022,QD56VCSR76,48,"4865"
D1031,11,04/09/2022,QD9548L0QB,50,"4815"
D1031,11,05/11/2022,QEB2TV645C,50,"4765"
D1032,1,08/30/2020,OHU738P52J,100.00,"6400"
D1032,1,08/30/2020,OHU938RT7F,17.00,"6383"
D1032,1,09/06/2020,OI65AW0A8P,"1617.00","4766"
D1032,1,09/14/2020,OIE4J1I9AM,"1620.00","3146"
D1032,1,09/23/2020,OIN4SD9UUE,"1620.00","1526"
D1032,1,09/28/2020,OIS7XZC2M3,"1526.00",0
D1032,2,10/15/2020,OJF5ISQNE1,950.00,"2950"
D1032,2,10/24/2020,OJO7SKMF9N,"1000.00","1950"
D1032,2,10/30/2020,OJU3Z7VFAZ,975.00,975
D1032,2,11/03/2020,OK304FMHDY,975,0
D1032,3,11/10/2020,OKA0DD83R6,"1650.00","4700"
D1032,3,11/18/2020,OKI7M80WTL,"1650.00","3050"
D1032,3,11/26/2020,OKQ8VUGFEM,"2275.00",775
D1032,3,11/26/2020,OKQ7VUQ6K9,775,0
D1032,4,12/04/2020,OL446NBJZA,"1650.00","4850"
D1032,4,12/11/2020,OLB9GBJ28N,"1750.00","3100"
D1032,4,12/18/2020,OLI2P3V3OQ,"1625.00","1475"
D1032,4,12/22/2020,OLM8TFRJAI,1625,150
D1032,5,12/30/2020,OLU654T9HW,"1500.00","5000"
D1032,5,01/13/2021,PAD4KS493K,"1800.00","3200"
D1032,5,01/19/2021,PAJ7RJ5BH3,"3200.00",0
D1032,6,01/29/2021,PAT94KBGAX,"1650.00","6250"
D1032,6,03/30/2021,PCU294SIT4,500.00,"5750"
D1032,6,04/13/2021,PDD2RKM2HY,"1000.00","4750"
D1032,6,05/11/2021,PEB8TW5NK4,3000,"1750"
D1033,1,09/07/2020,OI72BI3OJ2,"1650.00","4850"
D1033,1,09/14/2020,OIE2J3W40O,"1650.00","3200"
D1033,1,09/26/2020,OIQ5VS628F,"3200.00",0
D1033,2,10/12/2020,OJC1F4ED87,"2000.00","4400"
D1033,2,10/19/2020,OJJ7NGTL5X,"3000.00","1400"
D1033,2,10/22/2020,OJM8Q80ANG,"1400.00",0
D1033,3,11/09/2020,OK92CBW6MO,"5950.00",0
D1033,4,12/05/2020,OL568411G6,"4000.00","2500"
D1033,4,12/07/2020,OL73AQ0RLT,"2500",0
D1033,5,01/05/2021,PA56BPZOQ0,"6800.00",0
D1033,6,02/02/2021,PB279AX8P7,"6500.00",0
D1033,7,03/02/2021,PC238MGTPN,"7800.00",0
D1033,8,03/30/2021,PCU29JZ5JK,"7800.00",0
D1033,9,04/28/2021,PDS8BYU9W2,"10200.00",0
D1033,10,05/26/2021,PEQ2E6JEI6,"9750.00",0
D1033,11,06/18/2021,PFI4ANPLWI,"9300.00",0
D1033,12,07/17/2021,PGH8GFE5N0,"13600.00",0
D1033,13,08/12/2021,PHC3IR1AGL,"12800.00",0
D1033,14,09/09/2021,PI93OO2Y7R,"15600.00",0
D1033,15,10/07/2021,PJ77WIWPG9,"15600.00",0
D1033,16,11/04/2021,PK426Y86XK,"15600.00",0
D1033,17,12/02/2021,PL21IFS0X7,1.00,"15599"
D1033,17,12/02/2021,PL24IFW06S,"15600",1
D1033,18,12/29/2021,PLT7U9ADEV,"15480.00",0
D1033,19,01/25/2022,QAP84WFTPS,"15120.00",360
D1033,19,01/25/2022,QAP74XCLIT,360,0
D1033,20,02/22/2022,QBM5JUE0UH,"19500.00",0
D1033,21,03/14/2022,QCE5O06BM7,"5600.00",0
D1033,22,04/01/2022,QD11MAYMAD,"17850.00",150
D1033,22,04/01/2022,QD13MCGLU7,150,0
D1033,23,04/19/2022,QDJ9MSHUGL,"18000.00",0
D1033,24,05/14/2022,QEE5YPL893,"19050.00",0
D1033,25,06/08/2022,QF81E0KV7T,"19200.00",0
D1033,26,07/04/2022,QG42UT1BRY,"19400.00",0
D1033,27,07/25/2022,QGP72UQ51X,"6100.00",0
D1033,28,08/22/2022,QHM6M93A4S,"19500.00",0
D1033,29,09/07/2022,QI73JVHB7D,"18000.00",0
D1033,30,10/04/2022,QJ17R3B3Z,"19350.00",0
D1033,31,10/25/2022,QJP6L26KS4,"24800.00",0
D1033,32,11/22/2022,QKM1G0VJA5,"26000.00",0
D1033,33,12/20/2022,QLK6LP00R8,"26000.00",0
D1033,34,1/17/2023,RAH4KG0WLU,"25800.00",0
D1033,35,2/14/2023,RBE2NF5SGK,"26000.00",0
D1033,36,3/14/2023,RCE9RLC97N,"26000.00",0
D1033,37,4/11/2023,RDB8VWKQW2,"11500.00",0
D1033,38,5/9/2023,RE974GHSFH,"26000.00",0
D1034,1,09/30/2020,OIU719BDH1,"27200.00",0
D1035,1,09/07/2020,OI70BKPKDQ,"1625.00","4875"
D1035,1,09/14/2020,OIE4J4GKWS,"1625.00","3250"
D1035,1,09/21/2020,OIL9QJVRRJ,"1600.00","1650"
D1035,1,09/28/2020,OIS3Y0RC69,"1650.00",0
D1035,2,10/05/2020,OJ5076IFI6,"1625.00","4875"
D1035,2,10/12/2020,OJC0FF1VC6,"1000.00","3875"
D1035,2,10/13/2020,OJD6GPE1U0,"1000.00","2875"
D1035,2,10/19/2020,OJJ5MZR7Y5,1350,"1525"
D1035,2,10/26/2020,OJQ5ULF4WN,1525,0
D1035,3,11/02/2020,OK243PZKRE,"1625.00","4875"
D1035,3,11/09/2020,OK93BUGLBT,"1450.00","3425"
D1035,3,11/16/2020,OKG1KA6YWT,"1600.00","1825"
D1035,3,11/20/2020,OKK8OPM7I2,1000,825
D1035,3,11/23/2020,OKN0S7RNWI,825,0
D1035,4,12/09/2020,OL98DCNQU4,"1500.00","5800"
D1035,4,12/16/2020,OLG3MQO7R7,625.00,"5175"
D1035,4,12/30/2020,OLU64D4YF6,725.00,"4450"
D1035,4,1/5/2021,PA44B7X9SG,1000,"3450"
D1035,4,1/11/2021,PAB5IETXQP,"3400",50
D1035,4,01/11/2021,PAB4IK6INY,50,0
D1035,5,01/12/2021,PAC6K8JL3U,400.00,"6100"
D1035,5,01/18/2021,PAI6QRV39K,825.00,"5275"
D1035,5,01/24/2021,PAO1X8DY3Z,300.00,"4975"
D1035,5,1/25/2021,PAP7YQOR0L,825,"4150"
D1035,5,2/5/2021,PB57COPLBT,"4150",0
D1035,6,02/12/2021,PBC6M48M50,500.00,"7300"
D1035,6,02/20/2021,PBK6UUI1HA,350.00,"6950"
D1035,6,02/23/2021,PBN4YFCIBO,"4000.00","2950"
D1035,6,2/26/2021,PBQ93O0IOP,"1000","1950"
D1035,6,3/5/2021,PC59CFAP6B,"1950",0
D1035,7,03/12/2021,PCC7LYS33X,500.00,"7240"
D1035,7,03/26/2021,PCQ746FDOZ,"4300.00","2940"
D1035,7,04/01/2021,PD15BVJOI7,"2940.00",0
D1035,8,04/08/2021,PD84LND41M,500.00,"8980"
D1035,8,04/16/2021,PDG5VENYPN,500.00,"8480"
D1035,8,04/29/2021,PDT5DMAX07,600.00,"7880"
D1035,8,5/3/2021,PE35INSYWP,"2000","5880"
D1035,8,5/7/2021,PE79O01D5B,500,"5380"
D1035,8,05/17/2021,PEH2231Q9Q,500,"4880"
D1035,8,05/18/2021,PEI73U40AF,500,"4380"
D1035,8,06/22/2021,PFM6FRLLGQ,500,"3880"
D1035,8,06/23/2021,PFN7HPNUJ3,200,"3680"
D1035,8,06/25/2021,PFP3JHKPED,300,"3380"
D1035,8,06/25/2021,PFP7KFLZWJ,100,"3280"
D1035,8,06/26/2021,PFQ3LXE753,200,"3080"
D1035,8,06/28/2021,PFS2OQ874S,150,"2930"
D1035,8,06/29/2021,PFT2Q8UB8O,200,"2730"
D1035,8,07/01/2021,PG14T1XB6O,300,"2430"
D1035,8,08/18/2021,PHI3QRAQDB,250,"2180"
D1035,8,08/23/2021,PHN0XQ6K50,250,"1930"
D1035,8,08/30/2021,PHU592TJDD,170,"1760"
D1035,8,09/20/2021,PIK76PZ7PT,100,"1660"
D1035,8,09/21/2021,PIL087Z9BA,100,"1560"
D1035,8,09/22/2021,PIM49Q16JI,100,"1460"
D1035,8,09/24/2021,PIO1CQ8SCF,150,"1310"
D1035,8,10/02/2021,PJ27P8QGBB,150,"1160"
D1035,8,10/03/2021,PJ34QWJ9Y4,100,"1060"
D1035,8,10/06/2021,PJ64UWYCMY,500,560
D1035,8,10/07/2021,PJ70X7CR4W,100,460
D1035,8,10/18/2021,PJI0FKK5N2,460,0
D1035,9,11/07/2022,QK78GSJJSI,150.00,"3630"
D1035,9,11/08/2022,QK83JM1I3F,150.00,"3480"
D1035,9,11/09/2022,QK99KE7YWR,130.00,"3350"
D1035,9,11/11/2022,QKB2QHWVCE,130,"3220"
D1035,9,11/12/2022,QKC0SVCI8S,130,"3090"
D1035,9,11/14/2022,QKE9VZAIWD,200,"2890"
D1035,9,11/15/2022,QKF2Y2BXUC,150,"2740"
D1035,9,11/16/2022,QKG01C0UGQ,150,"2590"
D1035,9,11/17/2022,QKH55J8GMF,120,"2470"
D1035,9,11/20/2022,QKK6C0EV4U,200,"2270"
D1035,9,11/21/2022,QKL6E5M17C,150,"2120"
D1035,9,11/22/2022,QKM1GYKLEV,200,"1920"
D1035,9,11/23/2022,QKN7JDYTBB,120,"1800"
D1035,9,11/26/2022,QKQ0QD08XU,280,"1520"
D1035,9,11/29/2022,QKT7XC23NT,300,"1220"
D1035,9,12/01/2022,QL182HOWNK,1220,0
D1035,10,12/02/2022,QL207451US,100.00,"3770"
D1035,10,12/02/2022,QL20749G9K,30.00,"3740"
D1035,10,12/04/2022,QL49DAVKZZ,100.00,"3640"
D1035,10,12/4/2022,QL44DB1F1I,30,"3610"
D1035,10,12/5/2022,QL52GRKZ1S,100,"3510"
D1035,10,12/05/2022,QL56GRX99C,50,"3460"
D1035,10,12/05/2022,QL54H13ZEE,50,"3410"
D1035,10,12/07/2022,QL78LYHNK8,100,"3310"
D1035,10,12/07/2022,QL77LYTSK5,30,"3280"
D1035,10,12/25/2022,QLP4Z24I82,2000,"1280"
D1035,10,12/27/2022,QLR04BDTD0,500,780
D1035,10,12/28/2022,QLS66KWI2I,300,480
D1035,10,12/29/2022,QLT69NOPIW,480,0
D1035,11,12/30/2022,QLU6C777LC,100.00,"3590"
D1035,11,12/30/2022,QLU0C7B92Y,30.00,"3560"
D1035,11,12/31/2022,QLV8FJWMFA,100.00,"3460"
D1035,11,12/31/2022,QLV9FK04PZ,30,"3430"
D1035,11,1/1/2023,RA16HWWQ22,100,"3330"
D1035,11,01/01/2023,RA14HX0H9S,30,"3300"
D1035,11,01/02/2023,RA26JWFPPK,100,"3200"
D1035,11,01/02/2023,RA27JWLBLX,30,"3170"
D1035,11,01/03/2023,RA37M24AG3,100,"3070"
D1035,11,01/03/2023,RA38M27C6O,30,"3040"
D1035,11,01/06/2022,RA60S8RDVI,100,"2940"
D1035,11,01/06/2023,RA63S8UB0V,100,"2840"
D1035,11,01/06/2023,RA63S8XC75,60,"2780"
D1035,11,01/07/2023,RA70VUYHVM,100,"2680"
D1035,11,01/07/2023,RA75VVB1N3,30,"2650"
D1035,11,01/08/2023,RA87YR03HB,100,"2550"
D1035,11,01/08/2023,RA85YR89UH,30,"2520"
D1035,11,01/11/2023,RAB76MN411,100,"2420"
D1035,11,01/11/2023,RAB96MU0DD,30,"2390"
D1035,11,01/12/2023,RAC17XLG3B,100,"2290"
D1035,11,01/12/2023,RAC07XTP2E,30,"2260"
D1035,11,01/12/2023,RAC57XZPI7,100,"2160"
D1035,11,01/12/2023,RAC77Y7EFP,30,"2130"
D1035,11,01/13/2023,RAD8C8GVJC,100,"2030"
D1035,11,01/15/2023,RAF3GZJ2BP,30,"2000"
D1035,11,01/15/2023,RAF6GZLUMC,100,"1900"
D1035,11,01/16/2023,RAG5JJ15D3,100,"1800"
D1035,11,01/16/2023,RAG1JJ7BX7,30,"1770"
D1035,11,01/17/2023,RAH0LZ09FK,100,"1670"
D1035,11,01/17/2023,RAH3LZ4N0Z,100,"1570"
D1035,11,01/18/2023,RAI2NI1AJG,100,"1470"
D1035,11,01/18/2023,RAI2NIA6VY,30,"1440"
D1035,11,01/19/2023,RAJ2QHGPMQ,100,"1340"
D1035,11,01/19/2023,RAJ1QHPT3B,30,"1310"
D1035,11,01/20/2023,RAK7RSP0LL,1310,0
D1035,12,01/21/2023,RAL7UY145N,100.00,"4660"
D1035,12,01/21/2023,RAL7UY6JNP,100.00,"4560"
D1035,12,01/22/2023,RAM7WTHXF1,100.00,"4460"
D1035,12,1/22/2023,RAM6WTL2GQ,100,"4360"
D1035,12,1/23/2023,RAN71V7MMT,100,"4260"
D1035,12,1/23/2023,RAN81VF916,100,"4160"
D1035,12,01/24/2023,RAO74H7VBR,100,"4060"
D1035,12,01/24/2023,RAO44HEZV8,100,"3960"
D1035,12,01/26/2023,RAQ39LNT3X,100,"3860"
D1035,12,01/25/2023,RAP178MHV1,100,"3760"
D1035,12,01/25/2023,RAP778URGT,100,"3660"
D1035,12,01/27/2023,RAR7BHNFHT,100,"3560"
D1035,12,01/27/2023,RAR9BHW4U5,100,"3460"
D1035,12,01/29/2023,RAT7H06OB9,100,"3360"
D1035,12,01/29/2023,RAT5H0L5FR,74,"3286"
D1035,12,01/31/2023,RAV0L3K4G6,100,"3186"
D1035,12,01/31/2023,RAV7L3S3U7,100,"3086"
D1035,12,01/31/2023,RAV2L3XG2C,100,"2986"
D1035,12,02/01/2023,RB13ONYLMT,100,"2886"
D1035,12,02/01/2023,RB12OO8PA6,100,"2786"
D1035,12,02/03/2023,RB38TNWFDQ,100,"2686"
D1035,12,02/03/2023,RB35TO5VDD,100,"2586"
D1035,12,02/03/2023,RB30TOFI2W,100,"2486"
D1035,12,02/03/2023,RB31TOQAOD,100,"2386"
D1035,12,02/03/2023,RB32TP0K76,26,"2360"
D1035,12,02/04/2023,RB46WPQ1OS,100,"2260"
D1035,12,02/04/2023,RB40WPZ8IW,100,"2160"
D1035,12,02/05/2023,RB52ZM3CBY,100,"2060"
D1035,12,02/05/2023,RB55ZM8NYD,100,"1960"
D1035,12,02/07/2023,RB7345WT71,1580,380
D1035,12,02/07/2023,RB704YZ0WU,380,0
D1035,13,02/08/2023,RB808HOS7Q,100.00,"6700"
D1035,13,02/08/2023,RB858HUKXH,100.00,"6600"
D1035,13,02/13/2023,RBD8LOR8YY,250.00,"6350"
D1035,13,2/20/2023,RBK02KMDS0,400,"5950"
D1035,13,2/28/2023,RBS4OMLI7M,"1000","4950"
D1035,13,3/1/2023,RC12S2WUUA,260,"4690"
D1035,13,03/02/2023,RC23UHPBFZ,1500,"3190"
D1035,13,03/03/2023,RC36Y1AVHI,260,"2930"
D1035,13,03/06/2023,RC6374RVQ3,100,"2830"
D1035,13,03/06/2023,RC6574YSQV,100,"2730"
D1035,13,03/07/2023,RC729VVDDA,100,"2630"
D1035,13,03/07/2023,RC729W2HHA,100,"2530"
D1035,13,03/08/2023,RC80BJE69G,2000,530
D1035,13,03/08/2023,RC89CA09P3,100,430
D1035,13,03/08/2023,RC82CA8296,100,330
D1035,13,03/08/2023,RC83CADD9L,20,310
D1035,13,03/09/2023,RC90D9A8M8,10,300
D1035,13,03/09/2023,RC96DV7EAQ,300,0
D1035,14,03/12/2023,RCC2N66X8G,400.00,"6050"
D1035,14,03/27/2023,RCR5Q8HWAR,"1500.00","4550"
D1035,14,03/28/2023,RCS5UKPQSV,330.00,"4220"
D1035,14,3/30/2023,RCU5ZX4NMD,330,"3890"
D1035,14,3/31/2023,RCV53NVCU1,330,"3560"
D1035,14,4/1/2023,RD116PBO3H,330,"3230"
D1035,14,03/29/2023,RCT4X34KM2,330,"2900"
D1035,14,04/02/2023,RD2299HUUW,330,"2570"
D1035,14,04/05/2023,RD50GEWM60,1800,770
D1035,14,04/05/2023,RD59HPOEPT,350,420
D1035,14,04/06/2023,RD68IOQC44,420,0
D1035,15,04/25/2023,RDQ131J0PX,"6050.00",0
D1035,16,05/25/2023,REP8DWDRD0,"6500.00",0
D1035,17,06/08/2023,RF84K6H90W,400.00,"6100"
D1035,17,05/26/2023,REQ8IGA2S4,100.00,"6000"
D1035,17,05/27/2023,RER6L9RW20,100.00,"5900"
D1035,17,6/23/2023,RFN6RH4QSY,"5900",0
D1035,18,07/21/2023,RGL031K132,"6500.00",0
D1036,1,09/01/2020,OI145X1VK4,435.00,"11165"
D1036,1,09/03/2020,OI3781TWDT,434.00,"10731"
D1036,1,09/08/2020,OI85D8R5J3,"2650.00","8081"
D1036,1,09/14/2020,OIE8JQI7JY,"3250.00","4831"
D1036,1,09/15/2020,OIF3KQ3JD7,"4831.00",0
D1036,2,11/05/2020,OK577ADLC9,"1550.00","14250"
D1036,2,11/07/2020,OK749GP7T8,"1200.00","13050"
D1036,2,11/09/2020,OK90CQHB2M,700.00,"12350"
D1036,2,11/12/2020,OKC0FPAU8M,1000,"11350"
D1036,2,03/16/2021,PCG2QT5JI0,500,"10850"
D1036,2,03/23/2021,PCN2ZDVBIO,100,"10750"
D1036,2,03/23/2021,PCN6ZE04LC,100,"10650"
D1037,1,09/08/2020,OI80CMRW1G,"6500.00","19500"
D1037,1,09/15/2020,OIF7KFZX59,"6500.00","13000"
D1037,1,09/22/2020,OIM1RMKIBX,"6500.00","6500"
D1037,1,09/28/2020,OIS7Y04BY9,"6500.00",0
D1037,2,10/05/2020,OJ5276QAHQ,"6500.00","19500"
D1037,2,10/10/2020,OJA7DD8EBX,"6500.00","13000"
D1037,2,10/19/2020,OJJ9MUL2G3,"6500.00","6500"
D1037,2,10/21/2020,OJL5OYXO87,6500,0
D1037,3,10/28/2020,OJS7WYNNO1,"6500.00","19500"
D1037,3,11/04/2020,OK425OIKAK,"6500.00","13000"
D1037,3,11/13/2020,OKD0GO69NW,"6500.00","6500"
D1037,3,11/18/2020,OKI1MN6L4P,6500,0
D1037,4,10/28/2020,OJS7WYNNO1_D2,"6500.00","19500"
D1037,4,11/04/2020,OK425OIKAK_D2,"6500.00","13000"
D1037,4,11/13/2020,OKD0GO69NW_D2,"6500.00","6500"
D1037,4,11/18/2020,OKI1MN6L4P_D2,6500,0
D1037,5,12/01/2020,OL102U8442,"1625.00","4875"
D1037,5,12/07/2020,OL73AT094V,"1650.00","3225"
D1037,5,12/14/2020,OLE3JLIIWZ,"1650.00","1575"
D1037,5,12/21/2020,OLL5SDDI6R,1575,0
D1038,1,09/08/2020,OI81CWJXRX,"1625.00","4475"
D1038,1,09/16/2020,OIG8KZBWDW,"1625.00","2850"
D1038,1,09/22/2020,OIM4RQKGE6,"2850.00",0
D1038,2,09/30/2020,OIU5155IB5,"1620.00","4180"
D1038,2,10/07/2020,OJ709E686M,"4180.00",0
D1038,3,10/15/2020,OJF5IMQUV3,"1950.00","5070"
D1038,3,10/21/2020,OJL7PC759J,"5070.00",0
D1038,4,,,,
D1038,5,11/27/2020,OKR6XGU4US,100.00,"9380"
D1038,5,11/27/2020,OKR1XGWHDZ,100.00,"9280"
D1038,5,11/27/2020,OKR5XGZ1UZ,10.00,"9270"
D1038,5,11/27/2020,OKR7XXJ3R7,500,"8770"
D1038,5,11/30/2020,OKU225KI4I,100,"8670"
D1038,5,11/30/2020,OKU125O1R7,70,"8600"
D1038,5,12/05/2020,OL77AJX9BZ,90,"8510"
D1038,5,12/05/2020,OL70AJY3H2,30,"8480"
D1038,5,12/07/2020,OL70AWQBG0,100,"8380"
D1038,5,12/07/2020,0L73AWX58Z,80,"8300"
D1038,5,12/18/2020,OLI8OUUK72,100,"8200"
D1038,5,12/18/2020,OLI8OUXJJ8,100,"8100"
D1038,5,12/21/2020,OLL2RVXYRU,100,"8000"
D1038,5,12/23/2020,OLN5V3SF99,100,"7900"
D1038,5,12/31/2020,OLV05XCZLE,100,"7800"
D1038,5,01/08/2021,PA81FBBBNP,100,"7700"
D1038,5,02/01/2021,PB198QBC07,98,"7602"
D1038,5,02/06/2021,PB66E9ENYC,100,"7502"
D1038,5,02/11/2021,PBB9KH8GRV,100,"7402"
D1038,5,02/15/2021,PBF6PJAZF2,100,"7302"
D1039,1,09/03/2020,OI317YQNS3,60.00,"7740"
D1039,1,09/03/2020,OI317YLJ7N,100.00,"7640"
D1039,1,09/03/2020,OI387YE1DY,100.00,"7540"
D1039,1,09/05/2020,OI5499XV3Y,60.00,"7480"
D1039,1,09/05/2020,OI5899WFFI,100.00,"7380"
D1039,1,09/05/2020,OI5999V9QP,100.00,"7280"
D1039,1,09/06/2020,OI62AHGYFA,60.00,"7220"
D1039,1,09/06/2020,OI61AHEM21,100.00,"7120"
D1039,1,09/06/2020,OI68AHC87E,100.00,"7020"
D1039,1,09/07/2020,OI70BDSK6M,60,"6960"
D1039,1,09/07/2020,OI70BDR2NY,100,"6860"
D1039,1,09/07/2020,OI77BDPCQZ,100,"6760"
D1039,1,09/09/2020,OI99DJB9RZ,100,"6660"
D1039,1,09/09/2020,OI98DJDUX0,100,"6560"
D1039,1,09/09/2020,OI91DJGG9X,60,"6500"
D1039,1,09/11/2020,OIB8FQ5G7O,100,"6400"
D1039,1,09/11/2020,OIB6FQA3ES,100,"6300"
D1039,1,09/11/2020,OIB8FQDWIE,60,"6240"
D1039,1,09/12/2020,OIC6HILMTE,100,"6140"
D1039,1,09/12/2020,OIC4HIP6YO,100,"6040"
D1039,1,09/12/2020,OIC9HIS9CF,60,"5980"
D1039,1,09/19/2020,OIJ6OXG9BI,"1300","4680"
D1039,1,09/19/2020,OIJ7OZ1HE1,1000,"3680"
D1039,1,09/19/2020,OIJ2OZDFEQ,40,"3640"
D1039,1,09/20/2020,OIK9Q2OWTV,100,"3540"
D1039,1,09/20/2020,OIK8Q2RGYS,100,"3440"
D1039,1,09/20/2020,OIK3Q2T231,60,"3380"
D1039,1,09/26/2020,OIQ3VLBWBR,100,"3280"
D1039,1,09/26/2020,OIQ3VLEZJD,100,"3180"
D1039,1,09/26/2020,OIQ4VLGTVG,60,"3120"
D1039,1,09/30/2020,OIU218IZ5U,520,"2600"
D1039,1,10/01/2020,OJ182ALES8,"2600",0
D1039,2,10/03/2020,OJ355G3NYJ,100.00,"9980"
D1039,2,10/03/2020,OJ305GBLUM,100.00,"9880"
D1039,2,10/03/2020,OJ345GER2U,60.00,"9820"
D1039,2,10/04/2020,OJ486B18XE,100,"9720"
D1039,2,10/04/2020,OJ446B32U2,100,"9620"
D1039,2,10/04/2020,OJ456B8S11,60,"9560"
D1039,2,10/06/2020,OJ608YK4YU,60,"9500"
D1039,2,10/06/2020,OJ608YGSO0,100,"9400"
D1039,2,10/06/2020,OJ698YEEAT,100,"9300"
D1039,2,10/07/2020,OJ72A7PCQM,100,"9200"
D1039,2,10/07/2020,OJ73A7RM2Z,100,"9100"
D1039,2,10/07/2020,OJ73A7THQ9,60,"9040"
D1039,2,10/09/2020,OJ99CJEPF9,100,"8940"
D1039,2,10/09/2020,OJ92CJHJDW,100,"8840"
D1039,2,10/09/2020,OJ97CJXNAF,60,"8780"
D1039,2,10/17/2020,OJH4KNXNW8,780,"8000"
D1039,2,10/18/2020,OJI4MF3H4S,100,"7900"
D1039,2,10/18/2020,OJI5MF5P3P,100,"7800"
D1039,2,10/18/2020,OJI3MF7NVZ,60,"7740"
D1039,2,11/04/2020,OK415YA4WV,2000,"5740"
D1040,1,09/09/2020,OI96E1JPJS,100.00,"6400"
D1040,1,09/09/2020,OI92E1LRIG,100.00,"6300"
D1040,1,09/09/2020,OI97E1NXHJ,17.00,"6283"
D1040,1,09/10/2020,OIA4F45Z64,100.00,"6183"
D1040,1,09/10/2020,OIA8F498R0,100.00,"6083"
D1040,1,09/10/2020,OIA0F4D29W,17.00,"6066"
D1040,1,09/13/2020,OID3IJL1BN,100.00,"5966"
D1040,1,09/13/2020,OID1IJB6QL,17.00,"5949"
D1040,1,09/13/2020,OID7IJ7I7D,100.00,"5849"
D1040,1,09/12/2020,OIC8HF1ZWS,100,"5749"
D1040,1,09/12/2020,OIC5HEZ5N1,17,"5732"
D1040,1,09/12/2020,OIC1HEUEBF,100,"5632"
D1040,1,09/11/2020,OIB3GC33XB,100,"5532"
D1040,1,09/11/2020,OIB5GC5I6D,100,"5432"
D1040,1,09/11/2020,OIB6GC7IZS,17,"5415"
D1040,1,09/14/2020,OIE9JJEJFD,100,"5315"
D1040,1,09/14/2020,OIE6JJGV7Y,100,"5215"
D1040,1,09/14/2020,OIE5JJIZ4Z,17,"5198"
D1040,1,09/17/2020,OIH6MUOKZA,100,"5098"
D1040,1,09/17/2020,OIH3MURXSN,100,"4998"
D1040,1,09/17/2020,OIH2MUVINI,17,"4981"
D1040,1,09/16/2020,OIG8LNSO1Q,100,"4881"
D1040,1,09/16/2020,OIG2LNW0S8,100,"4781"
D1040,1,09/16/2020,OIG3LO04YF,17,"4764"
D1040,1,09/15/2020,OIF8KM4FCK,100,"4664"
D1040,1,09/15/2020,OIF3KM7E73,100,"4564"
D1040,1,09/15/2020,OIF1KMACBL,17,"4547"
D1040,1,09/18/2020,OII6NYMQC4,100,"4447"
D1040,1,09/18/2020,OII8NYO8WW,100,"4347"
D1040,1,09/18/2020,OII6NYQ9EU,17,"4330"
D1040,1,09/19/2020,OIJ1P2FWVV,100,"4230"
D1040,1,09/19/2020,OIJ8P2HN5G,100,"4130"
D1040,1,09/19/2020,OIJ8P2JHAK,17,"4113"
D1040,1,09/20/2020,OIK3PY33E9,100,"4013"
D1040,1,09/20/2020,OIK3PY8AEH,100,"3913"
D1040,1,09/20/2020,OIK6PYZ9R6,17,"3896"
D1040,1,09/21/2020,OIL0R4PQT4,100,"3796"
D1040,1,09/21/2020,OIL8R4RIDE,17,"3779"
D1040,1,09/21/2020,OIL9R64WC3,100,"3679"
D1040,1,09/22/2020,OIM5S3V7DN,100,"3579"
D1040,1,09/22/2020,OIM5S3X6OV,100,"3479"
D1040,1,09/22/2020,OIM2S3ZC0E,17,"3462"
D1040,1,09/23/2020,OIN1T5PS1D,100,"3362"
D1040,1,09/23/2020,OIN1T5SA8V,100,"3262"
D1040,1,09/23/2020,OIN8T5TX8E,17,"3245"
D1040,1,09/24/2020,OIO6UB4BBE,100,"3145"
D1040,1,09/24/2020,OIO1UB5WD5,100,"3045"
D1040,1,09/24/2020,OIO1UBA0PF,17,"3028"
D1040,1,09/25/2020,OIP6VA3CFK,100,"2928"
D1040,1,09/25/2020,OIP6VA5R2Q,100,"2828"
D1040,1,09/25/2020,OIP1VA7U5N,17,"2811"
D1040,1,09/26/2020,OIQ4WF8CE8,100,"2711"
D1040,1,09/26/2020,OIQ3WFAE43,100,"2611"
D1040,1,09/26/2020,OIQ1WFDTEN,17,"2594"
D1040,1,09/27/2020,OIR2XAD0NS,100,"2494"
D1040,1,09/27/2020,OIR8XAH5GM,100,"2394"
D1040,1,09/27/2020,OIR0XAJ3LE,17,"2377"
D1040,1,09/28/2020,OIS8YHJC7O,100,"2277"
D1040,1,09/28/2020,OIS3YHLXU3,100,"2177"
D1040,1,09/28/2020,OIS6YHOC3G,17,"2160"
D1040,1,09/29/2020,OIT9ZT9S5X,100,"2060"
D1040,1,09/29/2020,OIT4ZTBF3Q,100,"1960"
D1040,1,09/29/2020,OIT7ZTCLIH,17,"1943"
D1040,1,09/30/2020,OIU11X7SRF,100,"1843"
D1040,1,09/30/2020,OIU31XAH3J,100,"1743"
D1040,1,09/30/2020,OIU61XDPPO,17,"1726"
D1040,1,10/01/2020,OJ1434OKV2,17,"1709"
D1040,1,10/01/2020,OJ1334H38D,100,"1609"
D1040,1,10/02/2020,OJ294C58MX,100,"1509"
D1040,1,10/02/2020,OJ284CB0VU,100,"1409"
D1040,1,10/02/2020,OJ264CE4RK,17,"1392"
D1040,1,10/03/2020,OJ325FEX3W,100,"1292"
D1040,1,10/03/2020,OJ395FHYKN,100,"1192"
D1040,1,10/03/2020,OJ345FKEVO,17,"1175"
D1040,1,10/04/2020,OJ4161358D,100,"1075"
D1040,1,10/04/2020,OJ46614WSA,17,"1058"
D1040,1,10/04/2020,OJ486177HU,100,958
D1040,1,10/05/2020,OJ537SWPWT,100,858
D1040,1,10/05/2020,OJ527SYCX8,100,758
D1040,1,10/05/2020,OJ557T0RLL,17,741
D1040,1,10/05/2020,OJ527T30YE,100,641
D1040,1,10/06/2020,OJ698Z91M9,17,624
D1040,1,10/06/2020,OJ678Z54JB,100,524
D1040,1,10/06/2020,OJ678Z3EM5,100,424
D1040,1,10/07/2020,OJ789CVVC8,24,400
D1040,1,10/07/2020,OJ789CUI22,100,300
D1040,1,10/07/2020,OJ729CPFXI,100,200
D1040,1,10/07/2020,OJ739CMAH3,100,100
D1040,1,10/07/2020,OJ759CFPUT,100,0
D1040,2,10/08/2020,OJ80B4A6KE,100.00,"6400"
D1040,2,10/08/2020,OJ85B4DV01,100.00,"6300"
D1040,2,10/08/2020,OJ83B4JDVF,17.00,"6283"
D1040,2,10/09/2020,OJ99CIFW4D,100,"6183"
D1040,2,10/09/2020,OJ95CIIAH5,100,"6083"
D1040,2,10/09/2020,OJ93CIKJX1,17,"6066"
D1040,2,10/10/2020,OJA9DMTQ1D,100,"5966"
D1040,2,10/10/2020,OJA7DMV2NB,17,"5949"
D1040,2,10/11/2020,OJB3EEA0Y1,100,"5849"
D1040,2,10/11/2020,OJB9EECDB5,100,"5749"
D1040,2,10/11/2020,OJB8EEDVME,100,"5649"
D1040,2,10/11/2020,OJB9EEFMQN,17,"5632"
D1040,2,10/12/2020,OJC7FQOM4L,100,"5532"
D1040,2,10/12/2020,OJC8FQQZ06,100,"5432"
D1040,2,10/12/2020,OJC1FQTQ19,50,"5382"
D1040,2,10/13/2020,OJD8GT5LF2,100,"5282"
D1040,2,10/13/2020,OJD8GT8V0E,80,"5202"
D1040,2,10/14/2020,OJE7I60HWJ,100,"5102"
D1040,2,10/14/2020,OJE7I64ETV,100,"5002"
D1040,2,10/14/2020,OJE7I67GAF,17,"4985"
D1040,2,10/15/2020,OJF0J239N4,100,"4885"
D1040,2,10/15/2020,OJF5J2TB9P,100,"4785"
D1040,2,10/15/2020,OJF3J2VJ75,30,"4755"
D1040,2,10/16/2020,OJG1KBJ17N,100,"4655"
D1040,2,10/16/2020,OJG4KBMLAA,30,"4625"
D1040,2,10/17/2020,OJH6LFGTE6,100,"4525"
D1040,2,10/17/2020,OJH9LFIX75,100,"4425"
D1040,2,10/17/2020,OJH1LFLKLX,50,"4375"
D1040,2,10/17/2020,OJH5LGPTXV,17,"4358"
D1040,2,10/18/2020,OJI8LVWXME,40,"4318"
D1040,2,10/18/2020,OJI2M9PLG4,100,"4218"
D1040,2,10/18/2020,OJI2M9RKSG,100,"4118"
D1040,2,10/18/2020,OJI2M9UFV0,17,"4101"
D1040,2,10/20/2020,OJK5OL34ZN,100,"4001"
D1040,2,10/20/2020,OJK7OL5XKJ,100,"3901"
D1040,2,10/20/2020,OJK7OLA30J,100,"3801"
D1040,2,10/21/2020,OJL4POZ2US,100,"3701"
D1040,2,10/21/2020,OJL1PPA7HR,100,"3601"
D1040,2,10/21/2020,OJL8PPC3WQ,100,"3501"
D1040,2,10/22/2020,OJM8QWAEXI,100,"3401"
D1040,2,10/23/2020,OJN8S0EVAK,100,"3301"
D1040,2,10/23/2020,OJN5S0HJFL,17,"3284"
D1040,2,10/23/2020,OJN5S0I4DR,100,"3184"
D1040,2,10/24/2020,OJO6T209Z6,100,"3084"
D1040,2,10/24/2020,OJO7T23VOD,17,"3067"
D1040,2,10/24/2020,OJO5T2871D,100,"2967"
D1040,2,10/26/2020,OJQ6VA27OM,100,"2867"
D1040,2,10/26/2020,OJQ1VA2PVR,100,"2767"
D1040,2,10/27/2020,OJR8VX196I,40,"2727"
D1040,2,10/27/2020,OJR4W9M4OS,100,"2627"
D1040,2,10/27/2020,OJR8W9OHWE,100,"2527"
D1040,2,10/28/2020,OJS3XCPW3D,100,"2427"
D1040,2,10/28/2020,OJS0XCW5YE,100,"2327"
D1040,2,10/29/2020,OJT5YF8YFT,100,"2227"
D1040,2,10/29/2020,OJT1YFBP01,100,"2127"
D1040,2,10/29/2020,OJT1YFGQEB,50,"2077"
D1040,2,11/01/2020,OK1632X1ZC,100,"1977"
D1040,2,11/01/2020,OK1532YP4H,100,"1877"
D1040,2,11/01/2020,OK17330BD7,30,"1847"
D1040,2,11/02/2020,OK2249LXWI,100,"1747"
D1040,2,11/02/2020,OK2549O0KD,17,"1730"
D1040,2,11/02/2020,OK2849PK8M,100,"1630"
D1040,2,11/03/2020,OK355E2F9P,100,"1530"
D1040,2,11/03/2020,OK375E4EXH,100,"1430"
D1040,2,11/03/2020,OK335E77VT,17,"1413"
D1040,2,11/04/2020,OK415W85IN,1413,0
D1040,3,11/05/2020,OK527RCX0I,100.00,"6250"
D1040,3,11/05/2020,OK527RHSFI,17.00,"6233"
D1040,3,11/05/2020,OK577TNCBZ,100.00,"6133"
D1040,3,11/06/2020,OK6194MTOD,100,"6033"
D1040,3,11/06/2020,OK6994OFAR,100,"5933"
D1040,3,11/06/2020,OK6094PMBE,17,"5916"
D1040,3,11/07/2020,OK79A6DNRP,100,"5816"
D1040,3,11/07/2020,OK70A6GMB0,100,"5716"
D1040,3,11/07/2020,OK77A6K57T,17,"5699"
D1040,3,11/08/2020,OK82BGFKBO,100,"5599"
D1040,3,11/08/2020,OK83BGHATP,100,"5499"
D1040,3,11/08/2020,OK84BGJ9KY,17,"5482"
D1040,3,11/09/2020,OK97CR5C8D,100,"5382"
D1040,3,11/09/2020,OK96CR5Y8A,100,"5282"
D1040,3,11/09/2020,OK96CR6AM4,17,"5265"
D1040,3,11/10/2020,OKA4DWWAZC,100,"5165"
D1040,3,11/10/2020,OKA1DWZ8EJ,100,"5065"
D1040,3,11/10/2020,OKA4DX2PWY,17,"5048"
D1040,3,11/12/2020,OKC1G7AOMH,100,"4948"
D1040,3,11/12/2020,OKC5G7CHL7,100,"4848"
D1040,3,11/12/2020,OKC7G7EPKZ,50,"4798"
D1040,3,11/15/2020,OKF3JNOLFV,100,"4698"
D1040,3,11/15/2020,OKF2JNQ1CQ,100,"4598"
D1040,3,11/15/2020,OKF7JNQUIV,17,"4581"
D1040,3,11/16/2020,OKG7KSGL2F,100,"4481"
D1040,3,11/16/2020,OKG9KSJ7UF,20,"4461"
D1040,3,11/16/2020,OKG9KSYC73,100,"4361"
D1040,3,11/18/2020,OKI7N55ZQD,100,"4261"
D1040,3,11/22/2020,OKM3RRT6GD,100,"4161"
D1040,3,11/22/2020,OKM7RRVEMB,100,"4061"
D1040,3,11/22/2020,OKM1RRZWHN,100,"3961"
D1040,3,11/24/2020,OKO7U2R17F,100,"3861"
D1040,3,11/24/2020,OKO2U2X0ZM,30,"3831"
D1040,3,11/25/2020,OKP4VF7I8K,100,"3731"
D1040,3,11/25/2020,OKP5VFNOQL,50,"3681"
D1040,3,11/28/2020,OKS6Z5XZSK,100,"3581"
D1040,3,11/28/2020,OKS2Z5ZVM4,100,"3481"
D1040,3,11/28/2020,OKS6Z614H8,10,"3471"
D1040,3,11/29/2020,OKT118CD5R,100,"3371"
D1040,3,11/29/2020,OKT518F1XH,50,"3321"
D1040,3,11/30/2020,OKU8216ILA,3321,0
D1040,4,12/03/2020,OL366BLXG4,100.00,"6400"
D1040,4,12/03/2020,OL376BPBV3,100.00,"6300"
D1040,4,12/03/2020,OL316BSVPZ,20.00,"6280"
D1040,4,12/05/2020,OL598YHTTR,100,"6180"
D1040,4,12/05/2020,OL558YKFXP,100,"6080"
D1040,4,12/05/2020,OL548YMRGW,50,"6030"
D1040,4,12/06/2020,OL63A2RRX9,100,"5930"
D1040,4,12/06/2020,OL67A33JYN,100,"5830"
D1040,4,12/06/2020,OL60A35LMY,50,"5780"
D1040,4,12/11/2020,OLB7GGKARN,100,"5680"
D1040,4,12/11/2020,OLB4GGMWH6,100,"5580"
D1040,4,12/11/2020,OLB6GGP3C4,50,"5530"
D1040,4,12/12/2020,OLC1HSPRR7,100,"5430"
D1040,4,12/20/2020,OLK5RRN5D5,100,"5330"
D1040,4,12/20/2020,OLK0RRPOMA,100,"5230"
D1040,4,12/28/2020,OLS823SIT8,1000,"4230"
D1040,4,12/30/2020,OLU24864QO,1000,"3230"
D1040,4,12/30/2020,OLU648ACMU,100,"3130"
D1040,4,12/30/2020,OLU148C1LF,100,"3030"
D1040,4,12/30/2020,OLU148DKF1,30,"3000"
D1040,4,12/30/2020,OLU14W6W3T,"3000",0
D1040,5,01/09/2021,PA99GPZQP7,100.00,"6700"
D1040,5,01/09/2021,PA94GQ23TI,100.00,"6600"
D1040,5,01/09/2021,PA97GQ6D1F,20.00,"6580"
D1040,5,01/10/2021,PAA6HX5A9C,100,"6480"
D1040,5,01/10/2021,PAA3HX6KBL,20,"6460"
D1040,5,01/11/2021,PAB2JAXGE0,100,"6360"
D1040,5,01/11/2021,PAB9JAYQ4B,100,"6260"
D1040,5,01/11/2021,PAB2JB294W,100,"6160"
D1040,5,01/12/2021,PAC3KDZOJR,100,"6060"
D1040,5,01/12/2021,PAC1KE1FF1,70,"5990"
D1040,5,01/19/2021,PAJ8S72FI8,500,"5490"
D1040,5,01/29/2021,PAT44QXE8Y,"4200","1290"
D1040,5,01/30/2021,PAU25ALG0A,1290,0
D1040,6,02/01/2021,PB198ND3P7,100.00,"7800"
D1040,6,02/01/2021,PB178NG9BF,50.00,"7750"
D1040,6,02/01/2021,PB188NOZ3A,100.00,"7650"
D1040,6,02/02/2021,PB229OYLFY,100,"7550"
D1040,6,02/02/2021,PB209P22S4,100,"7450"
D1040,6,02/02/2021,PB289PE47Y,50,"7400"
D1040,6,03/14/2021,PCE6ORG9GY,100,"7300"
D1040,6,03/14/2021,PCE6ORIU7K,100,"7200"
D1040,6,03/15/2021,PCF1Q60S79,100,"7100"
D1040,6,03/15/2021,PCF1Q62YVH,100,"7000"
D1040,6,03/16/2021,PCG8RGXTDA,100,"6900"
D1040,6,03/16/2021,PCG4RGYTTO,50,"6850"
D1040,6,03/18/2021,PCI7TXCI0P,100,"6750"
D1040,6,03/18/2021,PCI8TXF5VU,50,"6700"
D1040,6,06/02/2021,PF25NWRN73,100,"6600"
D1040,6,06/02/2021,PF27NWVRC7,100,"6500"
D1040,6,06/03/2021,PF38PBNPN6,100,"6400"
D1040,6,06/05/2021,PF57S8D28N,100,"6300"
D1040,6,06/06/2021,PF67TKVEWB,100,"6200"
D1040,6,06/07/2021,PF74UXVKE6,100,"6100"
D1040,6,06/10/2021,PFA5XYJ2FR,100,"6000"
D1040,6,06/11/2021,PFB21A3H24,100,"5900"
D1040,6,06/13/2021,PFD83ZE6IW,100,"5800"
D1040,6,06/16/2021,PFG388EVYD,100,"5700"
D1040,6,06/18/2021,PFI2A4ALFM,100,"5600"
D1040,6,06/20/2021,PFK9CWZHX5,100,"5500"
D1040,6,06/22/2021,PFM9FHX0NL,100,"5400"
D1040,6,06/24/2021,PFO2J85HJ4,100,"5300"
D1040,6,06/27/2021,PFR0NEYKMW,100,"5200"
D1040,6,07/03/2021,PG33UT7C37,50,"5150"
D1040,6,07/06/2021,PG6118CE1Z,100,"5050"
D1040,6,07/16/2021,PGG7FBY0FH,50,"5000"
D1040,6,08/23/2021,PHN6YGD1LG,100,"4900"
D1040,6,08/25/2021,PHP92QD3MD,80,"4820"
D1040,6,08/26/2021,PHQ949Q4L5,100,"4720"
D1040,6,08/29/2021,PHT38N0CKP,100,"4620"
D1040,6,04/05/2022,QD54V2MDCO,100,"4520"
D1040,6,04/05/2022,QD57VSSQHR,100,"4420"
D1040,6,04/06/2022,QD63XWPSJ1,100,"4320"
D1040,6,04/08/2022,QD811937H9,50,"4270"
D1040,6,04/09/2022,QD903UD2CU,50,"4220"
D1040,6,04/11/2022,QDB27H0MNS,80,"4140"
D1040,6,04/12/2022,QDC48WK6RQ,70,"4070"
D1040,6,04/14/2022,QDE9EG7YET,50,"4020"
D1040,6,05/06/2022,QE64K38UVM,60,"3960"
D1040,6,05/08/2022,QE89OIHPDR,40,"3920"
D1040,6,05/09/2022,QE91POKBZV,100,"3820"
D1040,6,02/23/2023,RBN4BERH78,496,"3324"
D1040,6,02/24/2023,RBO0F4BWUS,100,"3224"
D1040,6,02/27/2023,RBR3L3S317,200,"3024"
D1040,6,03/01/2023,RC11PT03T5,100,"2924"
D1040,6,03/02/2023,RC26SIJUZ6,100,"2824"
D1040,6,03/02/2023,RC28UOVHAG,100,"2724"
D1040,6,03/03/2023,RC40Y720X4,100,"2624"
D1040,6,03/05/2023,RC56281UY6,100,"2524"
D1040,6,03/07/2023,RC799UG2ON,100,"2424"
D1040,6,03/08/2023,RC84CQJZMA,100,"2324"
D1040,6,03/18/2023,RCI22642NU,100,"2224"
D1041,1,10/08/2020,OJ89ARXZYZ,"26000.00",0
D1041,2,11/06/2020,OK678NNWPV,"26000.00",0
D1041,3,12/05/2020,OL567YBWQG,"26000.00",0
D1041,4,01/03/2021,PA339O4597,"26000.00",0
D1041,5,02/08/2021,PB84GOYA7S,"32500.00","1500"
D1041,5,02/08/2021,Penalty waived,"1500.00",0
D1041,6,03/14/2021,PCE2NQGXZ4,"32500.00","1500"
D1041,6,03/14/2021,Penalty waived,"1500.00",0
D1041,7,04/20/2021,PDK01MOQT8,"32500.00","1500"
D1041,7,04/20/2021,PDK51WGYB1,"1500.00",0
D1041,8,05/28/2021,PES2GEY07G,"34000.00",0
D1041,9,07/02/2021,PG20TJW2L2,"12000.00","35600"
D1041,9,07/09/2021,PG974W76VR,"35600.00",0
D1041,10,09/21/2021,PIL289VGCG,"4000.00","23200"
D1041,10,10/14/2021,PJE28BGSKE,"2000.00","21200"
D1041,10,10/19/2021,PJJ9GKF1GB,20000,"1200"
D1041,10,10/19/2021,PENALTY WAIVED,1200,0
D1042,1,09/18/2020,OII7NXQZH3,"2000.00","20400"
D1042,1,09/21/2020,,"20400.00",0
D1042,2,09/22/2020,OIM4S13K0C,500.00,"23300"
D1042,2,09/25/2020,OIP6V0I12O,750.00,"22550"
D1042,2,09/28/2020,OIS3YD0SS5,"2300.00","20250"
D1042,2,09/30/2020,OIU11SNZC7,"2000","18250"
D1042,2,10/01/2020,OJ10313Z4O,400,"17850"
D1042,2,10/02/2020,OJ2348DOIB,900,"16950"
D1042,2,10/02/2020,OJ2448XR5M,1150,"15800"
D1042,2,10/07/2020,OJ709V9UEM,5300,"10500"
D1042,2,10/07/2020,OJ779ZRS0X,2200,"8300"
D1042,2,10/09/2020,OJ98BR21HK,8300,0
D1042,3,10/19/2020,OJJ5MW3AWB,"3000.00","23000"
D1042,3,10/23/2020,OJN5RUL8DB,300.00,"22700"
D1042,3,10/28/2020,OJS8WZTOIU,"2000.00","20700"
D1042,3,10/30/2020,OJU5YZXYKJ,"2000","18700"
D1042,3,11/02/2020,OK273JE1DH,4500,"14200"
D1042,3,11/03/2020,OK384TFPCI,1100,"13100"
D1042,3,11/04/2020,OK465S6RXC,2300,"10800"
D1042,3,11/05/2020,OK556WBYQL,4000,"6800"
D1042,3,11/06/2020,OK668A3XEI,2000,"4800"
D1042,3,11/07/2020,OK799MYY8R,"4800",0
D1042,4,11/19/2020,OKJ5NI2GP1,"6780.00",0
D1042,5,11/24/2020,OKO6TMOKXS,"2000.00","32000"
D1042,5,11/30/2020,OKU41QADKE,"1450.00","30550"
D1042,5,12/03/2020,OL3459WSKA,"1500.00","29050"
D1042,5,12/04/2020,OL44737XOU,"1500","27550"
D1042,5,12/06/2020,OL679VMR5X,950,"26600"
D1042,5,12/07/2020,OL74AGZ4CM,3000,"23600"
D1042,5,12/09/2020,OL90DES13G,"2800","20800"
D1042,5,12/09/2020,OL91DG8ZBD,"1900","18900"
D1042,5,12/16/2020,OLG2M5PZ6Y,2000,"16900"
D1042,5,12/18/2020,OLI9OCM50L,"1000","15900"
D1042,5,12/21/2020,OLL6S0T16M,1900,"14000"
D1042,5,12/23/2020,OLN2V68KPW,"14000",0
D1042,6,01/16/2021,PAG7P4F4C7,"10000.00","22500"
D1042,6,01/19/2021,PAJ2S3EV8I,"22500.00",0
D1042,7,02/13/2021,PBD0MZ3OGA,"31500.00",0
D1042,8,03/03/2021,PC32AIZZC2,"5900.00","30600"
D1042,8,03/08/2021,PC82H72W5O,"6500.00","24100"
D1042,8,03/08/2021,PC82H7595E,500.00,"23600"
D1042,8,03/15/2021,PCF2PMUBA4,"5000","18600"
D1042,8,03/16/2021,PCG4R40RTM,"2500","16100"
D1042,8,03/16/2021,PCG8R9JOBS,500,"15600"
D1042,8,03/17/2021,PCH5SDKGMV,"2000","13600"
D1042,8,03/20/2021,PCL3WW0A5T,"3000","10600"
D1042,8,03/25/2021,PCP92ZU29L,"2000","8600"
D1042,8,03/26/2021,PCQ744Y53R,1500,"7100"
D1042,8,03/30/2021,PCU9933OHD,3100,"4000"
D1043,1,09/18/2020,OII2NCW5R8,100.00,"6400"
D1043,1,09/18/2020,OII8NCY1Z8,100.00,"6300"
D1043,1,09/18/2020,OII2ND0AV0,20.00,"6280"
D1043,1,09/21/2020,OIL7Q81FZH,100.00,"6180"
D1043,1,09/21/2020,OIL0Q830LM,100.00,"6080"
D1043,1,09/21/2020,OIL8Q86AYY,73.00,"6007"
D1043,1,09/23/2020,OIN9SAY129,100.00,"5907"
D1043,1,09/23/2020,OIN1SB0895,100.00,"5807"
D1043,1,09/23/2020,OIN5SB262B,100.00,"5707"
D1043,1,09/24/2020,OIO6UBGBHG,100,"5607"
D1043,1,09/24/2020,OIO6UBGTBY,100,"5507"
D1043,1,09/24/2020,OIO0UBHO76,100,"5407"
D1043,1,09/24/2020,OIO8UBI928,40,"5367"
D1043,1,09/25/2020,OIP7UUQW5T,100,"5267"
D1043,1,09/25/2020,OIP4UUX5YC,100,"5167"
D1043,1,09/25/2020,OIP3UUZ3HX,100,"5067"
D1043,1,09/25/2020,OIP3UV0SYP,20,"5047"
D1043,1,09/28/2020,OIS2YQ9KOE,100,"4947"
D1043,1,09/28/2020,OIS0YQ8UIY,100,"4847"
D1043,1,09/28/2020,OIS8YQA8OQ,100,"4747"
D1043,1,09/28/2020,OIS6YQB57S,40,"4707"
D1043,1,09/29/2020,OIT9ZS0WTZ,100,"4607"
D1043,1,09/29/2020,OIT3ZS491V,100,"4507"
D1043,1,09/29/2020,OIT3ZS6SQZ,100,"4407"
D1043,1,09/30/2020,OIU720DLZL,100,"4307"
D1043,1,09/30/2020,OIU820EINQ,100,"4207"
D1043,1,09/30/2020,OIU220FW58,90,"4117"
D1043,1,10/01/2020,OJ1734QTGJ,100,"4017"
D1043,1,10/01/2020,OJ1334OTML,100,"3917"
D1043,1,10/09/2020,OJ98CKI12A,1500,"2417"
D1043,1,10/12/2020,OJC7FW15H7,2250,167
D1043,1,10/13/2020,OJD9G604RL,100,67
D1043,1,10/13/2020,OJD0G61FPC,70,3
D1043,2,10/22/2020,OJM3QJ3LBD,700.00,"7200"
D1043,2,11/02/2020,OK214B261H,100.00,"7100"
D1043,2,11/02/2020,OK204B355C,100.00,"7000"
D1043,2,11/02/2020,OK244B3R54,100,"6900"
D1043,2,11/04/2020,OK436MLXVF,100,"6800"
D1043,2,11/04/2020,OK456MPFLV,100,"6700"
D1043,2,11/04/2020,OK476MRX45,100,"6600"
D1043,2,11/04/2020,OK486MT6ZA,90,"6510"
D1043,2,11/05/2020,OK537XGGQ5,100,"6410"
D1043,2,11/05/2020,OK577XH5K5,100,"6310"
D1043,2,11/16/2020,OKG9KUYEQZ,300,"6010"
D1043,2,11/17/2020,OKH2M11HS8,300,"5710"
D1043,2,11/26/2020,OKQ8WLLA5Y,100,"5610"
D1043,2,11/27/2020,OKR4XTJK44,100,"5510"
D1043,2,11/30/2020,OKU52ILS15,100,"5410"
D1043,2,12/02/2020,OL21538MUN,100,"5310"
D1043,2,12/03/2020,OL346DE68W,100,"5210"
D1044,1,09/30/2020,OIU51BT3F1,"1850.00","11750"
D1044,1,09/30/2020,OIU31BVF9V,"1400.00","10350"
D1044,1,10/05/2020,OJ536V9J85,50.00,"10300"
D1044,1,10/05/2020,OJ556VDNUR,"1000.00","9300"
D1044,1,10/07/2020,OJ789WCNDO,"1250.00","8050"
D1044,1,10/15/2020,OJF7IL10F7,"8000.00",50
D1044,1,10/15/2020,OJF3IL470N,50.00,0
D1044,2,10/30/2020,OJU2ZF56BA,"3250.00","8950"
D1044,2,11/06/2020,OK678MJQVL,"3200.00","5750"
D1044,2,11/13/2020,OKD0GOSE5I,"6500.00",750
D1044,3,11/23/2020,OKN4RZH3LG,"4000.00","12320"
D1044,3,12/09/2020,OL98CVRJFO,"6000.00","6320"
D1044,3,12/16/2020,OLG2LMWABQ,"5600.00",720
D1044,3,12/17/2020,OLH3N3FD31,720,0
D1044,4,12/31/2020,OLU058Q79U,"6500.00","9100"
D1044,4,01/13/2021,PAD7L1ANKR,"7600.00","1500"
D1044,4,01/13/2021,PAD0L1OFZO,"1500.00",0
D1044,5,02/12/2021,PBC0LVVDQ8,"16320.00",0
D1044,6,03/05/2021,PC57CAOMYP,"14640.00",0
D1044,7,04/09/2021,PD95MT8BW3,"17680.00",0
D1044,8,04/26/2021,PDQ79EATWD,"15860.00",0
D1044,9,05/18/2021,PEI23K2CQE,"12500.00",0
D1044,10,07/05/2021,PG54Y85TL2,"4000.00","14960"
D1044,10,07/09/2021,PG9650S4G8,"10000.00","4960"
D1044,10,07/28/2021,PGS2W3EUIU,"4300.00",660
D1044,10,07/31/2021,PGV2ZZ9XAK,660,0
D1045,1,09/24/2020,OIO5TBW9KJ,"4030.00","8170"
D1045,1,10/01/2020,OJ15251D6D,"4034.00","4136"
D1045,1,10/08/2020,OJ83ARGBYZ,"4138.00",2
D1045,2,10/21/2020,OJL0PTJG92,"4034.00","8066"
D1045,2,10/30/2020,OJU8ZSW23S,"4034.00","4032"
D1045,2,11/02/2020,OK203HEHNG,"4034.00",2
D1045,3,11/14/2020,OKE7I29KGH,"4034.00","7966"
D1045,3,11/17/2020,OKH3LY6PYX,"4034.00","3932"
D1045,3,11/21/2020,OKL6PZFBT6,"3932.00",0
D1045,4,12/14/2020,OLE7JOAT2D,"12300.00",0
D1045,5,01/05/2021,PA54BLE9L8,"7350.00","5200"
D1045,5,01/05/2021,PA57BLQQX5,"5200.00",0
D1045,6,01/29/2021,PAT9435HHX,"12400.00",0
D1045,7,03/22/2021,PCM3YCGLPF,300.00,"18660"
D1045,7,03/22/2021,PCM6YEBYDU,250.00,"18410"
D1046,1,09/24/2020,OIO7TDG8SN,100.00,"6700"
D1046,1,09/24/2020,OIO6TDL5TO,100.00,"6600"
D1046,1,09/24/2020,OIO0TDNXKM,100.00,"6500"
D1046,1,09/24/2020,OIO6TDQZ3K,100.00,"6400"
D1046,1,09/24/2020,OIO0TDT5TU,50.00,"6350"
D1046,1,09/28/2020,OIS2XRTVXY,100.00,"6250"
D1046,1,09/28/2020,OIS4XRVVCA,100.00,"6150"
D1046,1,09/28/2020,OIS4XRZUTA,100.00,"6050"
D1046,1,09/28/2020,OIS0XS9RU8,100.00,"5950"
D1046,1,09/30/3030,OIU51G7B19,100,"5850"
D1046,1,09/30/3030,OIU21GC1W0,100,"5750"
D1046,1,10/05/2020,OJ576U7RMF,1050,"4700"
D1046,1,10/12/2020,OJC4EWET50,400,"4300"
D1046,1,10/21/2020,OJL2OVJ7VK,500,"3800"
D1046,1,10/22/2020,OJM9QFMB2X,100,"3700"
D1046,1,10/22/2020,OJM4QG9UXA,100,"3600"
D1046,1,10/22/2020,OJM3QGHAHH,100,"3500"
D1046,1,10/22/2020,OJM8QIG9S6,100,"3400"
D1046,1,10/22/2020,OJM0QJ47Z4,1000,"2400"
D1046,1,10/22/2020,OJM7QJE4QX,1000,"1400"
D1046,1,10/23/2020,OJN0R9USHY,900,500
D1046,1,10/22/2020,OJM2QK046G,500,0
D1046,2,10/29/2020,OJT7XPJ735,217.00,"6583"
D1046,2,11/07/2020,OK769ERJKM,300.00,"6283"
D1046,2,11/12/2020,OKC5FM6EVR,100.00,"6183"
D1046,2,11/12/2020,OKC3FM9FLB,100,"6083"
D1046,2,11/13/2020,OKD9GHYAOD,250,"5833"
D1046,2,11/17/2020,OKH9L0N2VH,217,"5616"
D1046,2,11/18/2020,OKI7MENAVR,100,"5516"
D1046,2,11/18/2020,OKI8MEPVG0,100,"5416"
D1046,2,11/18/2020,OKI7MEU09R,17,"5399"
D1046,2,11/25/2020,OKP9UDYB5B,5361,38
D1046,2,11/26/2020,OKQ0VS3IVE,300,262
D1047,1,09/30/2020,OIU81B62NU,"1658.00","4742"
D1047,1,10/05/2020,OJ5875OQBA,"1650.00","3092"
D1047,1,10/14/2020,OJE9HL6WDP,"1650.00","1442"
D1047,1,10/19/2020,OJJ9MUNVV7,"1525.00",83
D1047,2,10/26/2020,OJQ6UZMANQ,"1625.00","4875"
D1047,2,11/01/2020,OK132ETRWJ,"1625.00","3250"
D1047,2,11/09/2020,OK91CDHRI9,"1625.00","1625"
D1047,2,11/16/2020,OKG0KH747K,1625,0
D1047,3,11/24/2020,OKO0TK9HPA,"2275.00","6405"
D1047,3,12/01/2020,OL123JQFB8,"2275.00","4130"
D1047,3,12/08/2020,OL83CGIIZ9,"2275.00","1855"
D1047,3,12/9/2020,OL93D6T14P,1855,0
D1047,4,12/16/2020,OLG1LQMVV5,"2275.00","6825"
D1047,4,12/24/2020,OLO8X67160,"2275.00","4550"
D1047,4,01/02/2021,PA2280CW6O,"2275.00","2275"
D1047,4,1/6/2021,PA63CW9IFR,"2275",0
D1047,5,01/13/2021,PAD2LFX8OG,"3250.00","9750"
D1047,5,01/20/2021,PAK2TGJWV0,"3250.00","6500"
D1047,5,01/29/2021,PAT248QNLA,"2000.00","4500"
D1047,5,1/30/2021,PAU667S9LK,"1250","3250"
D1047,5,02/03/2021,PB33AHEHUZ,3250,0
D1047,6,02/13/2021,PBD3N4AVF5,"3250.00","9050"
D1047,6,02/20/2021,PBK8VFPXQ8,"3250.00","5800"
D1047,6,02/25/2021,PBP81ZDQL2,"5800.00",0
D1047,7,03/05/2021,PC54CXBJAY,"3250.00","9650"
D1047,7,03/13/2021,PCD0NCT5MY,"3250.00","6400"
D1047,7,03/20/2021,PCK2VPXQIO,"3250.00","3150"
D1047,7,3/24/2021,PCO91W9LGZ,"3150",0
D1047,8,04/03/2021,PD39EVOL3B,"3250.00","8750"
D1047,8,04/10/2021,PDA8NT6RCQ,"3250.00","5500"
D1047,8,04/10/2021,PDC2QEC3G6,"5500.00",0
D1047,9,04/21/2021,PDL63EZFHC,"3900.00","10860"
D1047,9,05/01/2021,PE11GBI763,"3900.00","6960"
D1047,9,05/03/2021,PE32IHZEUI,"6960.00",0
D1047,10,06/14/2021,PFE14MOAUV,"2000.00","16960"
D1047,10,06/22/2021,PFM9F7ADV3,"2000.00","14960"
D1047,10,06/22/2021,PFM6FK5TGG,"1000.00","13960"
D1047,10,6/30/2021,PFU2QSRQNC,"1500","12460"
D1047,10,07/01/2021,PG12SLANXC,1500,"10960"
D1047,10,07/05/2021,PG58XZ6RCK,2000,"8960"
D1047,10,07/13/2021,PGD8AVO7VU,1000,"7960"
D1047,10,07/14/2021,PGE9BTRW55,400,"7560"
D1047,10,07/14/2021,PGE5CHXYVX,2250,"5310"
D1047,10,07/31/2021,PGV51T4XG7,3000,"2310"
D1047,10,09/04/2021,PI45GWR71H,700,"1610"
D1047,10,09/18/2021,PII63IK7TE,300,"1310"
D1047,10,09/29/2021,PIT8IZYOKW,100,"1210"
D1047,10,09/29/2021,PIT5J07JKF,100,"1110"
D1047,10,09/29/2021,PIT3J0HY9J,100,"1010"
D1047,10,09/29/2021,PIT6J0O9OA,28,982
D1047,10,10/12/2021,PJC44X2N4I,1,981
D1047,10,10/12/2021,PJC94QV4W7,300,681
D1047,10,11/2/2021,PK101VC6EG,350,331
D1047,10,11/03/2021,PK335GT37N,380,49
D1048,1,10/23/2020,OJN0RALDL8,19500,0
D1048,2,11/20/2020,OKK0OSHH36,19500,150
D1048,3,11/20/2020,OKK0OSHH36_D2,150,"19200"
D1048,3,12/18/2020,OLI5OGWIZ5,"19200",0
D1048,4,1/16/2021,PAG9O7I9NN,"19500",0
D1048,5,2/13/2021,PBD1MLNAAZ,"25800",0
D1048,6,3/13/2021,PCD9MQKRUT,"25800",0
D1048,7,4/10/2021,PDA4NROOT2,"28380",0
D1048,8,5/8/2021,PE85PEM03V,"28380",0
D1048,9,6/5/2021,PF55RBB5UL,"32250",0
D1048,10,7/3/2021,PG38V26LC6,"32250",0
D1048,11,7/31/2021,PGV5100635,"33540",0
D1048,12,8/28/2021,PHS964HEB7,"33540",0
D1048,13,9/25/2021,PIP1D7WEPP,"38700",0
D1048,14,11/20/2021,PKK2WOJ01Q,"38700",0
D1048,15,12/18/2021,PLI7B5GLD1,"38700",0
D1048,16,1/14/2022,QAF3MX0D69,"38700",0
D1048,17,2/12/2022,QBC21W8WHC,"39990",0
D1048,18,3/15/2022,QCF9PDDKWL,"40300",0
D1048,19,4/13/2022,QDD5BMTW6P,"40300",0
D1048,20,5/11/2022,QEB8SZ62LQ,"40300",0
D1048,21,6/7/2022,QF74BF87V2,"40300",0
D1048,22,7/5/2022,QG53W9UDB3,"40300",0
D1048,23,08/03/2022,QH30KN6UY2,"40300",0
D1048,24,09/01/2022,QI136EQKUR,"40300",0
D1048,25,09/30/2022,QIU0XHRZSA,"40300",0
D1048,26,10/29/2022,QJT2TN6HZW,"40300",0
D1048,27,11/18/2022,QKI46OH73C,"6000","33990"
D1048,27,11/26/2022,QKQ3OW8NCT,"33990",0
D1048,28,12/20/2022,QLK0LCMQR2,"31250",0
D1048,29,01/18/2022,RAI0MOM5F2,"39000",0
D1048,30,02/16/2023,RBG2RQC4AS,"39000",0
D1048,31,03/17/2023,RCH1YTPVI9,"39000",0
D1048,32,04/14/2023,RDE857Z5QK,"39000",0
D1048,33,05/13/2023,RED1FPD57L,"39300","1000"
D1048,33,05/13/2023,RED3HP3QXJ,"1000",0
D1048,34,06/10/2023,RFA2OWUP06,"39990",0
D1048,35,07/10/2023,RGA568JK3T,"40300",0
D1048,36,08/09/2023,RH93MYVIUX,"40300",0
D1049,1,11/10/2020,OKA4DA4X1I,"20000","9200"
D1049,1,11/10/2020,OKA5DFCCRB,2000,"7200"
D1049,1,11/11/2020,OKB8EAPF6S,7200,0
D1049,2,12/8/2020,OL86BTRZ9A,"25000",600
D1049,2,12/8/2020,OL87BUQ3YX,600,0
D1049,3,1/8/2021,PA85FG7DD1,"3000","24200"
D1049,3,1/13/2021,PAD9L1QFPB,"24000",200
D1049,3,1/13/2021,PAD2L1Y204,200,0
D1049,4,2/18/2021,PBH2RRAWZ6,"4000","27600"
D1049,4,2/19/2021,PBJ2U2ZGQ8,"4000","23600"
D1049,4,2/24/2021,PBO9ZVOFUJ,"10000","13600"
D1049,4,03/06/2021,PC68DTDXWS,"3000","10600"
D1049,4,03/08/2021,PC88GM71M0,"1000","9600"
D1049,4,03/10/2021,PCA4J52SX2,"3000","6600"
D1049,4,03/11/2021,PCB0KDEV4S,"2000","4600"
D1049,4,03/17/2021,PCH4S729I0,"2500","2100"
D1049,4,03/25/2021,PCP936MOKT,900,"1200"
D1049,4,03/27/2021,PCR25F1NE4,400,800
D1049,4,03/30/2021,PCU89SD6XE,200,600
D1049,4,04/06/2021,PD68IYH5WC,300,300
D1049,4,04/07/2021,PD73K9TPUZ,300,0
D1050,1,,,,
D1051,1,10/01/2020,OJ13310MQV,100,"5700"
D1051,1,10/01/2020,OJ182YBWSG,20,"5680"
D1051,1,10/01/2020,OJ102Y8TLG,100,"5580"
D1051,1,10/02/2020,OJ2540221B,100,"5480"
D1051,1,10/02/2020,OJ28407OLC,100,"5380"
D1051,1,10/02/2020,OJ2940DTKD,25,"5355"
D1051,1,10/03/2020,OJ3158FCH9,100,"5255"
D1051,1,10/03/2020,OJ3458GOY2,20,"5235"
D1051,1,10/03/2020,OJ3558OO95,100,"5135"
D1051,1,10/04/2020,OJ426LK4FQ,100,"5035"
D1051,1,10/04/2020,OJ406LN4ME,100,"4935"
D1051,1,10/04/2020,OJ486LPAJ2,20,"4915"
D1051,1,10/05/2020,OJ557TH84F,220,"4695"
D1051,1,10/06/2020,OJ658ZPH9L,20,"4675"
D1051,1,10/06/2020,OJ658ZI293,100,"4575"
D1051,1,10/06/2020,OJ668ZCTDO,100,"4475"
D1051,1,10/07/2020,OJ77A6GB8B,100,"4375"
D1051,1,10/07/2020,OJ71A6HELX,20,"4355"
D1051,1,10/07/2020,OJ74A6NTR4,100,"4255"
D1051,1,10/08/2020,OJ80BA40C8,100,"4155"
D1051,1,10/08/2020,OJ84BA52W4,20,"4135"
D1051,1,10/08/2020,OJ83BAAJHL,100,"4035"
D1051,1,10/09/2020,OJ95CK22NB,100,"3935"
D1051,1,10/09/2020,OJ97CK3ZG1,20,"3915"
D1051,1,10/09/2020,OJ95CK52XN,100,"3815"
D1051,1,10/10/2020,OJA1DLX70H,100,"3715"
D1051,1,10/10/2020,OJA5DLZWEZ,17,"3698"
D1051,1,10/10/2020,OJA3DM5GO3,100,"3598"
D1051,1,10/11/2020,OJB5EN3O97,100,"3498"
D1051,1,10/11/2020,OJB8EN61S6,100,"3398"
D1051,1,10/11/2020,OJB9ENAW3R,20,"3378"
D1051,1,10/12/2020,OJC5FU94UR,220,"3158"
D1051,1,10/14/2020,OJE5I5BTKR,100,"3058"
D1051,1,10/14/2020,OJE7I5FQ0X,100,"2958"
D1051,1,10/14/2020,OJE8I5HEW2,30,"2928"
D1051,1,10/15/2020,OJF1IKNI3T,3000,72
D1051,2,10/16/2020,OJG4K144LE,227,"5973"
D1051,2,10/17/2020,OJH6LG44VA,250,"5723"
D1051,2,10/19/2020,OJJ0NMS5YS,100,"5623"
D1051,2,10/19/2020,OJJ3NMTQVH,100,"5523"
D1051,2,10/19/2020,OJJ5NMYSX5,50,"5473"
D1051,2,10/21/2020,OJL7PPEWLF,250,"5223"
D1051,2,10/22/2020,OJM1QTQXHP,100,"5123"
D1051,2,10/22/2020,OJM3QTSPL9,100,"5023"
D1051,2,10/22/2020,OJM3QTUHXD,50,"4973"
D1051,2,10/23/2020,OJN0RRTPP2,220,"4753"
D1051,2,10/24/2020,OJO6T26KUE,300,"4453"
D1051,2,10/25/2020,OJP9U4AJUL,250,"4203"
D1051,2,10/27/2020,OJR6W8KAOM,250,"3953"
D1051,2,10/28/2020,OJS0XCPTAQ,220,"3733"
D1051,2,10/29/2020,OJT6YHLOT6,230,"3503"
D1051,2,11/02/2020,OK253Z6ABF,400,"3103"
D1051,2,11/03/2020,OK3950XV4V,400,"2703"
D1051,2,11/6/2020,OK698XM97Z,600,"2103"
D1051,2,11/7/2020,OK749HSHG2,2103,0
D1051,3,11/09/2020,OK90CL22IA,250,"5850"
D1051,3,11/11/2020,OKB3EQD49H,500,"5350"
D1051,3,11/12/2020,OKC4GA0FYO,220,"5130"
D1051,3,11/21/2020,OKL4Q17ZDC,300,"4830"
D1051,3,11/22/2020,OKM3RPVPQ9,300,"4530"
D1051,3,11/26/2020,OKQ3WIYVYJ,300,"4230"
D1051,3,11/27/2020,OKR6XSNW46,500,"3730"
D1051,3,11/28/2020,OKS1YF2KEV,3730,0
D1051,4,12/12/2020,OLC5HSFO8N,500,"6000"
D1051,4,12/13/2020,OLD7IWFOQR,300,"5700"
D1051,4,12/23/2020,OLN4V0C6B4,500,"5200"
D1051,4,12/25/2020,OLP1YG26U3,600,"4600"
D1051,4,12/27/2020,OLR41J4REY,4000,600
D1051,4,12/27/2020,OLR01MOW7E,900,300
D1051,5,01/26/2021,PAQ1ZIWMGD,6500,0
D1051,6,02/23/2021,PBN5ZECVJJ,"2000","4500"
D1051,6,02/24/2021,PBO8ZU4QJY,"4500",0
D1051,7,03/24/2021,PCO51NNZHB,"7800",0
D1051,8,05/31/2021,PEV7KO0PJ9,"3000","6480"
D1051,8,03/07/2022,QC78B9SFSC,"3000","3480"
D1052,1,10/17/2020,OJH2L0MGO4,3000,"10600"
D1052,1,10/25/2020,OJP7U1ZE2P,2000,"8600"
D1052,1,10/29/2020,OJT2Y5U2H4,8600,0
D1052,2,11/6/2020,OK567VRZII,3250,"8850"
D1052,2,11/15/2020,OKF6JJW0ZG,1300,"7550"
D1052,2,11/18/2020,OKI8MC3BYG,7550,0
D1052,3,11/28/2020,OKS4Y1AD7Y,1250,"11550"
D1052,3,12/6/2020,OL64A1GCDM,"2000","9550"
D1052,3,12/13/2020,OLD1J0JGB1,"2500","7050"
D1052,3,12/15/2020,OLF3KM88NH,7050,0
D1052,4,1/18/2021,PAI2QEWJAG,1750,"12850"
D1052,4,1/22/2021,PAM4VXTZ06,"3000","9850"
D1052,4,1/27/2021,PAR821SY6M,"3000","6850"
D1052,4,1/31/2021,PAV378UFV7,"1000","5850"
D1052,4,02/10/2021,PB168B9C88,"5850",0
D1052,5,2/2/2021,PB279J3CQN,400,"11100"
D1052,5,2/3/2021,PB32B1F5K0,400,"10700"
D1052,5,2/4/2021,PB40C26H62,400,"10300"
D1052,5,2/11/2021,PBB1JY98D3,"1600","8700"
D1052,5,02/15/2021,PBF3OYY12N,"8700",0
D1052,6,3/5/2021,PC58CFR7V6,"11900",0
D1052,7,3/31/2021,PCV2AR1F0Y,"12800",0
D1052,8,4/28/2021,PDS9C920DN,"12900",0
D1052,9,5/26/2021,PEQ1DXWDXH,"12900",0
D1052,10,6/23/2021,PFN4H0WNS,"15480",0
D1053,1,10/09/2020,OJ96CBG9V2,100,"3680"
D1053,1,10/09/2020,OJ96CBJ4A0,100,"3580"
D1053,1,10/09/2020,OJ97CBMFNJ,100,"3480"
D1053,1,10/10/2020,OJA7DPL9UJ,100,"3380"
D1053,1,10/10/2020,OJA0DPM31Q,100,"3280"
D1053,1,10/14/2020,OJE4I5G17W,100,"3180"
D1053,1,10/14/2020,OJE5I5H0S7,100,"3080"
D1053,1,10/14/2020,OJE1I5LEHL,100,"2980"
D1053,1,10/14/2020,OJE5I5MO65,100,"2880"
D1053,1,10/13/2020,OJD8GFD4TG,100,"2780"
D1053,1,10/13/2020,OJD5GFG6PH,80,"2700"
D1053,1,10/15/2020,OJF7J9VT3B,100,"2600"
D1053,1,10/15/2020,OJF7J9WJV7,100,"2500"
D1053,1,10/15/2020,OJF5J9WXT3,98,"2402"
D1053,1,10/21/2020,OJM1PY5AHZ,100,"2302"
D1053,1,10/21/2020,OJM1PY6WMR,100,"2202"
D1053,1,10/27/2020,OJR2VPK2CC,100,"2102"
D1053,1,10/27/2020,OJR2VPMI0Q,100,"2002"
D1053,1,10/27/2020,OJR9VPOZVD,100,"1902"
D1053,1,10/30/2020,OJU9Z6FZCV,100,"1802"
D1053,1,10/30/2020,OJU8Z6IRJ8,100,"1702"
D1053,1,10/30/2020,OJU4Z6KPD0,100,"1602"
D1053,1,11/02/2020,OK203HYJ1G,1602,0
D1053,2,11/03/2020,OK384T8TF8,100,"3470"
D1053,2,11/03/2020,OK334TAQ31,100,"3370"
D1053,2,11/03/2020,OK324TCI1S,100,"3270"
D1053,2,11/6/2020,OK6086F51U,100,"3170"
D1053,2,11/6/2020,OK6586HW25,100,"3070"
D1053,2,11/6/2020,OK6786MID5,100,"2970"
D1053,2,11/13/2020,OKD6HHIMK2,100,"2870"
D1053,2,11/13/2020,OKD7HHK4CR,100,"2770"
D1053,2,11/13/2020,OKD6HHLERA,100,"2670"
D1053,2,11/18/2020,OKI5N66H4J,100,"2570"
D1053,2,11/20/2020,OKK0OSHH36_D3,2600,30
D1053,3,11/25/2020,OKP9UFM4CB,490,"3410"
D1053,3,12/04/2020,OL406OFE9M,450,"2960"
D1053,3,12/10/2020,OLA2ELR0P0,"2000",960
D1053,3,12/16/2020,OLG7M2YAAT,1020,60
D1053,4,02/10/2021,PBA9JQQXCD,450,"3450"
D1053,4,02/16/2021,PBG2Q16YXM,500,"2950"
D1053,4,02/20/2021,PBK8VBOVB0,470,"2480"
D1053,4,3/9/2021,PC95HNMWKB,"2480",0
D1053,5,04/10/2021,PDA1O05RWX,200,"5330"
D1053,5,04/12/2021,PDC0QPYM9E,100,"5230"
D1053,5,04/12/2021,PDC0QQ4HFM,100,"5130"
D1053,5,4/13/2021,PDE3SZEPXN,100,"5030"
D1053,5,4/13/2021,PDE3SZJEDT,100,"4930"
D1053,5,4/16/2021,PDG8VM95KG,100,"4830"
D1053,5,4/16/2021,PDG2VMADM4,50,"4780"
D1053,5,04/17/2021,PDJ8Z6AGNS,100,"4680"
D1053,5,04/28/2021,PDS7BTJSPZ,100,"4580"
D1053,5,04/29/2021,PDT2DBITS8,100,"4480"
D1053,5,04/30/2021,PDU4EMO3X8,100,"4380"
D1053,5,05/03/2021,PE32IP99BU,100,"4280"
D1053,5,05/04/2021,PE41JYD0H3,100,"4180"
D1053,5,05/07/2021,PE63N75F8P,100,"4080"
D1053,5,05/17/2021,PEH42SHG60,100,"3980"
D1053,5,05/17/2021,PEH32SLX5T,100,"3880"
D1053,5,05/17/2021,PEH42SQ95O,100,"3780"
D1053,5,05/18/2021,PEJ05DLA1A,100,"3680"
D1053,5,05/19/2021,PEJ55DP3XV,100,"3580"
D1053,5,5/20/2021,PEK16KOW45,100,"3480"
D1053,5,05/21/2021,PEL87YL7UY,100,"3380"
D1053,5,05/25/2021,PEP5DBMBL7,100,"3280"
D1053,5,05/25/2021,PEP9DBWF7L,100,"3180"
D1053,5,05/27/2021,PER4FQ8CH6,100,"3080"
D1053,5,05/28/2021,PES2HE5YOI,100,"2980"
D1053,5,06/01/2021,PF14M82PK2,100,"2880"
D1053,5,06/02/2021,PF28NX2C9Y,100,"2780"
D1053,5,06/07/2021,PF71UNWUR9,100,"2680"
D1053,5,06/08/2021,PF83W3H745,100,"2580"
D1053,5,06/09/2021,PF99XRSDIP,100,"2480"
D1053,5,06/10/2021,PFA6YRESLM,100,"2380"
D1053,5,06/12/2021,PFC32ABS2Z,100,"2280"
D1053,5,06/14/2021,PFF06PXN1W,100,"2180"
D1053,5,06/15/2021,PFG475RRZS,100,"2080"
D1053,5,06/16/2021,PFH78VAR2J,100,"1980"
D1053,5,06/17/2021,PFH39I60KZ,100,"1880"
D1053,5,06/19/2021,PFJ0BBO2KM,100,"1780"
D1053,5,06/26/2021,PFQ1KSRNFX,100,"1680"
D1053,5,06/26/2021,PFQ7KSSM6D,100,"1580"
D1053,5,06/27/2021,PFR3M8ZDZZ,100,"1480"
D1053,5,06/28/2021,PFS1OFYVC5,100,"1380"
D1053,5,06/29/2021,PFT4Q1V3VW,100,"1280"
D1053,5,06/30/2021,PFU3RC4ZSH,100,"1180"
D1053,5,07/01/2021,PG24TO2DJ2,100,"1080"
D1053,5,07/02/2021,PG26UGTEU2,100,980
D1053,5,07/03/2021,PG32VVMPEY,100,880
D1053,5,,PENALTIES W/OFF,880,0
D1054,1,10/10/2020,OJA4DQAV18,100,"6350"
D1054,1,10/10/2020,OJA1DQYNLT,100,"6250"
D1054,1,10/10/2020,OJA6DR525O,20,"6230"
D1054,1,10/11/2020,OJB4ES9L70,100,"6130"
D1054,1,10/11/2020,OJB7ESAHQ7,100,"6030"
D1054,1,10/12/2020,OJC6FTK17E,100,"5930"
D1054,1,10/12/2020,OJC7FUUI45,100,"5830"
D1054,1,10/13/2020,OJD9FYBUKJ,50,"5780"
D1054,1,10/13/2020,OJD7GV1E91,100,"5680"
D1054,1,10/13/2020,OJD7GW04W3,100,"5580"
D1054,1,10/14/2020,OJE6H30SHG,20,"5560"
D1054,1,10/14/2020,OJE8HT7QLS,100,"5460"
D1054,1,10/14/2020,OJE5HTLCI3,100,"5360"
D1054,1,10/14/2020,OJE8I1D0QU,20,"5340"
D1054,1,10/15/2020,OJF7JAMC1N,100,"5240"
D1054,1,10/15/2020,OJF1JAPR5F,100,"5140"
D1054,1,10/15/2020,OJG1JARGA9,20,"5120"
D1054,1,10/16/2020,OJG8K55ZIA,100,"5020"
D1054,1,10/16/2020,OJG4K5TACI,100,"4920"
D1054,1,10/16/2020,OJG4K6APLW,20,"4900"
D1054,1,10/17/2020,OJH9L6TJ6X,100,"4800"
D1054,1,10/17/2020,OJH9LKHP4R,100,"4700"
D1054,1,10/17/2020,OJH1LKKMWB,20,"4680"
D1054,1,10/18/2020,OJI2MHMLG4,100,"4580"
D1054,1,10/18/2020,OJI5MI26WZ,100,"4480"
D1054,1,10/18/2020,OJI8MIAEBI,20,"4460"
D1054,1,10/19/2020,OJJ1NM5JO3,100,"4360"
D1054,1,10/19/2020,OJJ5NMNVFB,100,"4260"
D1054,1,10/19/2020,OJJ1NNMO4P,20,"4240"
D1054,1,10/20/2020,OJK2OQHGGS,100,"4140"
D1054,1,10/20/2020,OJK3OQHVKF,100,"4040"
D1054,1,10/20/2020,OJK9OQI3SZ,20,"4020"
D1054,1,10/21/2020,OJL4PTGJ0U,100,"3920"
D1054,1,10/21/2020,OJL3PTKO55,100,"3820"
D1054,1,10/21/2020,OJL5PTL21R,20,"3800"
D1054,1,10/22/2020,OJM8QWXT7G,100,"3700"
D1054,1,10/22/2020,OJM0QX27F2,100,"3600"
D1054,1,10/22/2020,OJM6QX2K0A,20,"3580"
D1054,1,10/24/2020,OJO7S1EDD3,100,"3480"
D1054,1,10/24/2020,OJO7S1F0TT,100,"3380"
D1054,1,10/24/2020,OJO6S1F9VW,20,"3360"
D1054,1,10/24/2020,OJO9T6GBTD,20,"3340"
D1054,1,10/24/2020,OJO4T5XIWW,100,"3240"
D1054,1,10/24/2020,OJO5T6IRTV,100,"3140"
D1054,1,10/25/2020,OJP5U1P8RJ,100,"3040"
D1054,1,10/25/2020,OJP5U1XV6J,100,"2940"
D1054,1,10/27/2020,OJR6VAGCZW,100,"2840"
D1054,1,10/27/2020,OJR5VAFR25,100,"2740"
D1054,1,10/27/2020,OJR9VAGRD7,20,"2720"
D1054,1,10/27/2020,OJR9WDWKX9,100,"2620"
D1054,1,10/27/2020,OJR0WE2AC0,100,"2520"
D1054,1,10/27/2020,OJR7WE8RRJ,20,"2500"
D1054,1,10/28/2020,OJS9XHO9LZ,100,"2400"
D1054,1,10/28/2020,OJS7XHP7DH,100,"2300"
D1054,1,10/28/2020,OJS1XHPT0H,20,"2280"
D1054,1,10/30/2020,OJU5YNCZFV,100,"2180"
D1054,1,10/30/2020,OJU7YND9NP,100,"2080"
D1054,1,10/30/2020,OJU8YNDNZA,20,"2060"
D1054,1,10/30/2020,OJU2ZT4MHA,100,"1960"
D1054,1,10/30/2020,OJU2ZT536E,100,"1860"
D1054,1,10/30/2020,OJU0ZT5G96,20,"1840"
D1054,1,11/01/2020,OK10353AM2,100,"1740"
D1054,1,11/01/2020,OK1035497M,100,"1640"
D1054,1,11/01/2020,OK1735ANJR,20,"1620"
D1054,1,11/02/2020,OK244C0620,100,"1520"
D1054,1,11/02/2020,OK234C0JQH,100,"1420"
D1054,1,11/02/2020,OK244C0YOA,20,"1400"
D1054,1,11/04/2020,OK495JB6HB,100,"1300"
D1054,1,11/04/2020,OK415JB9BL,100,"1200"
D1054,1,11/04/2020,OK445JBJSW,20,"1180"
D1054,1,11/04/2020,OK456PMEVR,100,"1080"
D1054,1,11/04/2020,OK496PO077,100,980
D1054,1,11/04/2020,OK496POZD1,20,960
D1054,1,11/06/2020,OK647Y7JJI,100,860
D1054,1,11/06/2020,OK667Y7PC6,100,760
D1054,1,11/06/2020,OK677Y80JJ,20,740
D1054,1,10/31/2020,OJV2209VJ6,20,720
D1054,1,10/31/2020,OJV820888W,100,620
D1054,1,10/31/2020,OJV82075XQ,100,520
D1054,1,10/25/2020,OJP0U2B5FW,20,500
D1054,1,11/06/2020,OK658PT2DX,100,400
D1054,1,11/06/2020,OK658PWABJ,100,300
D1054,1,11/06/2020,OK608PZP2U,100,200
D1054,1,11/06/2020,OK658Q2KQD,100,100
D1054,1,11/06/2020,OK678Q6LLP,100,0
D1054,2,11/07/2020,OK77AF9FHV,100,"6300"
D1054,2,11/07/2020,OK79AFALBH,100,"6200"
D1054,2,11/07/2020,OK77AFBRBX,50,"6150"
D1054,2,11/8/2020,OK84BKKOR2,100,"6050"
D1054,2,11/8/2020,OK81BKJPKL,100,"5950"
D1054,2,11/8/2020,OK81BKKTMT,50,"5900"
D1054,2,11/10/2020,OKA1CRUX6D,100,"5800"
D1054,2,11/10/2020,OKA2CRV6RO,100,"5700"
D1054,2,11/10/2020,OKA7CRVGLP,50,"5650"
D1054,2,11/10/2020,OKA9DY7CKN,100,"5550"
D1054,2,11/10/2020,OKA2DY8B4W,100,"5450"
D1054,2,11/10/2020,OKA5DYVQ3N,50,"5400"
D1054,2,11/11/2020,OKB3F521KF,100,"5300"
D1054,2,11/11/2020,OKB4F5316E,100,"5200"
D1054,2,11/11/2020,OKB3F5431Z,50,"5150"
D1054,2,11/12/2020,OKC2GA83M8,100,"5050"
D1054,2,11/12/2020,OKC6GA9KEM,100,"4950"
D1054,2,11/12/2020,OKC2GABMO4,50,"4900"
D1054,2,11/14/2020,OKE9HIFZLD,100,"4800"
D1054,2,11/14/2020,OKE7HIG0HJ,100,"4700"
D1054,2,11/14/2020,OKE4HIG0CG,50,"4650"
D1054,2,11/14/2020,OKE5INJNPH,100,"4550"
D1054,2,11/14/2020,OKE0INKCN4,100,"4450"
D1054,2,11/14/2020,OKE5INL2ER,50,"4400"
D1054,2,11/15/2020,OKF4JPOEIO,100,"4300"
D1054,2,11/15/2020,OKF7JPOLPN,100,"4200"
D1054,2,11/15/2020,OKF2JPOSXI,50,"4150"
D1054,2,11/16/2020,OKG1KUK5OH,100,"4050"
D1054,2,11/16/2020,OKG6KULAU0,100,"3950"
D1054,2,11/16/2020,OKG7KUMJJH,50,"3900"
D1054,2,11/17/2020,OKH5M1RI07,100,"3800"
D1054,2,11/17/2020,OKH2M1RTE4,100,"3700"
D1054,2,11/17/2020,OKH1M1S3D9,50,"3650"
D1054,2,11/19/2020,OKJ1N7PVCD,100,"3550"
D1054,2,11/19/2020,OKJ5N7Q6U3,100,"3450"
D1054,2,11/19/2020,OKJ2N7Q9ZW,50,"3400"
D1054,2,11/20/2020,OKK5OCKJI7,100,"3300"
D1054,2,11/20/2020,OKK0OCL0TY,100,"3200"
D1054,2,11/20/2020,OKK4OCLFIO,50,"3150"
D1054,2,11/20/2020,OKK7PK7JZL,100,"3050"
D1054,2,11/20/2020,OKK0PK7TVI,100,"2950"
D1054,2,11/21/2020,OKL4PK8CUE,50,"2900"
D1054,2,11/22/2020,OKM1QRPIBJ,100,"2800"
D1054,2,11/22/2020,OKM1QRQ7B9,100,"2700"
D1054,2,11/22/2020,OKM9QRQIAR,50,"2650"
D1054,2,11/24/2020,OKO9T0VBRL,100,"2550"
D1054,2,11/24/2020,OKO1T0VPSD,100,"2450"
D1054,2,11/24/2020,OKO2T0W740,50,"2400"
D1054,2,11/25/2020,OKP1U8QQLZ,100,"2300"
D1054,2,11/25/2020,OKP3U8R6TD,100,"2200"
D1054,2,11/25/2020,OKP3U8RL6V,50,"2150"
D1054,2,11/26/2020,OKQ5VGQMCD,100,"2050"
D1054,2,11/26/2020,OKQ2VGQTRS,100,"1950"
D1054,2,11/26/2020,OKQ8VGRH0C,50,"1900"
D1054,2,11/26/2020,OKQ7WOQYGF,100,"1800"
D1054,2,11/26/2020,OKQ8WORACS,100,"1700"
D1054,2,11/26/2020,OKQ6WORM4C,50,"1650"
D1054,2,11/27/2020,OKR5XQIPPN,100,"1550"
D1054,2,11/27/2020,OKR5XQMRIJ,100,"1450"
D1054,2,11/27/2020,OKR4XQR7I8,50,"1400"
D1054,2,11/30/2020,OKU31BW59Z,100,"1300"
D1054,2,11/30/2020,OKU11BWRWN,100,"1200"
D1054,2,11/30/2020,OKU51BXGL3,100,"1100"
D1054,2,11/30/2020,OKU31CHCE7,100,"1000"
D1054,2,11/30/2020,OKU31CIFEX,100,900
D1054,2,12/01/2020,OL192JSPEV,100,800
D1054,2,12/01/2020,OL142JSUT6,100,700
D1054,2,12/01/2020,OL142JSZ1Y,50,650
D1054,2,12/1/2020,OL153T7VWX,100,550
D1054,2,12/1/2020,OL153T97G1,100,450
D1054,2,12/1/2020,OL153TBCJL,50,400
D1054,2,12/02/2020,OL2353BH8T,100,300
D1054,2,12/02/2020,OL2253F2VG,100,200
D1054,2,12/02/2020,OL2653XV4U,50,150
D1054,2,12/03/2020,OL385UZQDY,150,0
D1054,3,12/05/2020,OL5390URYD,100,"6400"
D1054,3,12/05/2020,OL5390VGB1,100,"6300"
D1054,3,12/05/2020,OL5990VRKH,50,"6250"
D1054,3,12/6/2020,OL68A731DO,100,"6150"
D1054,3,12/6/2020,OL68A742D2,100,"6050"
D1054,3,12/6/2020,OL61A74OZL,100,"5950"
D1054,3,12/8/2020,OL89BHR8L5,100,"5850"
D1054,3,12/8/2020,OL89BHREKF,100,"5750"
D1054,3,12/8/2020,OL88BHRFIA,50,"5700"
D1054,3,12/9/2020,OL98CROHEO,100,"5600"
D1054,3,12/9/2020,OL96CRONFK,100,"5500"
D1054,3,12/9/2020,OL93CRP2EX,100,"5400"
D1054,3,12/9/2020,OLA2E1PRDW,100,"5300"
D1054,3,12/9/2020,OLA6E1Q2A8,100,"5200"
D1054,3,12/9/2020,OLA5E1Q757,50,"5150"
D1054,3,12/11/2020,OLB1FBI3SB,100,"5050"
D1054,3,12/11/2020,OLB2FBJDWC,100,"4950"
D1054,3,12/11/2020,OLB1FBJKPB,50,"4900"
D1054,3,12/12/2020,OLC0GMI4XC,100,"4800"
D1054,3,12/12/2020,OLC1GMIETH,100,"4700"
D1054,3,12/12/2020,OLC1GMIQZJ,50,"4650"
D1054,3,12/13/2020,OLD4J04VO6,100,"4550"
D1054,3,12/13/2020,OLD0J075R2,100,"4450"
D1054,3,12/13/2020,OLD2J09P86,100,"4350"
D1054,3,12/14/2020,OLE4K87IJM,100,"4250"
D1054,3,12/14/2020,OLE0K897BA,100,"4150"
D1054,3,12/14/2020,OLE9K8B21H,100,"4050"
D1054,3,12/15/2020,OLF6LIVOZ2,100,"3950"
D1054,3,12/15/2020,OLF7LIWWM7,100,"3850"
D1054,3,12/15/2020,OLF4LIXU4S,100,"3750"
D1054,3,12/18/2020,OLI7O3JNYT,100,"3650"
D1054,3,12/18/2020,OLI1O3KKS1,100,"3550"
D1054,3,12/18/2020,OLI2O3KNB6,100,"3450"
D1054,3,12/18/2020,OLI9O68MLN,100,"3350"
D1054,3,12/18/2020,OLI2O6ATYE,100,"3250"
D1054,3,12/20/2020,OLK9RU5R5F,100,"3150"
D1054,3,12/20/2020,OLK2RU68KQ,100,"3050"
D1054,3,12/20/2020,OLK0RU6JIA,100,"2950"
D1054,3,12/22/2020,OLM2T3UXYS,100,"2850"
D1054,3,12/22/2020,OLM9T3VTP7,100,"2750"
D1054,3,12/22/2020,OLM7TF331L,50,"2700"
D1054,3,12/22/2020,OLM5UCTYLT,100,"2600"
D1054,3,12/22/2020,OLM0UCX1GI,100,"2500"
D1054,3,12/22/2020,OLM6UCZXCO,100,"2400"
D1054,3,12/24/2020,0LO9VSQLRL,100,"2300"
D1054,3,12/24/2020,0LO7VSQORV,100,"2200"
D1054,3,12/24/2020,0LO5VSR1Z3,100,"2100"
D1054,3,12/25/2020,OLP3XCE5NV,100,"2000"
D1054,3,12/25/2020,OLP8XCNREE,100,"1900"
D1054,3,12/26/2020,OLQ0ZMYR8E,100,"1800"
D1054,3,12/26/2020,OLQ2ZMZ6T0,100,"1700"
D1054,3,12/26/2020,OLQ3ZMZVYV,100,"1600"
D1054,3,12/28/2020,OLT22USCV4,100,"1500"
D1054,3,12/28/2020,OLT32USE9P,100,"1400"
D1054,3,12/28/2020,OLT92USMT3,100,"1300"
D1054,3,12/30/2020,OLU041REFY,100,"1200"
D1054,3,12/30/2020,OLU641RH5C,100,"1100"
D1054,3,12/30/2020,OLU841RONO,100,"1000"
D1054,3,01/01/2021,PA117OEH95,1000,0
D1054,4,01/25/2021,PAP0YD1RT6,350,"8610"
D1054,4,02/02/2021,PB2590NQT3,500,"8110"
D1054,4,02/03/2021,PB33B7QHIT,300,"7810"
D1054,4,2/5/2021,PB56D26NIO,400,"7410"
D1054,4,2/10/2021,PBA5JBWV39,450,"6960"
D1054,4,2/12/2021,PBC9LO13RX,6960,0
D1054,5,03/06/2021,PC67DRJ3EL,900,"8060"
D1054,5,03/11/2021,PCB7K5SPSV,8060,0
D1054,6,03/24/2021,PCO71P7HKH,500,"8390"
D1054,6,03/30/2021,PCU69ON14U,500,"7890"
D1054,6,04/06/2021,PD69IGA6TP,7890,0
D1054,7,05/03/2021,PE36IXBO1O,8960,0
D1054,8,05/31/2021,PEV1KMPH6L,9030,0
D1054,9,06/29/2021,PFT4PKV6QG,9100,0
D1054,10,07/28/2021,PGS4VNFZAU,9100,0
D1054,11,08/25/2021,PHP91PV47V,9030,0
D1054,12,09/23/2021,PIN8AG2D8Y,9100,0
D1054,13,10/22/2021,PJM7L5UE7F,9030,0
D1055,1,10/15/2020,OJF7IBTJH3,1100,"5700"
D1055,1,10/19/2020,OJJ5MWBM1H,700,"5000"
D1055,1,10/26/2020,OJQ1UZ8LMF,400,"4600"
D1055,1,10/23/2020,OJN6RGGBGA,1000,"3600"
D1055,1,11/6/2020,OK678LWCAT,1900,"1700"
D1055,1,11/09/2020,OK98C8XDH0,1700,0
D1055,2,11/27/2020,OKQ5WB37CP,500,"3400"
D1055,2,12/06/2020,OL689XR5QS,"3500",100
D1055,3,01/05/2021,PA52BH6WWY,1000,"6900"
D1055,3,02/03/2021,PB30AGBUTY,"6300",600
D1055,3,02/03/2021,PB32ALDKBW,600,0
D1055,4,03/03/2021,PC349S5DZ4,"6400",100
D1055,4,03/03/2021,PC379SI2FP,100,0
D1055,5,05/07/2021,PE70OI7RY0,"6500",0
D1056,1,11/10/2020,OKA5D6YWUP,19350,0
D1056,2,12/09/2020,OL98D6T14P,"26000",0
D1056,3,01/04/2021,PA40A7NAC8,"25400",0
D1056,4,02/01/2021,PB1384XUBH,"25800",0
D1056,5,03/01/2021,PC17729I6Z,"32250",0
D1056,6,03/29/2021,PCT58AUB3D,"32250",0
D1056,7,04/27/2021,PDR6B3JBO8,"32500",0
D1056,8,05/26/2021,PEQ9DVBWU7,"39000",0
D1056,9,06/24/2021,PFO0I8F2TI,"39000",0
D1056,10,07/23/2021,PGN1OR4YMF,"45000",500
D1056,10,07/23/2021,PGN8ORTJO0,500,0
D1056,11,08/19/2021,PHJ3SBS6NH,"44800",0
D1056,12,09/17/2021,PIH41LY3X2,"52000",0
D1056,13,10/16/2021,PJG8BDYHOY,"52000",0
D1056,14,11/13/2021,PKD2LD3TH4,"51600",0
D1056,15,,,,"58500"
D1056,16,01/08/2022,QA84B7P95W,"58050",0
D1056,17,02/04/2022,QB49ME0MSD,"64000",0
D1056,18,03/05/2022,QC516A7ZAX,"65000",0
D1056,19,04/02/2022,QD20P8M63Q,"64500",0
D1056,20,04/30/2022,QDU27XVGFK,"64500",0
D1056,21,05/28/2022,QES7QSXBFJ,"65000",0
D1056,22,06/25/2022,QFP1BRYSCJ,"64500",0
D1056,23,07/23/2022,QGN9XNTHA7,"64500",0
D1056,24,08/20/2022,QHK6I9SD6W,"64500",0
D1056,25,09/10/2022,QIA0PBB3DW,"61000",0
D1056,26,10/05/2022,QJ52A66MT4,"63000",0
D1056,27,10/19/2022,QJJ97T05I5,"57500",0
D1056,28,11/28/2022,QKS2TTH3DQ,"38700",0
D1056,29,12/19/2022,QLJ7IEYAT7,"61000",0
D1056,30,01/17/2023,RAH2KJ2DWG_D2,"65000",0
D1056,31,02/02/2023,RB28QQ7P7C,"58500",0
D1056,32,03/042023,RC40YLZHGC,"65000",0
D1056,33,05/02/2023,RE21JL54FR,"65000",0
D1056,34,06/02/2023,RF221RZ24I,"65000",0
D1056,35,07/03/2023,RG32L063SO,"65000",0
D1056,36,07/31/2023,RGV7URBV6R,"64500",0
D1057,1,10/22/2020,OJM9QRYCWD,1400,"11600"
D1057,1,10/20/2020,OJK8OQATRM,800,"10800"
D1057,1,11/11/2020,OKB6EWCWTM,10400,400
D1057,1,11/11/2020,OKB1EWPQU9,200,200
D1057,1,11/12/2020,OKC0FDNJOG,200,0
D1057,2,11/20/2020,OKK7OEIKNN,2000,"11000"
D1057,2,11/26/2020,OKQ6WO7YGS,2000,"9000"
D1057,2,12/10/2020,OLA7F9VTA3,"9000",0
D1057,3,01/12/2021,PAB4J9BQUE,"2000","11600"
D1057,3,01/13/2021,PAC4K2SAMW,"11650",50
D1057,4,01/30/2021,PAU65S4ZP4,"1000","5500"
D1057,4,02/03/2021,PB30AU6WSY,700,"4800"
D1057,4,02/10/2021,PBA3JUXYMZ,"4800",0
D1057,5,03/22/2021,PCM4YHA0EO,"13650",50
D1057,6,04/26/2021,PDQ09804L8,"16320",0
D1057,7,05/24/2021,PEO8B5KJBC,"15600",0
D1057,8,06/21/2021,PFL2EGQEHK,"2000","21700"
D1057,8,06/30/2021,PFU0QGRWU4,"1000","20700"
D1057,8,07/05/2021,PG50XWJNZI,"1000","19700"
D1057,8,07/13/2021,PGD2B5QBWC,4000,"15700"
D1057,8,07/22/2021,PGM3MRG0XZ,2000,"13700"
D1057,8,08/02/2021,PH204X3V5E,1800,"11900"
D1057,8,08/14/2021,PHE3MA2AVN,1000,"10900"
D1057,8,08/15/2021,PHF1NNW6Y3,2000,"8900"
D1057,8,08/23/2021,PHN4XQR0TY,1000,"7900"
D1057,8,09/13/2021,PID3TWUQSN,1000,"6900"
D1058,1,11/12/2020,OKC0FIQVR8,"13000",500
D1058,2,11/12/2020,OKC0FIQVR8_D2,500,"13100"
D1058,2,12/15/2020,OLF0KIUUQ6,3000,"10100"
D1058,2,12/16/2020,OLG5M9PQN5,"10100",0
D1058,3,01/08/2021,PA88F3DV8I,"12400",0
D1058,4,02/06/2021,PB67DTNNUT,"15600",0
D1058,5,03/06/2021,PC62DIWAD6,"15480",0
D1058,6,03/20/2021,PCK5VSHECD,"13800",0
D1058,7,04/17/2021,PDH3WT6FNN,"39000",0
D1058,8,05/05/2021,PE53MBB0G3,"20000","20800"
D1058,8,05/16/2021,PEG010Q4EU,2000,"18800"
D1058,8,05/17/2021,PEH6263YF6,"18800",0
D1058,9,06/15/2021,PFF7711977,"23400",0
D1058,10,07/14/2021,PGE1BRVL79,"29670",0
D1058,11,08/11/2021,PHB8HSOFX6,"12500","26500"
D1058,11,08/12/2021,PHC2IC3MV6,26500,0
D1058,12,08/30/2021,PHU59R6GLV,"1600","36100"
D1058,12,09/09/2021,PI99PAM7OV,4700,"31400"
D1058,12,09/10/2021,PIA1PZK047,"31400",0
D1058,13,09/30/2021,PIU0KLWY4O,"2600","36400"
D1058,13,10/09/2021,PJ93ZHV6YP,36400,0
D1058,14,10/19/2021,PJJ0GOF5RI,"24800","9100"
D1058,14,10/21/2021,PJL2J6S3PG,100,"9000"
D1058,14,10/21/2021,PJL9J62NIB,100,"8900"
D1058,14,10/21/2021,PJL7J5S555,100,"8800"
D1058,14,10/21/2021,PJL8J50U0O,8800,0
D1058,15,11/18/2021,PKI8TPE2YY,"7740",0
D1058,16,11/24/2021,PKO94A107R,"8400",0
D1058,17,12/09/2021,PL92UVGBTA,"25520",0
D1058,18,01/05/2022,QA54658VMM,"23050",10
D1058,19,01/17/2022,QAH4QFAJS6,"28000",0
D1058,20,02/08/2022,QB84TO5VNW,"36000",0
D1058,21,03/05/2022,QC5961SV9T,"10000","29000"
D1058,21,03/07/2022,QC789V2J6Q,29000,0
D1058,22,03/27/2022,QCR9CY8YE7,500,"38500"
D1058,22,04/04/2022,QD43SFJY9X,38500,0
D1058,23,04/07/2022,QD75YJGR3B,500,"34000"
D1058,23,04/18/2022,QDI5KMPOS,34000,0
D1058,24,05/15/2022,QEF828QC8M,"3000","36000"
D1058,24,05/21/2022,QEL4D0LGYU,36000,0
D1058,25,06/09/2022,QF90G2F444,"36300",0
D1058,26,07/10/2022,QGA78TBYMN,100,"38900"
D1058,26,0718/2022,QGI8NCTSBA,100,"38800"
D1058,26,07/23/2022,QGN5XULEJ3,"38800",0
D1058,27,08/23/2022,QHN2NIY1II,"39000","1800"
D1058,27,08/23/2022,QHN2NT98HG,1800,0
D1059,1,10/28/2020,OJS1XI1RJD,6500,"18100"
D1059,1,11/04/2020,OK406PLELS,6500,"11600"
D1059,1,11/11/2020,OKB2F5BUCE,6500,"5100"
D1059,1,11/12/2020,OKC9FI68NJ,5100,0
D1059,2,11/19/2020,OKJ1OC4H45,6500,"18100"
D1059,2,11/26/2020,OKQ8WOMITS,6500,"11600"
D1059,2,12/03/2020,OL336E1V97,6500,"5100"
D1059,2,12/04/2020,OL426QQVPS,"5100",0
D1059,3,12/11/2020,OLB1GLS21X,"6500","17100"
D1059,3,12/19/2020,OLJ8QOIKYG,6500,"10600"
D1059,3,12/21/2020,OLL0S8X808,10600,0
D1059,4,12/28/2020,OLS72TU817,"8125","21625"
D1059,4,01/04/2021,PA42B8YIKG,8125,"13500"
D1059,4,01/08/2021,PA85F8FQHT,"13500",0
D1059,5,01/17/2021,PAH8Q7GI60,"6000","23500"
D1059,5,01/19/2021,PAJ0SHKV0O,2125,"21375"
D1059,5,01/25/2021,PAP4YHFPC6,"21375",0
D1059,6,02/06/2021,PB65F0JA79,"8125","21625"
D1059,6,02/12/2021,PBC0L80QWS,"21625",0
D1059,7,03/12/2021,PCC4ME2O6Q,"4000","35500"
D1059,7,03/23/2021,PCN6ZPFHZO,975,"34525"
D1059,7,03/31/2021,PCV4ADDJ7M,"1000","33525"
D1059,7,03/31/2021,PCV0AODCY2,200,"33325"
D1059,7,04/04/2021,PD41GS0CVJ,1000,"32325"
D1059,7,04/08/2021,PD88L69XAE,500,"31825"
D1059,7,04/09/2021,PD96MFYTKQ,500,"31325"
D1059,7,04/10/2021,PDA7OOXUN3,500,"30825"
D1059,7,04/10/2021,PDB4PXYJ58,500,"30325"
D1059,7,04/14/2021,PDE9TRTKNB,500,"29825"
D1059,7,04/15/2021,PDF5V4F5IR,500,"29325"
D1059,7,05/15/2021,PEF6YUX608,500,"28825"
D1059,7,06/01/2021,PF17MMRL7X,300,"28525"
D1059,7,07/03/2021,PG34VDLM1Q,300,"28225"
D1059,7,07/03/2021,PG35W6XR3J,300,"27925"
D1059,7,07/31/2021,PGV1ZP5X3F,200,"27725"
D1059,7,08/02/2021,PH2848RD4C,50,"27675"
D1059,7,08/06/2021,PH66A4WTDS,300,"27375"
D1059,7,08/31/2021,PHV4BQT2L0,100,"27275"
D1060,1,,,,"11200"
D1060,2,11/04/2020,OK455UVRX9,11200,0
D1060,3,11/11/2020,OKB7ECJ2XR,"11200",0
D1060,4,11/17/2020,OKH1LA6IAB,"11200",0
D1060,5,11/25/2020,OKP6UP6Y1K,"13440",0
D1060,6,12/02/2020,OL2244BAZS,"13440",0
D1060,7,12/02/2020,OL2244BAZS_D2,"13440",0
D1060,8,12/16/2020,OLG2M0XK7K,"13800",0
D1060,9,01/02/2021,PA2785U1F3,"14280",0
D1060,10,01/20/2021,PAK8SVILGE,"14280",0
D1060,11,02/03/2021,PB31AHK5AT,"13920",0
D1060,12,02/20/2021,PBK3V6MQ0X,"3100","11540"
D1060,12,02/23/2021,PBN8Z1AUWK,"11540",0
D1060,13,11/17/2021,PKH5SPH8UR,530,"18430"
D1060,13,11/20/2021,PKK6WK12JW,500,"17930"
D1060,13,12/18/2021,PLI8B0O55I,500,"17430"
D1061,1,11/23/2020,OKN0SB6AHI,"26000","1200"
D1061,1,11/23/2020,OKN6SCOB4W,"1200",0
D1061,2,12/21/2020,OLL5SJ6RX7,"26000",0
D1061,3,01/28/2021,PAS035204Q,"1000","12600"
D1061,3,01/30/2021,PAU85V7TSI,"1000","11600"
D1061,3,02/01/2021,PB137UOQ6F,"2000","9600"
D1061,3,02/04/2021,PB46BHQ89U,"2000","7600"
D1061,3,02/08/2021,PB83GGXZQ7,"7000",600
D1061,3,02/08/2021,PB82GI957C,600,0
D1061,4,02/11/2021,PBB7KFHAV9,"11200",0
D1061,5,02/24/2021,PBO8ZZN86Q,"1000","30500"
D1061,5,03/01/2021,PC177MIZLT,"5000","25500"
D1061,5,03/02/2021,PC2690V8FS,"3000","22500"
D1061,5,03/03/2021,PC32A97WTA,"3000","19500"
D1061,5,03/04/2021,PC47BLMNJ1,"2000","17500"
D1061,5,03/05/2021,PC51CCK241,"2000","15500"
D1061,5,03/06/2021,PC67EEGWH9,"3000","12500"
D1061,5,03/07/2021,PC75FKKP6T,"3000","9500"
D1061,5,03/08/2021,PC80GEMPDU,"9500",0
D1061,6,03/10/2021,PCA9IX6HIR,"2000","30500"
D1061,6,03/13/2021,PCD2MOKJWK,"2000","28500"
D1061,6,03/15/2021,PCF1PRY5JV,"1000","27500"
D1061,6,03/16/2021,PCG0R728UQ,"1000","26500"
D1061,6,03/17/2021,PCH3S0FAAZ,"1000","25500"
D1061,6,03/19/2021,PCJ0UT4228,"2000","23500"
D1061,6,03/20/2021,PCK0W6M6EA,"1000","22500"
D1061,6,03/29/2021,PCT78FW39Z,"2000","20500"
D1061,6,03/31/2021,PCV8AK0382,"2000","18500"
D1061,6,03/31/2021,PCV0B4XBOM,2000,"16500"
D1061,6,04/03/2021,PD37EO1SIH,4000,"12500"
D1061,6,04/06/2021,PD69J9Y1P1,12500,0
D1061,7,05/25/2021,PEP8D47AZY,"1000","31500"
D1061,7,05/27/2021,PER1EZDTWX,"5000","26500"
D1061,7,05/27/2021,PER8FRVKGO,"1000","25500"
D1061,7,05/31/2021,PEV9KQDDHZ,"3000","22500"
D1061,7,06/18/2021,PFI5AQIGL9,"22500",0
D1061,8,07/05/2021,PG57Y1TJQ3,"1000","19400"
D1061,8,07/06/2021,PG64ZXZNYO,"1000","18400"
D1061,8,07/06/2021,PG6010A1YE,"1000","17400"
D1061,8,07/07/2021,PG702F2IP8,"1000","16400"
D1061,8,07/10/2021,PGA3601WLX,"1000","15400"
D1061,8,07/10/2021,PGA66SLMMC,"1000","14400"
D1061,8,07/11/2021,PGB3891CVR,1000,"13400"
D1061,8,07/15/2021,PGF1DU3KRN,1000,"12400"
D1061,8,07/17/2021,PGH3GQNEUT,1000,"11400"
D1061,8,07/21/2021,PGL5LGC0B5,1000,"10400"
D1061,8,07/26/2021,PGQ5TBLTH3,2000,"8400"
D1061,8,07/28/2021,PGS7W3PEET,"7500",900
D1061,8,09/16/2021,PIG1YPYDZP,900,0
D1061,9,09/17/2021,PIH91QXF8L,"1000","18350"
D1061,9,09/18/2021,PII435PHDQ,"1000","17350"
D1061,9,09/20/2021,PIK25I5HCA,"1000","16350"
D1061,9,09/20/2021,PIK76KA0HJ,"1000","15350"
D1061,9,09/23/2021,PIN7A3A9NH,"1000","14350"
D1061,9,10/08/2021,PJ89YB66YX,"1000","13350"
D1061,9,10/14/2021,PJE18CIMFV,13500,150
D1061,10,10/14/2021,PJE18CIMFV_D2,150,"32100"
D1061,10,11/04/2021,PK476TIHT3,"2000","30100"
D1061,10,11/05/2021,PK578CF56L,"2000","28100"
D1061,10,11/07/2021,PK77CAO99X,"2000","26100"
D1061,10,11/09/2021,PK94FILW9O,"2000","24100"
D1061,10,11/11/2021,PKB8HXOCAM,"2000","22100"
D1061,10,11/11/2021,PKB0ITHANI,22100,0
D1061,11,11/13/2021,PKD8LSZ9EG,1000,"31500"
D1061,11,11/13/2021,PKD3LZ4DMX,"1000","30500"
D1061,11,11/17/2021,PKH6RDH4XM,"2000","28500"
D1061,11,11/18/2021,PKI8T5HFYS,"2000","26500"
D1061,11,11/24/2021,PKO44DUJJE,"2000","24500"
D1061,11,11/28/2021,PKS8B0C4VA,"2000","22500"
D1061,11,11/29/2021,PKT1CT6V9T,2000,"20500"
D1061,11,11/30/2021,PKU6E9S5XM,2000,"18500"
D1061,11,12/01/2021,PL10G1B38G,2000,"16500"
D1061,11,12/05/2021,PL59NGG9CN,2000,"14500"
D1061,11,12/08/2021,PL84TMCMQI,2000,"12500"
D1061,11,12/10/2021,PLA5WZON33,12500,0
D1061,12,01/01/2022,QA16YQG168,2000,"24000"
D1061,12,01/02/2022,QA2518RJJB,"2000","22000"
D1061,12,01/05/2022,QA56610C6Q,"2000","20000"
D1061,12,01/06/2022,QA697LKL1T,"4000","16000"
D1061,12,01/06/2022,QA668HSP08,"3000","13000"
D1061,12,01/08/2022,QA88BSFB62,"9000","4000"
D1061,12,01/09/2022,QA94CSNXJO,4000,0
D1061,13,03/23/2022,QCN65H7N4U,39000,0
D1061,14,03/28/2022,QCS7FCQQQ7,500,"38500"
D1061,14,03/31/2022,QCV7K4QNS1,"1000","37500"
D1061,14,03/31/2022,QCV7L8E60N,"1000","36500"
D1061,14,04/02/2022,QD23PGXLF3,"2000","34500"
D1061,14,04/04/2022,QD47SA2ZVL,1000,"33500"
D1061,14,04/06/2022,QD63WF9G6Z,2000,"31500"
D1061,14,04/08/2022,QD871J818Z,2000,"29500"
D1061,14,04/08/2022,QD862MAXMC,1000,"28500"
D1061,14,04/10/2022,QDA15HJTKL,1000,"27500"
D1061,14,04/11/2022,QDB98D6B8X,1000,"26500"
D1061,14,04/14/2022,QDE4E3XGV2,1000,"25500"
D1061,14,04/16/2022,QDG6GU1HPM,1000,"24500"
D1061,14,04/17/2022,QDH5JIM2S1,2000,"22500"
D1061,14,04/20/2022,QDK6OKNBJO,22500,0
D1061,15,05/06/2022,QE69IWEWPN,1000,"25000"
D1061,15,05/17/2022,QEH165C8MN,"25000",0
D1061,16,06/14/2022,QFE5PDVED9,26000,0
D1061,17,07/12/2022,QGC8BM90OC,39000,0
D1061,18,08/08/2022,QH83VNTNST,39000,0
D1061,19,09/06/2022,QI61H3SMWT,39000,0
D1061,20,10/05/2022.,QJ56AG1W6Q,39000,0
D1061,21,11/03/2022,QK3569PZI7,39000,0
D1061,22,11/28/2022,QKS7TXMW4H,44100,0
D1061,23,12/29/2022,QLT58PPI95,68000,0
D1061,24,01/27/2023,RAR8BEOTIW,65000,0
D1061,25,02/22/2023,RBM17TIV1P,63500,0
D1061,26,03/20/2023,,63500,0
D1061,27,04/18/2023,RDI0GG8JVA,65000,0
D1061,28,,,,"65000"
D1061,29,06/13/2023,REG6OXU2R0,64500,0
D1061,30,07/13/2023,RGD5FLKJOV,65000,0
D1061,31,08/16/2023,RHG5APHOL3,15000,"53000"
D1061,31,8/21/2023,RHL1OTB0MF,"3000","50000"
D1061,31,8/21/2023,RHL4ORDMXK,"50000",0
D1062,1,10/30/2020,OJU3ZR0DMV,1625,"4875"
D1062,1,11/06/2020,OK658CGFEF,1625,"3250"
D1062,1,11/13/2020,OKD6GTBT24,1625,"1625"
D1062,1,11/20/2020,OKK5PAF9WT,1625,0
D1062,2,12/04/2020,OL496UNE8N,1625,"4875"
D1062,2,12/11/2020,OLB1FSI3P7,1625,"3250"
D1062,2,12/16/2020,OLG1MKZPTP,1625,"1625"
D1062,2,12/24/2020,OLO9X33AJ1,1625,0
D1062,3,01/06/2021,PA61D6KMVJ,1625,"4875"
D1062,3,01/09/2021,PA96G7R5VU,400,"4475"
D1062,3,01/10/2021,PAA3HL859X,"1225","3250"
D1062,3,1/17/2021,PAH9Q5CIB7,1625,"1625"
D1062,3,01/26/2021,PAQ51GXB81,1625,0
D1063,1,10/24/2020,OJO1SW38CD,100,"7700"
D1063,1,10/24/2020,OJO7SW7DI9,100,"7600"
D1063,1,10/24/2020,OJO5SWFP55,60,"7540"
D1063,1,10/26/2020,OJQ8U73M8S,100,"7440"
D1063,1,10/26/2020,OJQ7U73X6N,100,"7340"
D1063,1,10/27/2020,OJR2VFKICQ,100,"7240"
D1063,1,10/27/2020,OJR9VFNKFF,100,"7140"
D1063,1,10/27/2020,OJR6VFQJ3C,60,"7080"
D1063,1,10/28/2020,OJS6XHL79E,100,"6980"
D1063,1,10/28/2020,OJS2XHMBF4,100,"6880"
D1063,1,10/28/2020,OJS2XHNDLA,60,"6820"
D1063,1,10/29/2020,OJT2YN3P2K,100,"6720"
D1063,1,10/29/2020,OJT9YN47ZV,100,"6620"
D1063,1,10/29/2020,OJT6YN5HL6,60,"6560"
D1063,1,11/01/2020,OK192BGF23,100,"6460"
D1063,1,11/01/2020,OK182BIVZ6,100,"6360"
D1063,1,11/01/2020,OK142BPZ5G,60,"6300"
D1063,1,11/03/2020,OK344C36E0,100,"6200"
D1063,1,11/03/2020,OK384C3BEO,100,"6100"
D1063,1,11/03/2020,OK324C3N3C,60,"6040"
D1063,1,11/03/2020,OK335ILM0H,100,"5940"
D1063,1,11/03/2020,OK335IM4M7,100,"5840"
D1063,1,11/03/2020,OK375IMNI1,60,"5780"
D1063,1,11/05/2020,OK5675WX22,100,"5680"
D1063,1,11/05/2020,OK5075YPIG,100,"5580"
D1063,1,11/05/2020,OK57763VMX,60,"5520"
D1063,1,11/06/2020,OK678SCZAJ,60,"5460"
D1063,1,11/06/2020,OK688SGST4,60,"5400"
D1063,1,11/06/2020,OK698SJVPD,100,"5300"
D1063,1,11/06/2020,OK608SMPUW,100,"5200"
D1063,1,11/06/2020,OK628SPLZ0,100,"5100"
D1063,1,11/06/2020,OK698SVZGL,100,"5000"
D1063,1,11/10/2020,OKA7DYYI21,100,"4900"
D1063,1,11/10/2020,OKA0DYZAV2,60,"4840"
D1063,1,11/10/2020,OKA9DYZHBJ,100,"4740"
D1063,1,11/11/2020,OKB9DZ03H1,100,"4640"
D1063,1,11/11/2020,OKB3DZ0CDZ,100,"4540"
D1063,1,11/11/2020,OKB0DZ0WN2,60,"4480"
D1063,1,11/18/2020,OKI2M7KBE8,1000,"3480"
D1063,1,11/18/2020,OKI2M7X51Y,520,"2960"
D1063,1,11/21/2020,OKL0PYQ4U6,2900,60
D1063,1,11/21/2020,OKL1PZ2LWV,60,0
D1063,2,02/01/2021,PB117S456L,100,"7400"
D1063,2,02/01/2021,PB157SB1LH,"1000","6400"
D1063,2,02/01/2021,PB137SJRBL,650,"5750"
D1063,2,02/09/2021,PB98HNAMUG,1820,"3930"
D1063,2,02/18/2021,PBI2SVESFG,"3930",0
D1063,3,03/-08/2021,PC82G3CHHC,"7000",800
D1063,3,03/17/2021,PCH5RW4NL3,800,0
D1063,4,03/24/2021,PCO72MGN4Z,"10800",400
D1063,4,03/27/2021,PCR06GN5PU,100,300
D1063,4,03/27/2021,PCR56HD905,270,30
D1063,4,03/27/2021,PCR76HILTV,30,0
D1063,5,04/29/2021,PDT2DOCDBE,"12200",0
D1063,6,05/28/2021,PES6GBXRBI,"13000",0
D1063,7,06/26/2021,PFQ3L1K9KR,"13000",0
D1063,8,07/25/2021,PGP2S9RX7S,"13000",0
D1063,9,08/19/2021,PHJ8SD24GA,"15000",0
D1063,10,09/09/2021,PI91OPMX3T,"14640",0
D1063,11,10/07/2021,PJ76W5COPS,"15480",0
D1063,12,10/27/2021,PJR3TKWN6X,"14640",0
D1063,13,11/27/2021,PKR99DIOZZ,"15600",0
D1063,14,12/23/2021,PLN6JQNMSS,"15240",0
D1063,15,01/21/2022,QAL2X79YUO,"15600",0
D1063,16,02/24/2022,QBO5OUPVJ1,250,"18710"
D1063,16,03/08/2022,QC81CRQWY5,250,"18460"
D1063,16,03/23/2022,QCN85GLM90,2000,"16460"
D1063,16,04/13/2022,QDD8BC3DTA,250,"16210"
D1063,16,05/04/2022,QE47G3FUIZ,250,"15960"
D1063,16,05/23/2022,QEN5IA37LV,250,"15710"
D1063,16,06/10/2022,QEN5IA37LV_D2,100,"15610"
D1063,16,06/10/2022,QEN5IA37LV_D3,50,"15560"
D1063,16,06/10/2022,QEN5IA37LV_D4,100,"15460"
D1063,16,06/10/2022,QFA8I31PQ0,100,"15360"
D1063,16,06/10/2022,QFA1I35CXZ,50,"15310"
D1063,16,06/10/2022,QFA7I37WHF,100,"15210"
D1063,16,06/24/2023,RFO1U7XX5N,500,"14710"
D1063,16,06/30/2023,RFU4B746GA,500,"14210"
D1064,1,11/04/2020,OK475XYQGX,2000,"13800"
D1064,1,11/08/2020,OK89AGNJUB,1250,"12550"
D1064,1,11/19/2020,OKJ3NTAXN5,1000,"11550"
D1064,1,11/23/2020,OKN8S14Y3S,2000,"9550"
D1064,1,1/4/2021,PA43A1GFP1,3250,"6300"
D1064,1,02/03/2021,PB30AB4QD6,"1000","5300"
D1064,1,04/09/2021,PD95M5VO85,500,"4800"
D1064,1,04/14/2021,PDE9T05JXD,200,"4600"
D1065,1,11/02/2020,OK283UG4F0,3250,"9750"
D1065,1,11/09/2020,OK98CQDP5W,3250,"6500"
D1065,1,11/23/2020,OKN9T0K0OL,6500,0
D1065,2,12/05/2020,OL557V13Y9,1000,"12600"
D1065,2,12/05/2020,OL548WOG7M,2250,"10350"
D1065,2,12/11/2020,OLB7GHGB11,2450,"7900"
D1065,2,12/12/2020,OLC0HWJFOS,800,"7100"
D1065,2,12/23/2020,OLN5V7E76F,6500,600
D1065,2,12/23/2020,0LN4VKHLAK,600,0
D1065,3,01/14/2021,PAE8MCY1JU,500,"12500"
D1065,3,01/21/2021,PAL3UOBEBX,1500,"11000"
D1065,3,01/23/2021,PAN7WCADY1,1250,"9750"
D1065,3,1/30/2021,PAU55K6RL1,3250,"6500"
D1065,3,2/6/2021,PB68E7V8RQ,3250,"3250"
D1065,3,2/10/2021,PBA4J15JUU,3250,0
D1065,4,02/19/2021,PBJ8TJR0SU,"3200","9800"
D1065,4,02/19/2021,PBJ0U6354C,50,"9750"
D1065,4,02/26/2021,PBQ540XWNX,"3250","6500"
D1065,4,3/5/2021,PC52CD69IE,500,"6000"
D1065,4,3/5/2021,PC56DBILTY,"2700","3300"
D1065,4,3/6/2021,PC63EAUW3T,50,"3250"
D1065,4,03/10/2021,PCA0J0CYFA,"3250",0
D1065,5,03/20/2021,PCK0WJ7GH4,"3250","9750"
D1065,5,03/29/2021,PCT17SKVS7,3200,"6550"
D1065,5,04/03/2021,PD34EM59C2,"3300","3250"
D1065,5,4/7/2021,PD73JZ30L5,3250,0
D1065,6,04/16/2021,PDG9VYKR39,"3250","9750"
D1065,6,04/26/2021,PDQ79X618P,3250,"6500"
D1065,6,05/01/2021,PE15GIDLWP,"3250","3250"
D1065,6,5/5/2021,PE52LBWHOM,3250,0
D1065,7,05/15/2021,PEF4YW8J7O,"3250","9750"
D1065,7,05/22/2021,PEM19GQZQT,3250,"6500"
D1065,7,05/29/2021,PET6IGUK3E,"3250","3250"
D1065,7,6/2/2021,PF27MYQGS1,3250,0
D1065,8,06/15/2021,PFF764C9ND,"3200","9800"
D1065,8,06/22/2021,PFM4FRZV4W,"3300","6500"
D1065,8,06/28/2021,PFS3NP8E6R,"3250","3250"
D1065,8,6/29/2021,PFT3P6JPNZ,3250,0
D1065,9,07/19/2021,PGJ6IU9U4A,"3000","23000"
D1065,9,07/21/2021,PGL3LHL0BX,"3000","20000"
D1065,9,07/21/2021,PGL5M960M1,"3000","17000"
D1065,9,7/23/2021,PGM8NHJK8G,"3000","14000"
D1065,9,7/24/2021,PGO3QQMGFN,"9000","5000"
D1065,9,07/26/2021,PGQ2T4EA0K,5000,0
D1065,10,08/05/2021,PH5482BE90,"3250","9750"
D1065,10,08/21/2021,PHL3W0J4I5,"6500","3250"
D1065,10,08/23/2021,PHN0XSGHEC,"3250",0
D1065,11,09/07/2021,PI73LIOE83,"3250","9750"
D1065,11,09/20/2021,PIK75R5NMF,"9750",0
D1065,12,10/02/2021,PJ28NWE252,"3250","9750"
D1065,12,10/15/2021,PJF19PX88X,"9750",0
D1065,13,10/27/2021,PJR3TE2A7V,"3250","9750"
D1065,13,11/10/2021,PKA8HDASA0,"8000","1750"
D1065,13,11/11/2021,PKB9I8K9DL,1750,0
D1065,14,12/03/2021,PL33JOU4F1,"6000","7000"
D1065,14,12/09/2021,PL96U5DCJ2,"7250",250
D1065,15,12/30/2021,PLU4UWG5Q0,"12750",250
D1065,15,12/09/2021,PL96U5DCJ2_D2,250,0
D1065,16,01/26/2022,QAQ75ZXC6B,"13000",0
D1065,17,02/22/2022,QBM5K0039X,"13000",0
D1065,18,03/19/2022,QCJ6XZPIA0,"6500","6500"
D1065,18,03/21/2022,QCL62SSPDU,"6500",0
D1065,19,04/16/2022,QDG7HTUJYX,"10000","3000"
D1065,19,04/18/2022,QDI2L3F6X4,"3000",0
D1065,20,05/12/2022,QEC9USPGWD,"12600",0
D1065,21,06/06/2022,QF63AGHH99,"13000",0
D1065,22,07/03/2022,QG33SS30P9,"13000",0
D1065,23,07/29/2022,QGT7BL6SJ7,"12500",200
D1065,23,07/30/2022,QGU2CDXFXQ,200,0
D1065,24,08/26/2022,QHQ7UMZQNL,"13000",0
D1065,25,09/23/2022,QIN3JGES8N,"13000",0
D1065,26,10/21/2022,QJL9B7VIGL,"25600",0
D1065,27,11/12/2022,QKC5RLYI0F,"24800",0
D1065,28,12/07/2022,QL78LAX9O6,"25400",0
D1065,29,12/28/2022,QLT28V5SF0,"24800",0
D1065,30,01/21/2023,RAL6UY5E94,"24600",0
D1065,31,02/02/2023,RBK92O9PYF,"25600",0
D1065,32,03/18/2023,RCI64P9LI4,"25600",0
D1065,33,04/14/2023,RDE86SBJBI,"25200",0
D1065,34,05/09/2023,RE985PSV5O,"31250",0
D1065,35,06/06/2023,RF65E6WDHX,"32250",0
D1065,36,07/05/2023,RG54SG9WW2,"34000",0
D1065,37,08/04/2023,RH46929VDW,"25800",200
D1065,37,08/04/2023,RH468XJ1RI,200,0
D1066,1,10/29/2020,OJT7YA26JB,100,"3980"
D1066,1,10/29/2020,OJT4YA550K,30,"3950"
D1066,1,10/30/2020,OJU7ZLOD7H,100,"3850"
D1066,1,10/30/2020,OJU6ZLUR1W,30,"3820"
D1066,1,10/31/2020,OJV91ZOYWD,100,"3720"
D1066,1,10/31/2020,OJV31ZPZ9X,30,"3690"
D1066,1,11/01/2020,OK102X8SFE,100,"3590"
D1066,1,11/01/2020,OK142XBX0K,30,"3560"
D1066,1,11/02/2020,OK2449LD66,100,"3460"
D1066,1,11/02/2020,OK2049MFSW,20,"3440"
D1066,1,11/02/2020,OK2749NZLZ,10,"3430"
D1066,1,11/03/2020,OK395D09F7,100,"3330"
D1066,1,11/03/2020,OK395D0DNP,30,"3300"
D1066,1,11/04/2020,OK436OCEDT,100,"3200"
D1066,1,11/04/2020,OK486OD7R6,30,"3170"
D1066,1,11/05/2020,OK587VBHH0,100,"3070"
D1066,1,11/05/2020,OK537VDCKF,30,"3040"
D1066,1,11/06/2020,OK678ZDU51,100,"2940"
D1066,1,11/06/2020,OK668ZG2LE,30,"2910"
D1066,1,11/07/2020,OK73ACN4A9,100,"2810"
D1066,1,11/07/2020,OK75ACR3DZ,30,"2780"
D1066,1,11/08/2020,OK85BGP1RF,100,"2680"
D1066,1,11/08/2020,OK88BGPWMC,30,"2650"
D1066,1,11/09/2020,OK94CMRCJ2,100,"2550"
D1066,1,11/09/2020,OK99CMSDAT,30,"2520"
D1066,1,11/10/2020,OKA4DR2EBM,100,"2420"
D1066,1,11/10/2020,OKA2DR4N82,30,"2390"
D1066,1,11/11/2020,OKB0F166NE,100,"2290"
D1066,1,11/11/2020,OKB8F16CDG,30,"2260"
D1066,1,11/13/2020,OKD5HBF3QD,100,"2160"
D1066,1,11/13/2020,OKD0HBGZYC,30,"2130"
D1066,1,11/13/2020,OKD6HBITFQ,100,"2030"
D1066,1,11/13/2020,OKD7HBMORL,30,"2000"
D1066,1,11/14/2020,OKE3IISNJR,100,"1900"
D1066,1,11/14/2020,OKE4IIU4FE,30,"1870"
D1066,1,11/15/2020,OKF9JMDMXF,100,"1770"
D1066,1,11/15/2020,OKF7JMH0CH,30,"1740"
D1066,1,11/16/2020,OKG7KT3M5N,100,"1640"
D1066,1,11/16/2020,OKG0KT4EQ2,30,"1610"
D1066,1,11/17/2020,OKH8LSABZS,100,"1510"
D1066,1,11/17/2020,OKH7LSEGJJ,30,"1480"
D1066,1,11/18/2020,OKI3N43Q9X,30,"1450"
D1066,1,11/18/2020,OKI4N45JDA,100,"1350"
D1066,1,11/19/2020,OKJ9O96PRX,100,"1250"
D1066,1,11/19/2020,OKJ3O98A1L,30,"1220"
D1066,1,11/20/2020,OKK0PFL234,100,"1120"
D1066,1,11/20/2020,OKK0PFOO8Y,30,"1090"
D1066,1,11/21/2020,OKL0QO3GLK,30,"1060"
D1066,1,11/21/2020,OKL7QO4EIV,100,960
D1066,1,11/24/2020,OKO3TY1ES7,100,860
D1066,1,11/24/2020,OKO0TY7RP8,100,760
D1066,1,11/24/2020,OKO5TY8WKR,30,730
D1066,1,11/24/2020,OKO3TYN8XL,30,700
D1066,1,11/25/2020,OKP9VCGKUP,30,670
D1066,1,11/25/2020,OKP7VCL0C1,100,570
D1066,1,11/25/2020,OKP2VCPP68,30,540
D1066,1,11/27/2020,OKR9WS27JB,100,440
D1066,1,11/27/2020,OKR0WSKAB4,100,340
D1066,1,11/27/2020,OKR4WSLFRG,30,310
D1066,1,11/27/2020,OKR1XLQZLP,100,210
D1066,1,11/27/2020,OKR3XLU3VZ,100,110
D1066,1,11/27/2020,OKR0XLWCM0,10,100
D1066,1,11/27/2020,OKR5XM6B99,100,0
D1066,2,12/04/2020,OL467ISML0,100,"3740"
D1066,2,12/04/2020,OL417IVIB1,30,"3710"
D1066,2,12/05/2020,OL518CVYLP,30,"3680"
D1066,2,12/05/2020,OL548CX6IC,100,"3580"
D1066,2,12/06/2020,OL689ZIF5Q,100,"3480"
D1066,2,12/06/2020,OL609ZK0OW,30,"3450"
D1066,2,12/07/2020,OL73B3YOEH,30,"3420"
D1066,2,12/07/2020,OL77B41L3R,100,"3320"
D1066,2,12/08/2020,OL80CC9ME6,100,"3220"
D1066,2,12/08/2020,OL86CCB2P4,30,"3190"
D1066,2,12/10/2020,OLA9EAN7YL,100,"3090"
D1066,2,12/10/2020,OLA6EAOC8I,30,"3060"
D1066,2,12/11/2020,OLB6FQLW7A,100,"2960"
D1066,2,12/11/2020,OLB6FQN3D6,30,"2930"
D1066,2,12/12/2020,OLC0H946ZY,30,"2900"
D1066,2,12/12/2020,OLC0H94A5U,100,"2800"
D1066,2,12/13/2020,OLD0IV4I22,100,"2700"
D1066,2,12/13/2020,OLD2IV65V6,30,"2670"
D1066,2,12/14/2020,OLE7K2EUTH,100,"2570"
D1066,2,12/16/2020,OLG0LSGK3W,30,"2540"
D1066,2,12/16/2020,OLG9MHH84B,50,"2490"
D1066,2,12/18/2020,OLI5ONKML5,100,"2390"
D1066,2,12/18/2020,OLI9ONM2K3,30,"2360"
D1066,2,12/18/2020,OLI6ONNTUM,70,"2290"
D1066,2,12/19/2020,OLJ8PPT4N2,100,"2190"
D1066,2,12/20/2020,OLK0RPNW8U,100,"2090"
D1066,2,12/20/2020,OLK1RPQ5KX,30,"2060"
D1066,2,12/22/2020,OLM8U2EAFW,100,"1960"
D1066,2,12/22/2020,OLM2U2G29I,50,"1910"
D1066,2,12/23/2020,0LN9V5EUJP,100,"1810"
D1066,2,12/23/2020,0LN3V5HQA9,30,"1780"
D1066,2,12/25/2020,OLP7XKZSUL,100,"1680"
D1066,2,12/25/2020,OLP6XL1MZ4,30,"1650"
D1066,2,12/28/2020,OLS31Z7DCF,500,"1150"
D1066,2,12/28/2020,OLS41ZEIW4,500,650
D1066,2,12/28/2020,OLS81ZYMQ0,100,550
D1066,2,12/28/2020,OLS920228P,100,450
D1066,2,12/28/2020,OLS4204FO4,100,350
D1066,2,12/28/2020,OLS3207KXL,100,250
D1066,2,12/28/2020,OLS4209LUW,100,150
D1066,2,12/28/2020,OLS520C7TF,100,50
D1066,2,12/28/2020,OLS620K4VY,50,0
D1066,3,12/29/2020,OLT73QVO21,100,"3800"
D1066,3,12/29/2020,OLT53R3S13,30,"3770"
D1066,3,12/31/2020,OLV65OBVNM,100,"3670"
D1066,3,12/31/2020,OLV75OGE17,30,"3640"
D1066,3,01/01/2021,PA1374SAEF,100,"3540"
D1066,3,01/01/2021,PA1374VARJ,30,"3510"
D1066,3,01/04/2021,PA46B6Z4KK,100,"3410"
D1066,3,01/04/2021,PA46B70OTA,30,"3380"
D1066,3,01/06/2021,PA68D9W6LM,100,"3280"
D1066,3,01/06/2021,PA62D9XEMQ,30,"3250"
D1066,3,01/07/2021,PA74ELDOEI,100,"3150"
D1066,3,01/07/2021,PA75ELGS65,30,"3120"
D1066,3,01/08/2021,PA82FTES6U,100,"3020"
D1066,3,01/08/2021,PA82FTHXH6,30,"2990"
D1066,3,1/9/2021,PA98H3BVI8,100,"2890"
D1066,3,1/9/2021,PA90H3HDQO,30,"2860"
D1066,3,1/10/2021,PAA8I5FB9A,100,"2760"
D1066,3,1/10/2021,PAA1I5IH53,30,"2730"
D1066,3,1/11/2021,PAB2JATHIO,30,"2700"
D1066,3,1/11/2021,PAB8JAXTR0,100,"2600"
D1066,3,1/12/2021,PAC4KFVGB6,100,"2500"
D1066,3,1/12/2021,PAC5KFWGTN,30,"2470"
D1066,3,1/14/2021,PAE3MNW14L,100,"2370"
D1066,3,1/14/2021,PAE8MNXYP6,30,"2340"
D1066,3,1/15/2021,PAF0NTTRUM,100,"2240"
D1066,3,1/15/2021,PAF1NTWUHP,30,"2210"
D1066,3,1/16/2021,PAG1P2SSNF,100,"2110"
D1066,3,1/16/2021,PAG9P2TJZ9,30,"2080"
D1066,3,1/17/2021,PAH4Q3Q4SW,100,"1980"
D1066,3,1/17/2021,PAH1Q3RAA5,30,"1950"
D1066,3,1/18/2021,PAI5R8STN5,100,"1850"
D1066,3,1/18/2021,PAI1R9GT19,30,"1820"
D1066,3,1/19/2021,PAJ9RXFZBD,20,"1800"
D1066,3,1/19/2021,PAJ3SEL1OZ,100,"1700"
D1066,3,1/19/2021,PAJ9SEORL5,30,"1670"
D1066,3,1/20/2021,PAK0TKDQPW,100,"1570"
D1066,3,1/20/2021,PAK5TKFDSF,10,"1560"
D1066,3,1/21/2021,PAL6UPDWVU,100,"1460"
D1066,3,1/21/2021,PAL6UPGES8,30,"1430"
D1066,3,1/22/2021,PAM6VVF0IQ,100,"1330"
D1066,3,1/22/2021,PAM8VVHP3G,30,"1300"
D1066,3,1/24/2021,PAO8Y18MBC,100,"1200"
D1066,3,1/24/2021,PAO7Y1A4R1,30,"1170"
D1066,3,1/24/2021,PAO1Y1GKY1,100,"1070"
D1066,3,1/24/2021,PAO6Y1IW1K,30,"1040"
D1066,3,01/26/2021,PAQ8ZPEM70,1040,0
D1066,4,01/27/2021,PAR22DLOU2,100,"3800"
D1066,4,01/27/2021,PAR02DXVWO,30,"3770"
D1066,4,01/28/2021,PAS23QBAKM,100,"3670"
D1066,4,01/28/2021,PAS43QBF1I,30,"3640"
D1066,4,01/29/2021,PAT94WPKMV,100,"3540"
D1066,4,01/29/2021,PAT84WQXSA,30,"3510"
D1066,4,01/30/2021,PAU75EEQRL,30,"3480"
D1066,4,01/30/2021,PAU65EALCO,100,"3380"
D1066,4,01/31/2021,PAV17EGIM9,100,"3280"
D1066,4,01/31/2021,PAV57EIWH7,30,"3250"
D1066,4,02/01/2021,PB178O6L8P,100,"3150"
D1066,4,02/01/2021,PB188O810C,30,"3120"
D1066,4,02/02/2021,PB299XYDCD,100,"3020"
D1066,4,02/02/2021,PB219XZ6K3,30,"2990"
D1066,4,2/3/2021,PB31B6QQOX,100,"2890"
D1066,4,2/3/2021,PB33B6SIIR,30,"2860"
D1066,4,2/4/2021,PB47CG2NUJ,100,"2760"
D1066,4,2/5/2021,PB51DI1GG7,100,"2660"
D1066,4,2/5/2021,PB51DIWS0F,30,"2630"
D1066,4,2/6/2021,PB64EWVRJQ,100,"2530"
D1066,4,2/6/2021,PB66EWXNCM,30,"2500"
D1066,4,2/7/2021,PB74G3QMPM,100,"2400"
D1066,4,2/7/2021,PB76G3RWGM,30,"2370"
D1066,4,2/8/2021,PB88HC426C,100,"2270"
D1066,4,2/8/2021,PB84HC5PH8,30,"2240"
D1066,4,2/9/2021,PB92IF71II,100,"2140"
D1066,4,2/9/2021,PB93IF95Q5,30,"2110"
D1066,4,2/10/2021,PBA2JMWTCI,100,"2010"
D1066,4,2/10/2021,PBA4JMZ26K,30,"1980"
D1066,4,2/12/2021,PBC5M0N9UL,100,"1880"
D1066,4,2/12/2021,PBC0M0ORS4,30,"1850"
D1066,4,2/12/2021,PBC8M1BHPW,100,"1750"
D1066,4,2/12/2021,PBC8M1GV7Q,30,"1720"
D1066,4,2/14/2021,PBE7OMIOAJ,100,"1620"
D1066,4,2/14/2021,PBE0OMJY8I,30,"1590"
D1066,4,2/15/2021,PBF5PLLIBJ,100,"1490"
D1066,4,2/15/2021,PBF3PLVV6J,30,"1460"
D1066,4,2/16/2021,PBG4QZ599A,100,"1360"
D1066,4,2/16/2021,PBG1QZ8QIN,30,"1330"
D1066,4,2/17/2021,PBH5S72FWL,100,"1230"
D1066,4,2/17/2021,PBH2S79RL0,30,"1200"
D1066,4,2/18/2021,PBI0TG0PLY,100,"1100"
D1066,4,2/18/2021,PBI3TJ81JR,30,"1070"
D1066,4,2/19/2021,PBJ1UQTXX5,100,970
D1066,4,2/21/2021,PBL2X17PEC,100,870
D1066,4,2/21/2021,PBL4X198YE,30,840
D1066,4,02/22/2021,PBM2YAFTFO,100,740
D1066,4,02/22/2021,PBM9YAGEYB,30,710
D1066,4,02/23/2021,PBN4ZGISRA,100,610
D1066,4,02/23/2021,PBN3ZGRRYT,28,582
D1066,4,02/24/2021,PBO812U1F4,580,2
D1066,4,02/24/2021,PBO114MEQ9,2,0
D1066,5,02/25/2021,PBP52XGW9N,135,"4625"
D1066,5,02/26/2021,PBQ947K9OP,135,"4490"
D1066,5,02/27/2021,PBR55J5RY5,135,"4355"
D1066,5,02/28/2021,PBS16QDWM7,100,"4255"
D1066,5,02/28/2021,PBS36QEFKR,35,"4220"
D1066,5,03/01/2021,PC137YIP31,100,"4120"
D1066,5,03/01/2021,PC117YJT93,35,"4085"
D1066,5,03/02/2021,PC2195EQ93,100,"3985"
D1066,5,03/02/2021,PC2895G7DS,35,"3950"
D1066,5,03/04/2021,PC48BTRCR2,100,"3850"
D1066,5,03/04/2021,PC49BTY8VB,35,"3815"
D1066,5,03/05/2021,PC51D3F4NX,100,"3715"
D1066,5,03/05/2021,PC55D3H4M1,35,"3680"
D1066,5,03/07/2021,PC79FT7NCX,100,"3580"
D1066,5,03/07/2021,PC73FT8RQD,35,"3545"
D1066,5,03/07/2021,PC72FTE3HE,100,"3445"
D1066,5,03/07/2021,PC71FTKECB,35,"3410"
D1066,5,3/8/2021,PC89H53G03,100,"3310"
D1066,5,3/8/2021,PC84H547DI,35,"3275"
D1066,5,3/9/2021,PC91II15AT,100,"3175"
D1066,5,3/9/2021,PC95II1N7X,35,"3140"
D1066,5,3/10/2021,PCA4JQLJ40,100,"3040"
D1066,5,3/10/2021,PCA6JQWJTG,35,"3005"
D1066,5,3/11/2021,PCB2L13NMM,100,"2905"
D1066,5,3/11/2021,PCB6L14SV6,35,"2870"
D1066,5,3/12/2021,PCC0MD9BTQ,100,"2770"
D1066,5,3/12/2021,PCC9MDB19N,35,"2735"
D1066,5,3/13/2021,PCD9NPAUC9,100,"2635"
D1066,5,3/13/2021,PCD8NPBHIE,35,"2600"
D1066,5,3/14/2021,PCE0OW5FFY,100,"2500"
D1066,5,3/14/2021,PCE2OW5Y0W,35,"2465"
D1066,5,3/15/2021,PCF5Q6AQFR,100,"2365"
D1066,5,3/15/2021,PCF9Q6BD2V,35,"2330"
D1066,5,3/16/2021,PCG4RFMKK0,100,"2230"
D1066,5,3/16/2021,PCG6RFNC2W,35,"2195"
D1066,5,3/17/2021,PCH3SR000N,100,"2095"
D1066,5,3/17/2021,PCH1SR0Q7X,35,"2060"
D1066,5,3/18/2021,PCI1U1L6D5,100,"1960"
D1066,5,3/18/2021,PCI2U1M180,35,"1925"
D1066,5,3/19/2021,PCJ9VBS7VL,100,"1825"
D1066,5,3/19/2021,PCJ0VBTLTY,35,"1790"
D1066,5,3/22/2021,PCM2XX0IEY,100,"1690"
D1066,5,3/22/2021,PCM4XX0LCU,35,"1655"
D1066,5,3/22/2021,PCM6Z3XRL2,100,"1555"
D1066,5,3/22/2021,PCM1Z3YZU9,35,"1520"
D1066,5,3/25/2021,PCP73SO9RB,500,"1020"
D1066,5,03/29/2021,PCT18SPO47,810,210
D1066,5,03/29/2021,Penalty waived,210,0
D1066,6,04/08/2021,PD89M0RYNN,152,"4398"
D1066,6,04/09/2021,PD98NDYXP0,100,"4298"
D1066,6,04/09/2021,PD90NDZW2K,52,"4246"
D1066,6,04/10/2021,PDA2OOQ1YI,100,"4146"
D1066,6,04/10/2021,PDA5OOS8FL,52,"4094"
D1066,6,04/12/2021,PDC1Q52RCT,100,"3994"
D1066,6,04/12/2021,PDC4Q59KZY,52,"3942"
D1066,6,04/13/2021,PDD0RZ1YSU,152,"3790"
D1066,6,04/14/2021,PDE1TRFPTB,152,"3638"
D1066,6,04/15/2021,PDF8V5SZBS,152,"3486"
D1066,6,04/16/2021,PDG9WDWP6B,152,"3334"
D1066,6,04/18/2021,PDI1YU7CSP,152,"3182"
D1066,6,04/19/2021,PDJ119HZYZ,152,"3030"
D1066,6,04/20/2021,PDK92J2EF7,152,"2878"
D1066,6,04/21/2021,PDL73RFNNL,152,"2726"
D1066,6,04/23/2021,PDN26AOJU8,152,"2574"
D1066,6,04/23/2021,PDN36AVOE3,152,"2422"
D1066,6,4/25/2021,PDP77Z6TQ9,152,"2270"
D1066,6,4/25/2021,PDP48TV30S,152,"2118"
D1066,6,4/26/2021,PDQ7A9IV8B,152,"1966"
D1066,6,4/29/2021,PDT5D50KOD,152,"1814"
D1066,6,4/30/2021,PDU0EN6OLM,152,"1662"
D1066,6,5/2/2021,PE20I67MH0,152,"1510"
D1066,6,5/3/2021,PE38JIXGYI,152,"1358"
D1066,6,5/5/2021,PE56M9J4OS,290,"1068"
D1066,6,5/6/2021,PE60MYNC04,1000,68
D1066,6,5/6/2021,PE61MZ97OT,68,0
D1066,7,05/09/2021,PE92RNMH9O,152,"4398"
D1066,7,05/12/2021,PEC2VOG722,456,"3942"
D1066,7,05/13/2021,PED0X28XS6,100,"3842"
D1066,7,05/20/2021,PEK662R5JM,100,"3742"
D1066,7,05/20/2021,PEK862STLW,52,"3690"
D1066,7,05/20/2021,PEK570WD5D,100,"3590"
D1066,7,05/20/2021,PEK770YUMJ,50,"3540"
D1066,7,05/20/2021,PEK070ZQ8E,2,"3538"
D1066,7,05/25/2021,PEP4DEF68S,100,"3438"
D1066,7,05/25/2021,PEP2DEH3T6,100,"3338"
D1066,7,05/25/2021,PEP0DF0L6A,100,"3238"
D1066,7,05/26/2021,PEQ3ENRW07,100,"3138"
D1066,7,05/26/2021,PEQ3EOD0HZ,52,"3086"
D1066,7,05/27/2021,PER5FUMJ45,100,"2986"
D1066,7,05/27/2021,PER3FUO03L,52,"2934"
D1066,7,05/28/2021,PES6HA03PG,100,"2834"
D1066,7,05/28/2021,PES6HAXAE2,49,"2785"
D1066,7,5/29/2021,PET6IPRCUO,100,"2685"
D1066,7,5/29/2021,PET3IPXCJ1,52,"2633"
D1066,7,5/30/2021,PEU3JXEG2J,100,"2533"
D1066,7,5/30/2021,PEU2JXRML0,47,"2486"
D1066,7,5/31/2021,PEV6L4RLJE,100,"2386"
D1066,7,5/31/2021,PEV0L4TJ7A,52,"2334"
D1066,7,6/1/2021,PF14MOLMVE,100,"2234"
D1066,7,6/1/2021,PF10MOM9I0,100,"2134"
D1066,7,6/1/2021,PF12MOO2FK,100,"2034"
D1066,7,6/1/2021,PF15MOOROJ,100,"1934"
D1066,7,6/1/2021,PF14MOQ60Q,100,"1834"
D1066,7,6/1/2021,PF12MOQUKA,100,"1734"
D1066,7,6/1/2021,PF14MOS8U2,100,"1634"
D1066,7,06/02/2021,PF28O307G8,100,"1534"
D1066,7,06/02/2021,PF24O315LA,100,"1434"
D1066,7,06/02/2021,PF23O34AF7,10,"1424"
D1066,7,06/02/2021,PF28O36F5U,90,"1334"
D1066,7,06/03/2021,PF31PFN9XL,100,"1234"
D1066,7,06/03/2021,PF34PFP2NO,100,"1134"
D1066,7,06/03/2021,PF36PG1040,100,"1034"
D1066,7,06/03/2021,PF34PG36DQ,100,934
D1066,7,06/03/2021,PF33PG4QRZ,100,834
D1066,7,06/04/2021,PF43QA0H0P,100,734
D1066,7,06/04/2021,PF47QA3J3V,100,634
D1066,7,06/04/2021,PF44QA5K62,100,534
D1066,7,06/04/2021,PF44QA824E,34,500
D1066,7,06/04/2021,PF48QAE29C,100,400
D1066,7,06/04/2021,PF46QAH6UC,100,300
D1066,7,06/04/2021,PF49QAJ56N,100,200
D1066,7,06/04/2021,PF47QAL8LV,100,100
D1066,7,06/04/2021,PF43QAOTIV,100,0
D1066,8,06/05/2021,PF56SAJRP2,100,"4450"
D1066,8,06/05/2021,PF57SAOW4J,48,"4402"
D1066,8,06/07/2021,PF75V2AVY7,100,"4302"
D1066,8,06/07/2021,PF79V2H5Q3,45,"4257"
D1066,8,06/09/2021,PF98XTNM4W,100,"4157"
D1066,8,06/09/2021,PF92XTORGS,52,"4105"
D1066,8,06/13/2021,PFD647OXYY,100,"4005"
D1066,8,06/13/2021,PFD647SNCM,100,"3905"
D1066,8,06/22/2021,PFM0GFC0A2,100,"3805"
D1066,8,06/22/2021,PFM2GFD3BO,52,"3753"
D1066,8,06/23/2021,PFN2HTL9FG,100,"3653"
D1066,8,06/23/2021,PFN4HTNKX2,52,"3601"
D1066,8,06/25/2021,PFP9KLYIQ5,100,"3501"
D1066,8,06/25/2021,PFP5KM5F6H,100,"3401"
D1066,8,06/25/2021,PFP7KM9CZJ,100,"3301"
D1066,8,06/25/2021,PFP1KMD2JZ,52,"3249"
D1066,8,06/26/2021,PFQ2M4BYHY,100,"3149"
D1066,8,06/26/2021,PFQ6M4CWHE,52,"3097"
D1066,8,6/27/2021,PFR3NFPJM9,100,"2997"
D1066,8,6/27/2021,PFR3NFRHFV,100,"2897"
D1066,8,6/27/2021,PFR4NFUF4W,100,"2797"
D1066,8,6/27/2021,PFR3NFW3AF,100,"2697"
D1066,8,6/27/2021,PFR3NFY38F,10,"2687"
D1066,8,6/28/2021,PFS7OVO27J,100,"2587"
D1066,8,6/28/2021,PFS0OVQ99G,100,"2487"
D1066,8,6/28/2021,PFS5OVR5AX,100,"2387"
D1066,8,6/28/2021,PFS7OVRSVV,100,"2287"
D1066,8,6/28/2021,PFS6OVTCJG,10,"2277"
D1066,8,6/29/2021,PFT4QAFYSG,100,"2177"
D1066,8,6/29/2021,PFT2QAGRH6,100,"2077"
D1066,8,6/29/2021,PFT6QAHK94,100,"1977"
D1066,8,6/29/2021,PFT0QAHUBG,10,"1967"
D1066,8,06/30/2021,PFU9RKPHT1,100,"1867"
D1066,8,06/30/2021,PFU8RKXP44,100,"1767"
D1066,8,06/30/2021,PFU8RL22BA,52,"1715"
D1066,8,07/01/2021,PG19T3EFKD,100,"1615"
D1066,8,07/01/2021,PG15T3MH9F,100,"1515"
D1066,8,07/01/2021,PG13T3QGXB,100,"1415"
D1066,8,07/02/2021,PG26UK7OTG,100,"1315"
D1066,8,07/02/2021,PG26UKB0BE,100,"1215"
D1066,8,07/03/2021,PG36V0V8SS,100,"1115"
D1066,8,07/03/2021,PG38V0XJ0A,100,"1015"
D1066,8,07/03/2021,PG39V0ZSHX,100,915
D1066,8,07/03/2021,PG39V12DUH,100,815
D1066,8,07/03/2021,PG37V14FUL,100,715
D1066,8,07/03/2021,PG30V18HAS,100,615
D1066,8,07/03/2021,PG35V1CVOB,100,515
D1066,8,07/03/2021,PG37V1EJLV,15,500
D1066,8,07/03/2021,PG37V1KUJV,100,400
D1066,8,07/03/2021,PG39V1MVXV,100,300
D1066,8,07/03/2021,PG32V1PBPY,100,200
D1066,8,07/03/2021,PG31V1SM09,100,100
D1066,8,07/03/2021,PG34V2A7SQ,100,0
D1066,9,07/12/2021,PGC29UXALE,100,"5340"
D1066,9,07/12/2021,PGC79UXOLF,74,"5266"
D1066,9,07/13/2021,PGD8BAHCUS,100,"5166"
D1066,9,07/13/2021,PGD0BAHQ2O,74,"5092"
D1066,9,07/14/2021,PGE9CQMHST,100,"4992"
D1066,9,07/14/2021,PGE9CQMPYP,74,"4918"
D1066,9,07/15/2021,PGF1E6F1K5,100,"4818"
D1066,9,07/15/2021,PGF8E6FNOG,70,"4748"
D1066,9,07/22/2021,PGM0O2S7HM,100,"4648"
D1066,9,07/22/2021,PGM7O2SZ99,100,"4548"
D1066,9,07/22/2021,PGM4O2TREI,100,"4448"
D1066,9,07/22/2021,PGM3O2W0E1,100,"4348"
D1066,9,07/22/2021,PGM1O2WJZT,100,"4248"
D1066,9,07/22/2021,PGM5O2XKCT,100,"4148"
D1066,9,07/22/2021,PGM3O2YK6H,100,"4048"
D1066,9,07/23/2021,PGN7PJOGCB,100,"3948"
D1066,9,07/23/2021,PGN7PJPN3H,100,"3848"
D1066,9,07/23/2021,PGN8PJQH92,100,"3748"
D1066,9,07/23/2021,PGN2PJRI08,100,"3648"
D1066,9,07/23/2021,PGN2PJS9NI,15,"3633"
D1066,9,7/25/2021,PGP2SB40AY,100,"3533"
D1066,9,7/25/2021,PGP5SB4THV,100,"3433"
D1066,9,7/25/2021,PGP4SB5J4C,100,"3333"
D1066,9,7/25/2021,PGP7SB65U7,100,"3233"
D1066,9,7/26/2021,PGQ9TQWEOJ,100,"3133"
D1066,9,7/26/2021,PGQ6TR3JJ4,100,"3033"
D1066,9,7/26/2021,PGQ8TR5YYY,100,"2933"
D1066,9,7/27/2021,PGR1V9BW6H,100,"2833"
D1066,9,7/27/2021,PGR9V9DVT1,100,"2733"
D1066,9,7/27/2021,PGR8V9EQJO,100,"2633"
D1066,9,7/28/2021,PGS8WOL8A8,100,"2533"
D1066,9,7/28/2021,PGS3WOLY7Z,100,"2433"
D1066,9,7/28/2021,PGS7WOMTBT,100,"2333"
D1066,9,7/28/2021,PGS5WOSUPB,95,"2238"
D1066,9,07/29/2021,PGT2Y3KWLW,100,"2138"
D1066,9,07/29/2021,PGT4Y3M5WI,100,"2038"
D1066,9,07/29/2021,PGT4Y3TJM2,84,"1954"
D1066,9,08/01/2021,PH143DVVIS,1700,254
D1066,9,08/02/2021,PH233JUZUV,14,240
D1066,9,08/02/2021,PH274VCYZB,100,140
D1066,9,08/02/2021,PH234VFCQZ,100,40
D1066,9,08/02/2021,PH294VGWI3,40,0
D1066,10,08/08/2021,PH84DNVHJG,20,"5180"
D1066,10,08/20/2021,PHK1UODYIH,100,"5080"
D1066,10,08/20/2021,PHK1UOHZMX,100,"4980"
D1066,10,08/20/2021,PHK5UOK45H,10,"4970"
D1066,10,08/20/2021,PHK5UOOAT3,100,"4870"
D1066,10,08/22/2021,PHM8XHG59S,100,"4770"
D1066,10,08/22/2021,PHM9XHI8YT,100,"4670"
D1066,10,08/22/2021,PHM8XHK0U8,100,"4570"
D1066,10,08/22/2021,PHM3XHL70F,10,"4560"
D1066,10,08/23/2021,PHN6YXJGEU,100,"4460"
D1066,10,08/23/2021,PHN9YXKMXH,100,"4360"
D1066,10,08/23/2021,PHN2YXO4UC,100,"4260"
D1066,10,08/23/2021,PHN5YXP5F3,8,"4252"
D1066,10,08/26/2021,PHQ3479B0R,100,"4152"
D1066,10,08/26/2021,PHQ947BPB1,100,"4052"
D1066,10,08/26/2021,PHQ547DSX5,100,"3952"
D1066,10,08/26/2021,PHQ333BRR7,100,"3852"
D1066,10,08/26/2021,PHQ833EC7O,100,"3752"
D1066,10,08/26/2021,PHQ033GDIW,100,"3652"
D1066,10,08/26/2021,PHQ333NYFF,96,"3556"
D1066,10,8/29/2021,PHT78S6JX3,980,"2576"
D1066,10,8/30/2021,PHU88ZUA00,100,"2476"
D1066,10,8/30/2021,PHU18ZWFJR,100,"2376"
D1066,10,8/30/2021,PHU88ZYSO4,100,"2276"
D1066,10,8/30/2021,PHU99013D3,100,"2176"
D1066,10,8/30/2021,PHU390391V,100,"2076"
D1066,10,8/30/2021,PHU5A7J6WV,100,"1976"
D1066,10,8/30/2021,PHU7A7M3WD,100,"1876"
D1066,10,8/30/2021,PHU7A7NLFL,100,"1776"
D1066,10,8/30/2021,PHU8A7PJ9S,100,"1676"
D1066,10,8/30/2021,PHU7A7TN71,40,"1636"
D1066,10,8/31/2021,PHV4BNUZ7S,100,"1536"
D1066,10,8/31/2021,PHV4BNXQ2O,100,"1436"
D1066,10,8/31/2021,PHV0BNZW2M,100,"1336"
D1066,10,09/01/2021,PI16CUI510,1331,5
D1066,10,09/02/2021,PI25DOCEGB,5,0
D1066,11,09/26/2021,PIQ0FMV87C,100,"5100"
D1066,11,09/26/2021,PIQ5FN1YJX,100,"5000"
D1066,11,09/26/2021,PIQ7FN8HLX,80,"4920"
D1066,11,09/27/2021,PIR3H6UR4J,100,"4820"
D1066,11,09/27/2021,PIR0H6WAYQ,54,"4766"
D1066,11,10/03/2021,PJ39QVHRN5,100,"4666"
D1066,11,10/03/2021,PJ34QVIZO0,100,"4566"
D1066,11,10/03/2021,PJ31QVK7CZ,100,"4466"
D1066,11,10/03/2021,PJ36QVLETK,100,"4366"
D1066,11,10/03/2021,PJ32QVQVCQ,100,"4266"
D1066,11,10/03/2021,PJ30QVU9T0,70,"4196"
D1066,11,10/04/2021,PJ43SHAGPR,100,"4096"
D1066,11,10/04/2021,PJ48SHBUZW,100,"3996"
D1066,11,10/04/2021,PJ44SHDLXM,100,"3896"
D1066,11,10/04/2021,PJ43SHF40T,100,"3796"
D1066,11,10/04/2021,PJ41SHGSTN,100,"3696"
D1066,11,10/04/2021,PJ46SHSGCK,100,"3596"
D1066,11,10/05/2021,PJ57U27YSB,100,"3496"
D1066,11,10/05/2021,PJ53U29FON,100,"3396"
D1066,11,10/05/2021,PJ51U2CTTJ,10,"3386"
D1066,11,10/6/2021,PJ67VQD72X,100,"3286"
D1066,11,10/6/2021,PJ65VQDHPX,54,"3232"
D1066,11,10/7/2021,PJ73XBPDZB,100,"3132"
D1066,11,10/7/2021,PJ74XBQO6E,100,"3032"
D1066,11,10/7/2021,PJ71XBRWL7,20,"3012"
D1066,11,10/11/2021,PJB83GQOGI,200,"2812"
D1066,11,10/11/2021,PJB43GSZLG,400,"2412"
D1066,11,10/11/2021,PJB13GVPDD,400,"2012"
D1066,11,10/11/2021,PJB13HHAVX,100,"1912"
D1066,11,10/11/2021,PJB63HIZLW,40,"1872"
D1066,11,10/11/2021,PJB04GUUGY,400,"1472"
D1066,11,10/11/2021,PJB14GYZIT,400,"1072"
D1066,11,10/11/2021,PJB24H3O9U,400,672
D1066,11,10/11/2021,PJB74H5TJ3,100,572
D1066,11,10/11/2021,PJB84I0JCU,72,500
D1066,11,10/11/2021,PJB04IQWFA,400,100
D1066,11,10/11/2021,PJB74IVOH3,73,27
D1066,11,10/11/2021,PJB64KXDWE,20,7
D1066,11,10/11/2021,PJB94LAOI7,7,0
D1066,12,10/12/2021,PJC560HNN1,500,"4700"
D1066,12,10/12/2021,PJC660NTIU,100,"4600"
D1066,12,10/12/2021,PJC460SGIQ,100,"4500"
D1066,12,10/12/2021,PJC560YF6T,100,"4400"
D1066,12,10/12/2021,PJC56133GV,100,"4300"
D1066,12,10/12/2021,PJC661794Y,100,"4200"
D1066,12,10/31/2021,PJV6YV9I9U,100,"4100"
D1066,12,10/31/2021,PJV9YVBOBN,100,"4000"
D1066,12,10/31/2021,PJV0YVE9FC,100,"3900"
D1066,12,10/31/2021,PJV4YVFZ3Q,100,"3800"
D1066,12,10/31/2021,PJV8YVICHG,100,"3700"
D1066,12,10/31/2021,PJV8YWBPYW,100,"3600"
D1066,12,10/31/2021,PJV5ZWNG8B,100,"3500"
D1066,12,10/31/2021,PJV2ZWVF4K,100,"3400"
D1066,12,10/31/2021,PJV6ZWZ4U0,100,"3300"
D1066,12,10/31/2021,PJV4ZX2W1G,70,"3230"
D1066,12,10/31/2021,PJV313PGTJ,1200,"2030"
D1066,12,10/31/2021,PJV5144WOZ,100,"1930"
D1066,12,11/03/2021,PK3765O29V,97,"1833"
D1066,12,11/08/2021,PK80CYLT4U,100,"1733"
D1066,12,11/08/2021,PK85CYMPBL,100,"1633"
D1066,12,11/08/2021,PK86CYOW9A,100,"1533"
D1066,12,11/7/2021,PK78CS0TMM,100,"1433"
D1066,12,11/7/2021,PK71CRRSFR,1333,100
D1066,12,11/7/2021,PK75CS3EDZ,100,0
D1066,12,11/8/2021,PK82DJP11I,100,100
D1066,13,11/11/2021,PKB4J7ICLW,100,"5100"
D1066,13,12/07/2021,PL70QQBDL8,5100,0
D1066,14,01/06/2022,QA648LHJL8,5200,0
D1066,15,02/04/2022,QB47M88DDD,5200,0
D1066,16,03/02/2022,QC24Z59MQC,6350,0
D1066,17,03/28/2022,QCS6FZUSUI,6500,0
D1066,18,04/25/2022,QDP2YGY1KW,5200,"1300"
D1066,18,04/26/2022,QDQ2Z39PUK,1300,0
D1066,19,05/23/2022,QEN8HMC84K,6500,0
D1066,20,06/17/2022,QFH2VKXAA8,6300,50
D1066,20,06/17/2022,QFH5VYMP2V,50,0
D1066,21,07/14/2022,QGE2FZYYHM,6500,0
D1066,22,08/12/2022,QHC73LTCTD,500,"6300"
D1066,22,08/13/2022,QHD051NCYU,100,"6200"
D1066,22,08/13/2022,QHD051W9H6,100,"6100"
D1066,22,10/06/2022,QJ61DH4XGD,100,"6000"
D1066,22,10/06/2022,QJ63DH0PHB,100,"5900"
D1067,1,11/05/2020,OK577QMXEP,1250,"4850"
D1067,1,11/06/2020,OK66821HCQ,430,"4420"
D1067,1,11/13/2020,OKD5HE2E35,1625,"2795"
D1067,1,11/19/2020,OKJ3NNW8Z7,2795,0
D1067,2,12/07/2020,OL74AF3C4U,"1900","4600"
D1067,2,12/13/2020,OLD8HZ8ZPI,"2600","2000"
D1067,2,12/16/2020,OLG7MJWZ8V,1000,"1000"
D1067,2,12/17/2020,OLH5NEAMVZ,1000,0
D1067,3,01/04/2021,PA41A9T3JB,"1400","5100"
D1067,3,01/20/2021,PAK2SVDVDQ,"5100",0
D1067,4,02/01/2021,PB107VSLCG,600,"6200"
D1067,4,02/06/2021,PB64E60RA2,"1000","5200"
D1067,4,02/18/2021,PBI2SKW340,3200,"2000"
D1067,4,02/18/2021,PBI4SMN4RA,"2000",0
D1067,5,03/09/2021,PC93HC9CB7,"6050",0
D1067,6,04/06/2021,PD66J7JBSW,"6500",0
D1067,7,05/10/2021,PEA8SOS1T8,"4900","1900"
D1067,7,05/12/2021,PEC5UWOH89,"1900",0
D1067,8,06/06/2021,PF65TI4GE9,"5000","1500"
D1067,8,06/07/2021,PF72U8YVO0,"1500",0
D1067,9,07/06/2021,PG65ZD8879,"6800",0
D1067,10,08/02/2021,PH224A4946,"4000","3800"
D1067,10,08/02/2021,PH294LH0KR,"3800",0
D1067,11,09/01/2021,PI16CEQSL0,"8160",0
D1067,12,10/21/2021,PJL5IQRXBF,300,"9180"
D1067,12,10/26/2021,PJQ1QY0N99,470,"8710"
D1067,12,10/28/2021,PJS2U8RZJI,500,"8210"
D1067,12,11/01/2021,PK111NRVO5,460,"7750"
D1067,12,11/05/2021,PK509JRRHQ,1000,"6750"
D1067,12,11/08/2021,PK81D1J5WV,500,"6250"
D1067,12,11/10/2021,PKA8HH64AY,500,"5750"
D1067,12,11/17/2021,PKH7RV8A3D,470,"5280"
D1067,12,11/17/2021,PKH5RY4FAP,570,"4710"
D1067,12,11/22/2021,PKM3ZKFAVR,300,"4410"
D1067,12,11/29/2021,PKT8CKA2A4,300,"4110"
D1067,12,12/06/2021,PL64QB0RMI,1200,"2910"
D1067,12,12/10/2021,PLA4WQI8AU,400,"2510"
D1067,12,12/22/2021,PLM7HKCZW1,500,"2010"
D1067,12,12/24/2021,PLO5LZ7YFD,500,"1510"
D1067,12,12/31/2021,PLV3WR5HNT,350,"1160"
D1067,12,01/08/2022,QA81B6JHHL,300,860
D1067,12,01/11/2022,QAB2FV3TPY,300,560
D1067,12,01/25/2022,QAP94NWIYN,560,0
D1067,13,12/07/2022,QL72KO7VLE,"1200","3840"
D1067,13,12/12/2022,QLC013K1YG,500,"3340"
D1067,13,12/13/2022,QLD33TTYE9,500,"2840"
D1067,13,12/17/2022,QLH7DDM1AD,500,"2340"
D1067,13,12/21/2022,QLL9N7CG3D,"1000","1340"
D1067,13,12/22/2022,QLM9PW597B,"1000",340
D1067,13,12/23/2022,QLN4TKGCXY,500,160
D1067,14,12/23/2022,QLN4TKGCXY_D2,160,"4760"
D1067,14,12/27/2022,QLR940YECZ,500,"4260"
D1067,14,01/06/2023,RA60S64UEI,"1000","3260"
D1067,14,01/13/2023,RAD6AAFHKE,"3270",10
D1067,15,02/09/2023,RB95926YSL,4900,300
D1067,15,02/09/2023,RB909TWQKE,300,0
D1067,16,03/09/2023,RC91ENQQX9,4800,400
D1067,16,03/09/2023,RC92F6MMNO,400,0
D1067,17,04/07/2023,RD73N6G46D,5200,0
D1067,18,05/07/2023,RE73ZCX43V,2500,"4300"
D1067,18,05/09/2023,RE944DBXNA,4300,0
D1067,19,06/12/2023,RFC6VEKM5E,500,"6300"
D1067,19,06/12/2023,RFC0WA1G6U,4000,"2300"
D1067,19,06/13/2023,RFD5XT3OYR,1800,500
D1067,19,06/13/2023,RFD3Y0F01N,500,0
D1067,20,07/13/2023,RGD9FO4015,4000,"2800"
D1067,20,07/13/2023,RGD2G2TT38,2900,100
D1067,21,08/08/2023,RH88KZUXBE,6500,0
D1068,1,11/27/2020,OKR3XF1OF5,3000,"10600"
D1068,1,11/30/2020,OKU71HFE4L,1900,"8700"
D1068,1,12/01/2020,OL132V7B7P,8700,0
D1068,2,01/04/2021,PA47A6RFL3,2500,"12100"
D1068,2,01/05/2021,PA56BAY5WE,1500,"10600"
D1068,2,01/07/2021,PA69DK5Z0B,10100,500
D1068,2,01/07/2021,PA79E9HU3V,500,0
D1068,3,01/09/2021,PA92GGMET0,500,"13100"
D1068,3,01/10/2021,PAA1HVA0BH,300,"12800"
D1068,3,01/13/2021,PAD6LBPQ2Q,300,"12500"
D1068,3,01/16/2021,PAG5O3VXLD,500,"12000"
D1068,3,01/18/2021,PAI7QHTD07,500,"11500"
D1068,3,01/19/2021,PAJ0S4VC8W,400,"11100"
D1068,3,01/21/2021,PAL9U23GWV,400,"10700"
D1068,3,01/21/2021,PAL8U94B5Y,400,"10300"
D1068,3,01/22/2021,PAM9VISK1B,100,"10200"
D1068,3,01/22/2021,PAM0VIVMTE,100,"10100"
D1068,3,01/23/2021,PAN6W5PMU2,100,"10000"
D1068,3,01/23/2021,PAN6W5S3WG,100,"9900"
D1068,3,01/26/2021,PAQ4ZJL3ZQ,900,"9000"
D1068,3,01/27/2021,PAR52C241J,780,"8220"
D1068,3,01/28/2021,PAS93IETPF,100,"8120"
D1068,3,01/28/2021,PAS63IHWWY,100,"8020"
D1068,3,02/08/2021,PB88GO7KMY,8020,0
D1068,4,03/08/2021,PC88GSFBIK,"8000","7800"
D1068,4,03/16/2021,PCG7QNX9SD,"1000","6800"
D1068,4,03/18/2021,PCI3T2OL89,1000,"5800"
D1068,4,03/22/2021,PCM0YBS6SI,"1200","4600"
D1068,4,03/25/2021,PCP42ZG3L2,1000,"3600"
D1068,4,03/30/2021,PCU99K8V01,1000,"2600"
D1068,4,03/30/2021,PENALTIES W/OFF,2600,0
D1069,1,11/06/2020,OK638QKM2Z,6200,"5000"
D1069,1,11/07/2020,OK779P6EZ3,5000,0
D1069,2,01/12/2021,PAC6JLGYNS,"13000",0
D1069,3,02/10/2021,PBA5IVLUJV,"13000",0
D1069,4,03/11/2021,PCB7K12YI7,"13000",0
D1069,5,04/08/2021,PD82L1NOCQ,"19500",0
D1069,6,05/07/2021,PE77NXHSXN,"19500",0
D1069,7,06/05/2021,PF52R5TNCG,"19500",0
D1069,8,07/03/2021,PG37UZ5HGT,"19350",0
D1069,9,07/31/2021,PGV710JZ2F,"21930",0
D1069,10,08/26/2021,PHQ83CI0L4,"21590",0
D1069,11,09/24/2021,PIO4C72HC4,"26000",0
D1069,12,10/23/2021,PJN4M1L6XQ,"26000",0
D1069,13,11/20/2021,PKK5WS0NJ3,"25800",0
D1069,14,12/18/2021,PLI7AXO9DX,"25800",0
D1069,15,01/17/2022,QAH3PTSVWX,"27200",0
D1069,16,02/16/2022,QBG99FSZ07,"7200","24400"
D1069,16,02/24/2022,QBO2O3PHDU,2000,"22400"
D1069,16,03/15/2022,QCF0P222WM,1000,"21400"
D1069,16,03/19/2022,QCJ0WPJ2M0,1000,"20400"
D1069,16,03/27/2022,QCR8DKH3RI,1000,"19400"
D1069,16,03/30/2022,QCU7IIBKBT,1000,"18400"
D1069,16,04/11/2022,QDB26ZXUVW,1000,"17400"
D1069,16,04/26/2022,QDQ5ZSF0MP,1000,"16400"
D1069,16,05/25/2022,QEP5KGZNHJ,1000,"15400"
D1069,16,06/19/2022,QFJ914PSZL,1000,"14400"
D1069,16,07/07/2022,QG721SBM6Y,1000,"13400"
D1069,16,07/20/2022,QGK3RCV0MB,1000,"12400"
D1069,16,08/08/2022,QH84UU3ZU6,1000,"11400"
D1069,16,09/17/2022,QIH14W42GN,1000,"10400"
D1069,16,10/26/2022,QJP9LBPTLR,1000,"9400"
D1069,16,11/09/2022,QK95LS4QQF,1000,"8400"
D1069,16,11/12/2022,QKC0RJFHUM,1000,"7400"
D1069,16,11/14/2022,QKE7VVJGTB,1000,"6400"
D1069,16,11/14/2022,QKE3WF8NRN,2000,"4400"
D1069,16,11/14/2022,PENALTIES W/OFF,4400,0
D1070,1,11/06/2020,OK6593EFSL,1625,"5175"
D1070,1,11/15/2020,OKF8JO2T6S,1600,"3575"
D1070,1,11/22/2020,OKM0RTCHB4,500,"3075"
D1070,1,11/23/2020,OKN8SZBPYA,1000,"2075"
D1070,1,11/27/2020,OKR5XWWYF9,750,"1325"
D1070,1,11/29/2020,OKT51888R3,1325,0
D1070,2,12/09/2020,OL99D039XV,"1100","5400"
D1070,2,12/14/2020,OLE5J1HP4T,525,"4875"
D1070,2,12/20/2020,OLK2RTPG6E,1775,"3100"
D1070,2,12/27/2020,OLR91MPEJN,1700,"1400"
D1070,2,12/28/2020,OLS42T0KHG,1400,0
D1070,3,01/12/2021,PAC1JFS7HP,"2000","4800"
D1070,3,01/24/2021,PAO0Y7301U,"2000","2800"
D1070,3,01/31/2021,PAV07DJYQQ,"2800",0
D1070,4,03/04/2021,PC41B0PUXH,"2000","4500"
D1070,4,03/07/2021,PC72FWGL44,"1150","3350"
D1070,4,03/11/2021,PCB6JU0W3M,"1100","2250"
D1070,4,3/12/2021,PCB7L2WMCX,2250,0
D1070,5,04/14/2021,PDE8SXJDUA,"5000","4100"
D1070,5,04/16/2021,PDG8WFWT82,"4100",0
D1070,6,05/14/2021,PEE0YC6NOG,"3000","6100"
D1070,6,05/16/2021,PEG41VAGW4,"4000","2100"
D1070,6,05/17/2021,PEH835L1YE,"2100",0
D1070,7,06/14/2021,PFE25PT7XS,"13000",0
D1070,8,07/15/2021,PGF4DMVN7I,"5000","8600"
D1070,8,07/16/2021,PGG5EZ43JP,"8600",0
D1070,9,08/24/2021,PHO6Z1TRUY,"1000","14800"
D1070,9,08/26/2021,PHQ62YO3Y4,500,"14300"
D1070,9,08/30/2021,PHU18X8UYX,500,"13800"
D1070,9,9/23/2021,PIN09VANUM,500,"13300"
D1070,9,10/01/2021,PJ14MEKU58,100,"13200"
D1070,9,10/01/2021,PJ16MEQ3RY,100,"13100"
D1070,9,10/08/2021,PJ80Z0R3VO,100,"13000"
D1070,9,10/21/2021,PJL2IR2YK6,300,"12700"
D1070,9,10/22/2021,PJM5LPJK7N,200,"12500"
D1070,9,10/27/2021,PJR7S4X093,100,"12400"
D1070,9,11/01/2021,PK151A8T25,200,"12200"
D1070,9,11/07/2021,PK79CRZO7T,100,"12100"
D1070,9,11/10/2021,PKA1G96ICZ,100,"12000"
D1070,9,12/09/2021,PL97U7LNLF,300,"11700"
D1070,9,01/26/2022,QAQ874A5LQ,200,"11500"
D1071,1,12/05/2020,OL548MU1Y4,"25000",0
D1071,2,12/23/2020,OLN0V7S70W,"23800",0
D1071,3,01/28/2021,PAS03EQB06,"29250",0
D1071,4,02/20/2021,PBK6VSTY04,"36000",0
D1071,5,04/17/2021,PDH7X5DB8H,"18900",0
D1071,6,04/30/2021,PDU2EX3HVE,"11200",0
D1071,7,07/02/2021,PG22TNDTXK,"36900",0
D1071,8,07/08/2021,PG833VK7JN,"33600",0
D1071,9,09/08/2021,PI80NJXSMK,"36600",0
D1071,10,05/05/2022,QE53I5WLV1,"18750",0
D1071,11,07/07/2022,QG702RSKHQ,"58500",0
D1071,12,10/05/2022,QJ55A0E4ZR,"22500",0
D1071,13,10/05/2022,QJ55A0E4ZR_D2,"22500",0
D1071,14,03/03/2023,RC36VIZBQK,"22400",0
D1071,15,03/31/2023,RC36VIZBQK_D2,"22400",0
D1071,16,04/24/2023,RDO8WCKBNA,"65400",900
D1071,17,04/24/2023,RDO8WCKBNA_D2,900,"46300"
D1071,17,06/01/2023,RF14YVC3T0,46300,0
D1071,18,08/05/2023,RH51CYJKBF,"30000",0
D1071,19,08/21/2023,RHL5PCO3KL,"29250",0
D1072,1,12/11/2020,OLB4FTE2JA,"26000",0
D1072,2,01/09/2021,PA92G8N26M,"26000",0
D1072,3,02/06/2021,PB60DZ8OJQ,"32500",0
D1072,4,02/23/2021,PBN2Z0W79Y,"29500",0
D1072,5,03/26/2021,PCQ346HXT9,"40800",0
D1073,1,12/07/2020,OL74ALW7NG,"12400",0
D1073,2,01/04/2021,PA49A3A8V7,"8500","4500"
D1073,2,01/05/2021,PA56BLISW6,3500,"1000"
D1073,2,01/05/2021,PA54BLV6QO,1000,0
D1073,3,01/06/2021,PA62DIONKY,300,"11900"
D1073,3,01/07/2021,PA79EQIMR7,300,"11600"
D1073,3,01/08/2021,PA85FWSYLP,300,"11300"
D1073,3,01/09/2021,PA99GXPWZX,300,"11000"
D1073,3,01/14/2021,PAF3MU64VP,300,"10700"
D1073,3,01/26/2021,PAQ711MNNR,"10700",0
D1073,4,02/09/2021,PB94HG8ECW,880,"14720"
D1073,4,02/15/2021,PBF7OTFA8V,300,"14420"
D1073,4,02/17/2021,PBH9RZYJM7,300,"14120"
D1073,4,02/19/2021,PBJ2UOYAPY,300,"13820"
D1073,4,02/24/2021,PBO4ZJJEPW,"5000","8820"
D1073,4,02/24/2021,PBO5ZJMH43,200,"8620"
D1073,4,02/24/2021,PBO9ZJNPTN,100,"8520"
D1073,4,02/24/2021,PBO7ZOH3XF,7900,620
D1073,4,02/24/2021,PBO8ZQBKIS,520,100
D1073,4,02/24/2021,PBO3ZRO1UV,100,0
D1073,5,03/23/2021,PCN613E9UO,"3900","11600"
D1073,5,03/23/2021,PCN717QTY5,380,"11220"
D1073,5,03/23/2021,PCN818CMIW,380,"10840"
D1073,5,03/24/2021,PCO41LE7JM,1840,"9000"
D1073,5,03/24/2021,PCO51LM0OH,"9000",0
D1073,6,04/21/2021,PDL93M41DB,"11000","8500"
D1073,6,04/21/2021,PDL63MK0KQ,350,"8150"
D1073,6,04/22/2021,PDM4421I5E,8150,0
D1073,7,05/17/2021,PEH12JGVPD,"19200",0
D1073,8,06/12/2021,PFC8234DYW,"19200",0
D1073,9,07/07/2021,PG742PANQS,"3500","15700"
D1073,9,07/08/2021,PG8535IWC5,15700,0
D1073,10,08/06/2021,PH649PAE0Q,"19500",0
D1073,11,08/31/2021,PHV1AH0NJR,"19050",0
D1073,12,09/21/2021,PIL7774ILP,"20840",0
D1073,13,10/15/2021,PJF9AJ6I65,"9000","13100"
D1073,13,10/19/2021,PJJ4G0G76E,12400,700
D1073,13,10/19/2021,PJJ1G1H0H5,700,0
D1073,14,11/15/2021,PKF4OOE048,"4800","17300"
D1073,14,11/16/2021,PKG8Q0WFH8,17300,0
D1073,15,12/15/2021,PLF25Q8CRO,"4400","17700"
D1073,15,12/15/2021,PLF25UEGMK,5500,"12200"
D1073,15,12/15/2021,PLF467I4Y0,12200,0
D1073,16,01/11/2022,QAB9GN16JJ,"21930",0
D1073,17,02/04/2022,QB48MY2K82,"4900","20700"
D1073,17,02/04/2022,QB42MYF0EC,14900,"5800"
D1073,17,02/05/2022,QB54NU8NCS,5800,0
D1073,18,03/04/2022,QC405AFFSM,"3200","22800"
D1073,18,03/05/2022,QC555VLCIN,23000,200
D1073,19,04/02/2022,QD28OPVXZA,"26000",0
D1073,20,04/29/2022,QDT370O2BJ,"26000",0
D1073,21,05/25/2022,QEP0KI19MK,"3000","23000"
D1073,21,06/27/2022,QER0OHDM86,23000,0
D1073,22,06/25/2022,QFP1CLQQ6Z,"4000","27600"
D1073,22,06/27/2022,QFR7GF47L9,3000,"24600"
D1073,22,06/28/2022,QFS2HY87Y2,1000,"23600"
D1073,22,06/30/2022,QFU4LLXXGK,1000,"22600"
D1073,22,07/01/2022,QG17OCTDDB,1000,"21600"
D1073,22,07/05/2022,QG55WUBL5B,1000,"20600"
D1073,22,07/07/2022,QG761OMKE0,1000,"19600"
D1073,22,07/08/2022,QG8039UFGC,3000,"16600"
D1073,22,07/13/2022,QGD5EID5O1,300,"16300"
D1073,22,07/13/2022,QGD3F8RXV9,200,"16100"
D1073,22,07/15/2022,QGF0HUM1U0,300,"15800"
D1073,22,07/16/2022,QGG5JP7K6D,300,"15500"
D1073,22,07/18/2022,QGI0NN7RGE,450,"15050"
D1073,22,07/19/2022,QGJ5PE9B8D,300,"14750"
D1073,22,07/20/2022,QGK5RNBVYJ,300,"14450"
D1073,22,07/21/2022,QGL7TY0F95,300,"14150"
D1073,22,07/22/2022,QGM2VJFUNO,400,"13750"
D1073,22,07/25/2022,QGP12CHZUZ,300,"13450"
D1073,22,07/27/2022,QGR673QVR2,400,"13050"
D1073,22,07/29/2022,QGT0AA9L1O,500,"12550"
D1073,22,08/08/2022,QH84VKUW7E,1000,"11550"
D1073,22,08/12/2022,QHC93YLYHF,400,"11150"
D1073,22,08/15/2022,QHF29LFGF6,500,"10650"
D1073,22,08/18/2022,QHI6EDYKH8,500,"10150"
D1073,22,08/22/2022,QHM2MPBLG2,300,"9850"
D1073,22,08/26/2022,QHQ0TKCZNG,300,"9550"
D1073,22,08/26/2022,QHQ8U124Y2,200,"9350"
D1073,22,08/29/2022,QHT7ZWL4VJ,400,"8950"
D1073,22,08/31/2022,QHV53WZC53,400,"8550"
D1073,22,09/01/2022,QI156GHMM7,300,"8250"
D1073,22,09/02/2022,QI298NR5V5,300,"7950"
D1073,22,09/05/2022,QI53EOXC91,400,"7550"
D1073,22,09/06/2022,QI60GYB6E4,500,"7050"
D1073,22,09/09/2022,QI99OBO7WV,400,"6650"
D1073,22,09/15/2022,QIF314EDN3,300,"6350"
D1073,22,01/10/2023,RAA33QFEOL,400,"5950"
D1073,22,01/13/2023,RAD3A8BADV,450,"5500"
D1073,22,01/13/2023,PENALTIES W/OFF,5500,0
D1074,1,12/21/2020,OLL3SJNQJ3,500,"31100"
D1074,1,12/23/2020,0LN6US2DOO,"1400","29700"
D1074,1,12/28/2020,OLS51TZH1R,3500,"26200"
D1074,1,1/10/2021,PAA8I2NNWK,1000,"25200"
D1074,1,1/12/2021,PAC7JWNEXL,"1000","24200"
D1074,1,01/18/2021,PAI4QVI9R8,900,"23300"
D1074,1,01/26/2021,PAQ4ZHAWGY,900,"22400"
D1074,1,01/27/2021,PAR81V4A5M,600,"21800"
D1074,1,02/01/2021,PB1789SZKH,"20000","1800"
D1074,1,02/02/2021,PB228VJWP2,"1800",0
D1075,1,11/23/2020,OKN5SLT6SX,700,"5800"
D1075,1,11/25/2020,OKP0UT952U,425,"5375"
D1075,1,11/28/2020,OKS0Z5M54Y,500,"4875"
D1075,1,12/4/2020,OL416PXWKF,1625,"3250"
D1075,1,12/4/2020,OL43744AW1,625,"2625"
D1075,1,12/09/2020,OL90D0LY5C,1625,"1000"
D1075,1,12/14/2020,OLE6JAJQXE,"1000",0
D1075,2,12/20/2020,OLK1QVD0A1,1625,"4875"
D1075,2,12/28/2020,OLS31OZ7S3,1625,"3250"
D1075,2,01/02/2021,PA2386EDA7,"3250",0
D1075,3,01/09/2021,PA96G2PEAO,1625,"4875"
D1075,3,01/10/2021,PAA7HC2GFP,210,"4665"
D1075,3,01/15/2021,PAF9NGZ4C9,"1800","2865"
D1075,3,01/18/2021,PAI5R1R4UL,225,"2640"
D1075,3,01/21/2021,PAL0TT8EBO,210,"2430"
D1075,3,01/21/2021,PAL2UCTYAC,230,"2200"
D1075,3,01/23/2021,PAN1WRK72D,1000,"1200"
D1075,3,01/25/2021,PAP5YUDS6J,"1200",0
D1075,4,01/26/2021,PAQ2114JRU,420,"6080"
D1075,4,02/01/2021,PB128NR3F6,1210,"4870"
D1075,4,02/04/2021,PB46BZW2OC,"2650","2220"
D1075,4,02/11/2021,PBB3KHAW31,"2200",20
D1075,4,02/12/2021,PBC9LMPDSZ,20,0
D1075,5,02/18/2021,PBI2SSZAEW,"3250","9750"
D1075,5,03/01/2021,PC167XXVHU,"3250","6500"
D1075,5,03/09/2021,PC93HAD8K5,"3250","3250"
D1075,5,03/10/2021,PCA9JKGFRH,900,"2350"
D1075,5,03/12/2021,PCC9LK4PGX,"2350",0
D1075,6,03/14/2021,PCE6O2W4UO,"3250","9750"
D1075,6,03/19/2021,PCJ6UZENZE,"3250","6500"
D1075,6,04/02/2021,PD27D8PDRB,"3250","3250"
D1075,6,04/07/2021,PD76JORGMS,"3250",0
D1075,7,04/16/2021,PDG2VPP9VQ,"6500","6500"
D1075,7,04/26/2021,PDQ196V39N,"6500",0
D1075,8,05/03/2021,PE32J7K5F6,"1625","4875"
D1075,8,05/10/2021,PEA9SL884F,"1625","3250"
D1075,8,05/17/2021,PEH62R2XFW,"1625","1625"
D1075,8,05/19/2021,PEJ250VSYE,"1625",0
D1075,9,05/24/2021,PEO3AYJ4Z1,"1250","11750"
D1075,9,05/26/2021,PEQ1DTQBSJ,"2000","9750"
D1075,9,06/05/2021,PF55RDA997,"3225","6525"
D1075,9,06/09/2021,PF91XDRBW5,"3225","3300"
D1075,9,06/10/2021,PFA4YIYEOK,"3300",0
D1075,10,06/19/2021,PFJ8BG98MM,500,"12500"
D1075,10,06/19/2021,PFJ0BGZ9N6,450,"12050"
D1075,10,06/19/2021,PFJ6BH5HEM,50,"12000"
D1075,10,07/01/2021,PG12S154SQ,"5150","6850"
D1075,10,06/21/2021,PFL5DYWJP7,450,"6400"
D1075,10,06/21/2021,PFL7EP9HGL,6000,400
D1075,10,06/29/2021,PFT1P5J089,400,0
D1075,11,07/09/2021,PG964XET6U,"6000","7000"
D1075,11,07/13/2021,PGD1AIN1NV,500,"6500"
D1075,11,07/29/2021,PGT7XA9IH5,"1500","5000"
D1075,11,07/29/2021,PGT6X4OQGS,"4700",300
D1075,11,07/29/2021,PGT3XBN72H,300,0
D1075,12,08/11/2021,PHB3HZIR8X,"3500","9500"
D1075,12,08/11/2021,PHB8HZLIGG,250,"9250"
D1075,12,08/11/2021,PHB0HZNU50,100,"9150"
D1075,12,08/12/2021,PHC5ICP95B,300,"8850"
D1075,12,08/26/2021,PHQ53UUY6R,"9000",150
D1075,13,08/31/2021,PHV0B7LIDK,"4000","9000"
D1075,13,09/06/2021,PI67K4Q7QT,"2500","6500"
D1075,13,09/18/2021,PII53H7AVR,"6500",0
D1076,1,11/28/2020,OKS2YTNV0A,4000,"7200"
D1076,1,12/02/2020,OL2942MGPZ,7290,90
D1076,2,12/15/2020,OLF5KVHPJ3,3600,"10000"
D1076,2,12/17/2020,OLH9MZUGI3,3300,"6700"
D1076,2,12/30/2020,OLU94O4DAJ,2900,"3800"
D1076,2,12/31/2020,OLV05VT57S,"3800",0
D1076,3,01/10/2021,PAA4HEZU76,"7000","4300"
D1076,3,01/11/2021,PAB5IIYMFX,"4300",0
D1076,4,01/20/2021,PAK6SSI9YE,"2400","10600"
D1076,4,01/29/2021,PAT14EJJ9B,"2900","7700"
D1076,4,02/08/2021,PB80GFOZCS,"7700",0
D1076,5,02/17/2021,PBH4RIV0T4,"3200","9800"
D1076,5,03/08/2021,PC89GAX7YT,"9900",100
D1076,6,03/28/2021,PCS96Z28LH,"3500","12820"
D1076,6,04/06/2021,PD67IJ1SMT,"7800","5020"
D1076,6,04/08/2021,PD86KUVD52,"5000",20
D1076,6,4/8/2021,PD86L7Z15C,50,30
D1076,7,05/07/2021,PE70O5C0ZY,"1800","14520"
D1076,7,05/08/2021,PE83PCCMLB,"14250",270
D1076,7,05/08/2021,PE86PCKFCM,270,0
D1076,8,06/05/2021,PF55RDFGRH,"15600",0
D1076,9,07/02/2021,PG24TKMJRM,"19350",0
D1076,10,07/30/2021,PGU6YE6642,"19615",115
D1076,11,08/27/2021,PHR74MBT51,"19500",0
D1076,12,09/24/2021,PIO2BWK6LW,"26000",0
D1076,13,10/21/2021,PJL1J148SB,"26000",0
D1076,14,11/17/2021,PKH6RFEWVC,"26000",0
D1076,15,12/15/2021,PLF85S10VS,"26000",0
D1076,16,01/12/2022,QAC1HUXRJP,"26000",0
D1076,17,02/09/2022,QB95VASHB3,"26000",0
D1076,18,03/07/2022,QC77A7AK5F,"25700",0
D1076,19,04/04/2022,QD40SV6UKA,"39000",0
D1076,20,04/28/2022,QDS33VW0QL,"38000",0
D1076,21,05/25/2022,QEP9KKL2HT,"39000",0
D1076,22,06/23/2022,QFN87V29FO,"39000",0
D1076,23,07/22/2022,QGM5W5VBAV,"11000","29200"
D1076,23,07/25/2022,QGP328SNF7,"5000","24200"
D1076,23,07/25/2022,QGP62WBISK,5000,"19200"
D1076,23,07/27/2022,QGR46BUZBG,4000,"15200"
D1076,23,07/29/2022,QGT1ACXCI1,7500,"7700"
D1076,23,08/01/2022,QH11GBXLFZ,4500,"3200"
D1076,23,08/01/2022,QH10GGBDUO,1800,"1400"
D1076,23,08/02/2022,QH21I8K1QX,1200,200
D1076,23,08/03/2022,QH35K9UEAR,200,0
D1077,1,11/27/2020,OKR5XW08SJ,100,"6400"
D1077,1,11/27/2020,OKR3XW4DM9,100,"6300"
D1077,1,11/27/2020,OKR9XW6YCH,90,"6210"
D1077,1,11/29/2020,OKT819J9J6,100,"6110"
D1077,1,11/29/2020,OKT119KD4T,100,"6010"
D1077,1,11/29/2020,OKT319LNF9,100,"5910"
D1077,1,12/01/2020,OL1537IU2P,1035,"4875"
D1077,1,12/03/2020,OL366CWNZS,100,"4775"
D1077,1,12/03/2020,OL366CYKPE,100,"4675"
D1077,1,12/10/2020,OLA0F6NHDQ,200,"4475"
D1077,1,12/11/2020,OLB1GL1PGH,1000,"3475"
D1077,1,12/23/2020,OLN1UKBGP9,3475,0
D1077,2,01/12/2021,PAC8JGD1UE,"1100","5000"
D1077,2,01/20/2021,PAK5SS98F7,5000,0
D1077,3,02/15/2021,PBF7OUGIMR,"5000","1500"
D1077,3,02/17/2021,PBH5SAMTD3,"1500",0
D1077,4,02/28/2021,PBS46PZGWA,100,"6100"
D1077,4,02/28/2021,PBS46Q0VP6,100,"6000"
D1077,4,03/01/2021,PC197QAA33,100,"5900"
D1077,4,03/01/2021,PC127QD78G,100,"5800"
D1077,4,03/02/2021,PC249BE7XA,100,"5700"
D1077,4,03/03/2021,PC34AOAB36,100,"5600"
D1077,4,03/03/2021,PC30AOCQTY,100,"5500"
D1077,4,03/07/2021,PC71FVLYDR,100,"5400"
D1077,4,03/12/2021,PCC9LE0C2Z,"5350",50
D1077,4,03/12/2021,PCC9LELS2N,50,0
D1077,5,04/06/2021,PD61IEVT2H,"6300",0
D1077,6,04/07/2021,PD76KOURS2,100,"7160"
D1077,6,04/07/2021,PD76KOXRR0,30,"7130"
D1077,6,04/26/2021,PDQ0936HQE,7130,0
D1077,7,04/27/2021,PDR2BI04ZE,100,"7520"
D1077,7,04/27/2021,PDR9BI1TTL,100,"7420"
D1077,7,04/27/2021,PDR4BI47YU,90,"7330"
D1077,7,04/28/2021,PDS1CGJ56D,100,"7230"
D1077,7,04/28/2021,PDS1CQNPMN,100,"7130"
D1077,7,04/28/2021,PDS2CQRJ6M,55,"7075"
D1077,7,04/29/2021,PDT5E1XGM9,100,"6975"
D1077,7,04/29/2021,PDT7E22H39,65,"6910"
D1077,7,04/30/2021,PDU0FGCGB0,100,"6810"
D1077,7,04/30/2021,PDU2FGFL14,28,"6782"
D1077,7,05/01/2021,PE15G5K9CX,100,"6682"
D1077,7,05/01/2021,PE12G5NTKE,60,"6622"
D1077,7,05/01/2021,PE15GUSV0F,100,"6522"
D1077,7,05/01/2021,PE18GUVJAM,100,"6422"
D1077,7,05/01/2021,PE19GUYARH,60,"6362"
D1077,7,05/02/2021,PE24I6XU02,100,"6262"
D1077,7,05/02/2021,PE27I6YDP1,28,"6234"
D1077,7,05/03/2021,PE35JDJ6X5,100,"6134"
D1077,7,05/03/2021,PE33JDPPTR,100,"6034"
D1077,7,05/03/2021,PE30JF32OC,100,"5934"
D1077,7,05/06/2021,PE66NNKGL8,100,"5834"
D1077,7,05/06/2021,PE61NNM1I9,100,"5734"
D1077,7,05/07/2021,PE75P08EN5,100,"5634"
D1077,7,05/07/2021,PE72P0ATYY,70,"5564"
D1077,7,05/08/2021,PE87PRMY7R,60,"5504"
D1077,7,05/21/2021,PEL687EYMQ,5504,0
D1077,8,05/26/2021,PEQ1EAIH11,100,"8060"
D1077,8,05/26/2021,PEQ4EAMCHO,100,"7960"
D1077,8,05/26/2021,PEQ3EAQCB5,89,"7871"
D1077,8,06/19/2021,PFJ0CK5U4E,2000,"5871"
D1077,8,06/20/2021,PFK7D5PJCD,5300,571
D1077,8,06/20/2021,PFK5D6XSEV,220,351
D1077,8,06/20/2021,PFL2E08NR0,355,4
D1077,9,06/21/2021,PFL2E08NR0_D2,4,"7616"
D1077,9,07/14/2021,PGE6CPVZ0S,"3000","4616"
D1077,9,07/15/2021,PGF9E2RJUH,4620,4
D1077,10,07/17/2021,PGH4GT1NF0,100,"7580"
D1077,10,07/17/2021,PGH0GXUO48,100,"7480"
D1077,10,07/17/2021,PGH7GXZ9S1,100,"7380"
D1077,10,07/18/2021,PGI7IAIEQL,100,"7280"
D1077,10,07/18/2021,PGI2IAMD7M,100,"7180"
D1077,10,07/18/2021,PGI4IAF5CY,100,"7080"
D1077,10,07/19/2021,PGJ9JOXM7J,100,"6980"
D1077,10,07/19/2021,PGJ0JP1DNY,100,"6880"
D1077,10,07/21/2021,PGL3MMP9W3,100,"6780"
D1077,10,07/21/2021,PGL3MMQD19,99,"6681"
D1077,10,07/22/2021,PGM1NVHH5D,100,"6581"
D1077,10,07/22/2021,PGM6NVM30C,100,"6481"
D1077,10,07/22/2021,PGM8NVVBRA,100,"6381"
D1077,10,07/23/2021,PGN2PDQS1O,100,"6281"
D1077,10,07/23/2021,PGN1PDZM5L,100,"6181"
D1077,10,07/23/2021,PGN3PFWBS7,100,"6081"
D1077,10,07/25/2021,PGP1SB64KR,100,"5981"
D1077,10,07/25/2021,PGP1SB86GH,50,"5931"
D1077,10,08/10/2021,PHA3FJ2KED,3800,"2131"
D1077,10,08/11/2021,PHB9GQGUDD,2100,31
D1077,10,08/11/2021,PHB0GUMFQQ,31,0
D1077,11,09/01/2021,PI14D91A9C,"3000","5960"
D1077,11,09/06/2021,PI60JHWZV6,"5960",0
D1077,12,10/01/2021,PJ17NKIDXZ,"8890",0
D1077,13,10/02/2021,PJ29PFBDZZ,350,"8540"
D1077,13,10/03/2021,PJ32QLUG9U,100,"8440"
D1077,13,10/03/2021,PJ35QQBUIJ,100,"8340"
D1077,13,10/03/2021,PJ34QS0G1S,100,"8240"
D1077,13,10/05/2021,PJ58SUJVFU,100,"8140"
D1077,13,10/05/2021,PJ56SUMAME,100,"8040"
D1077,13,10/06/2021,PJ68U6SBHG,100,"7940"
D1077,13,10/06/2021,PJ63U6SXQ5,100,"7840"
D1077,13,10/06/2021,PJ62U6U916,100,"7740"
D1077,13,10/06/2021,PJ67V28ERF,100,"7640"
D1077,13,10/06/2021,PJ66VQWQTW,100,"7540"
D1077,13,10/06/2021,PJ61VQWZL1,100,"7440"
D1077,13,10/07/2021,PJ75X8G7GP,100,"7340"
D1077,13,10/27/2021,PJR6SPMTA2,7300,40
D1077,13,10/27/2021,PJR8STILY8,40,0
D1077,14,11/20/2021,PKK8WVV9VY,"4000","4960"
D1077,14,11/20/2021,PKK9XRYISJ,"2000","2960"
D1077,14,11/21/2021,PKL7Z80YCN,2850,110
D1077,14,11/22/2021,PKM0ZP2O18,100,10
D1077,14,11/22/2021,PKM4ZP5BKI,10,0
D1077,15,12/01/2021,PL14H96KZM,100,"8790"
D1077,15,12/17/2021,PLH09OPI54,"8790",0
D1077,16,01/11/2022,QAB0FRZ9YA,"8850",40
D1077,16,01/11/2022,QAB1FVUA2X,40,0
D1077,17,01/12/2022,QAC9HCAF2D,100,"10300"
D1077,17,01/12/2022,QAC7HCBPM5,100,"10200"
D1077,17,01/13/2022,QAD8JW8S88,100,"10100"
D1077,17,01/13/2022,QAD8K0TUSQ,100,"10000"
D1077,17,01/13/2022,QAD4KAVZ0I,100,"9900"
D1077,17,01/13/2022,QAD0KGJZB4,100,"9800"
D1077,17,01/14/2022,QAE8LZ4T2W,100,"9700"
D1077,17,01/14/2022,QAE8LZ96BQ,100,"9600"
D1077,17,01/14/2022,QAE3MACKZT,100,"9500"
D1077,17,01/15/2022,QAF0NK8WZ2,100,"9400"
D1077,17,01/15/2022,QAF3NKD4K3,100,"9300"
D1077,17,01/15/2022,QAF9NY2U73,80,"9220"
D1077,17,01/16/2022,QAG7OIEUID,100,"9120"
D1077,17,01/16/2022,QAG6OIHCOQ,100,"9020"
D1077,17,01/17/2022,QAH6R94AQA,100,"8920"
D1077,17,01/17/2022,QAH2R95BOQ,100,"8820"
D1077,17,01/17/2022,QAH0R95P90,90,"8730"
D1077,17,01/18/2022,QAI7SUTFUF,350,"8380"
D1077,17,01/19/2022,QAJ6TUQ3OE,100,"8280"
D1077,17,01/19/2022,QAJ4UAHHKK,100,"8180"
D1077,17,01/19/2022,QAJ5UK1JSR,100,"8080"
D1077,17,01/20/2022,QAK4W5GHUY,100,"7980"
D1077,17,01/22/2022,QAM4Z9N0QG,100,"7880"
D1077,17,01/22/2022,QAM5ZA1OQT,100,"7780"
D1077,17,02/06/2022,QB65PKPW53,4000,"3780"
D1077,17,02/07/2022,QB73RZ70NL,1000,"2780"
D1077,17,02/08/2022,QB86UQ3YM6,2780,0
D1077,18,03/07/2022,QC759YM1NV,"4000","6400"
D1077,18,03/11/2022,QCB9HLXDKP,"6400",0
D1077,19,04/09/2022,QD903DC41C,"10400",0
D1077,20,05/03/2022,QE35EMDGCD,"6000","4000"
D1077,20,05/04/2022,QE49GIO3ET,"4000",0
D1077,21,05/30/2022,QEU3VQNLPH,"10240",0
D1077,22,06/30/2022,QFU0N46P2K,100,"10300"
D1077,22,07/01/2022,QG10PDEKXK,100,"10200"
D1077,22,07/03/2022,QG37TJ87XL,50,"10150"
D1077,22,07/05/2022,QG52WFX0V6,100,"10050"
D1077,22,07/06/2022,QG67ZXHXFJ,100,"9950"
D1077,22,07/07/2022,QG7531PCOZ,100,"9850"
D1077,22,07/10/2022,QGA494H2F2,100,"9750"
D1077,22,07/12/2022,QGC3D0OUI3,100,"9650"
D1077,22,07/13/2022,QGD8F3ULVS,100,"9550"
D1077,22,07/14/2022,QGE9H4855Z,100,"9450"
D1077,22,07/21/2022,QGL7TJIKYR,3000,"6450"
D1077,22,08/08/2022,QH83WS13RR,200,"6250"
D1077,22,08/24/2022,QHO5QPD7Z9,100,"6150"
D1077,22,08/24/2022,QHO0QPGHF6,100,"6050"
D1077,22,08/27/2022,QHR7W3RLYF,6000,50
D1077,22,08/29/2022,QHT819H6WI,50,0
D1078,1,12/22/2020,OLM4TWBVLU,"25200",0
D1078,2,01/21/2021,PAL6U2RATI,"27200",0
D1078,3,02/20/2021,PBK9V8VDLZ,"5000","22200"
D1078,3,02/22/2021,PBM1XQPAWP,"22200",0
D1078,4,03/25/2021,PCP836YQEU,"27200",0
D1078,5,04/26/2021,PDQ896ETXM,"5000","26600"
D1078,5,05/01/2021,PE12FMFZF0,"3000","23600"
D1078,5,05/05/2021,PE55L6P0SP,1500,"22100"
D1078,5,05/17/2021,PEH91WWEGJ,200,"21900"
D1078,5,05/18/2021,PEI4389QEY,200,"21700"
D1078,5,05/20/2021,PEK95SSZUN,400,"21300"
D1078,5,05/22/2021,PEM98F7N4R,400,"20900"
D1078,5,05/26/2021,PEQ0DMG6YY,600,"20300"
D1078,5,05/31/2021,PEV9KMABZB,"5000","15300"
D1078,5,06/07/2021,PF71UFF2KT,7000,"8300"
D1078,5,07/08/2021,PG8132CBQH,500,"7800"
D1078,5,07/19/2021,PGJ4ILM5ZS,500,"7300"
D1078,5,08/25/2021,PHP61ZJLBO,507,"6793"
D1078,5,10/06/2021,PL69OWT8BP,6800,7
D1079,1,12/22/2020,0LM7TWZZ4H,"25200",0
D1079,2,01/23/2021,PAN0WDMC88,"10000","17200"
D1079,2,01/25/2021,PAP8YHVZTW,17200,0
D1079,3,02/19/2021,PBJ4TOETR6,"14000","13200"
D1079,3,02/22/2021,PBM3XLZ2QV,"4000","9200"
D1079,3,02/26/2021,PBQ0373Y2G,"3000","6200"
D1079,3,03/01/2021,PC1573DLND,"6200",0
D1080,1,12/15/2020,OLF9KJ6KIL,"12000","40000"
D1080,1,12/17/2020,OLH5N2RNV9,"10000","30000"
D1080,1,12/23/2020,OLN4UPGVZM,"8000","22000"
D1080,1,12/24/2020,0LO8WISRMG,"22000",0
D1080,2,01/22/2021,PAM7V2MT2V,"21675","17325"
D1080,2,01/22/2021,PAM2VBCRNI,"17325",0
D1080,3,03/01/2021,PC117L4491,"4500","53900"
D1080,3,03/06/2021,PC63DQBYUJ,"2000","51900"
D1080,3,03/08/2021,PC86G9YAGQ,"20000","31900"
D1080,3,03/09/2021,PC94HL13KM,"18600","13300"
D1080,3,03/10/2021,PCA7J1TS55,"7500","5800"
D1080,3,03/11/2021,PCB3KG6IUD,"3000","2800"
D1080,3,03/12/2021,PCC7LW4VGD,"2800",0
D1080,4,04/19/2021,PDJ4Z89NDQ,"52000",0
D1080,5,05/17/2021,PEH3279Y8D,"20000","32000"
D1080,5,05/17/2021,PEH429RZ8S,"10000","22000"
D1080,5,05/18/2021,PEI83I7MMG,"7000","15000"
D1080,5,05/18/2021,PEI63V8BZI,"15000",0
D1080,6,06/11/2021,PFB2ZL22LG,"19900","32100"
D1080,6,06/11/2021,PFB4ZLWKE2,"15000","17100"
D1080,6,06/13/2021,PFD933QECL,"17100",0
D1080,7,07/21/2021,PGL7LR9OGP,"4500","58700"
D1080,7,07/30/2021,PGU6YDI6JQ,"3000","55700"
D1080,7,08/03/2021,PH385DOIIU,"2000","53700"
D1080,7,08/16/2021,PHG8OC7WZ8,"5000","48700"
D1080,7,08/18/2021,PHI8RJCX3Y,8000,"40700"
D1080,7,08/19/2021,PHK8TLQ9SA,2000,"38700"
D1080,7,08/24/2021,PHO8ZO0JC8,1000,"37700"
D1080,7,08/25/2021,PHP62C7RJ4,800,"36900"
D1080,7,09/02/2021,PI25DU0QUV,2000,"34900"
D1080,7,09/06/2021,PI68JJR2YM,34900,0
D1081,1,01/09/2021,PA97GDF2AL,"1625","5175"
D1081,1,01/14/2021,PAE5M2D2CT,"1625","3550"
D1081,1,01/23/2021,PAN1WBBA6L,"1625","1925"
D1081,1,2/4/2021,PB46BTT44E,"1925",0
D1081,2,02/18/2021,PBI4SSEQI0,"1625","4875"
D1081,2,02/25/2021,PBP62X28S8,"1625","3250"
D1081,2,03/03/2021,PC32AH0C4O,"1625","1625"
D1081,2,03/11/2021,PCB8K9KDF6,"1625",0
D1081,3,03/18/2021,PCI3TCURXH,800,"5450"
D1081,3,03/28/2021,PCS77NK1V5,850,"4600"
D1081,3,04/02/2021,PD23D9W7W5,"4600",0
D1081,4,04/10/2021,PDA5OOIZLD,"1000","6900"
D1081,4,04/13/2021,PDD9RREHRR,625,"6275"
D1081,4,04/18/2021,PDI5YZ23YR,625,"5650"
D1081,4,04/22/2021,PDM53ZBIDP,"1000","4650"
D1081,4,04/28/2021,PDS7C7Q4OT,625,"4025"
D1081,4,04/29/2021,PDT3DPECOF,1000,"3025"
D1081,4,05/06/2021,PE68N4CXA,800,"2225"
D1081,4,05/21/2021,PEL87SDBYU,2225,0
D1082,1,01/19/2021,PAJ9RUVJVV,"1700","5100"
D1082,1,02/05/2021,PB55CROLDX,"2000","3100"
D1082,1,02/09/2021,PB92IBOOK0,"3100",0
D1082,2,04/10/2021,PDA8O0M63S,"3900",0
D1082,3,05/07/2021,PE71O1YMOV,"3900",0
D1082,4,06/05/2021,PF53RLIWUF,"3900",0
D1082,5,07/06/2021,PG60Z62868,"4080",0
D1082,6,07/28/2021,PGS4VOTSH0,"3900",0
D1082,7,08/18/2021,PHI8QST67M,"6500",0
D1082,8,09/13/2021,PID6UJGWRM,"6500",0
D1082,9,10/09/2021,PJ91ZQ9OB1,"6500",0
D1082,10,11/06/2021,PK68A06R9G,"6500",0
D1082,11,12/05/2021,PL44LY6BGQ,"6500",0
D1082,12,12/22/2021,PLM0IL4YJO,"6250",0
D1082,13,01/19/2022.,QAJ6T7TRY,"6500",0
D1083,1,01/17/2021,PAH9Q722NJ,530,"3670"
D1083,1,02/01/2021,PB157LD2OD,100,"3570"
D1083,1,02/02/2021,PB269KBTIY,100,"3470"
D1083,1,2/2/2021,PB60E7A2H0,"3450",20
D1083,1,2/7/2021,PB78G5T5CG,20,0
D1083,2,02/11/2021,PBB0JYPP4I,100,"3800"
D1083,2,02/15/2021,PBG3Q2IRMD,100,"3700"
D1083,2,02/20/2021,PBK3UVH979,100,"3600"
D1083,2,03/03/2021,PC49AYRU67,"3600",0
D1083,3,03/24/2021,PCN3ZGU4LR,"2000","1900"
D1083,3,03/26/2021,PCQ94JO21T,"2000",100
D1083,4,04/23/2021,PDN85EIO5C,"3956",56
D1083,5,04/23/2021,PDN85EIO5C_D2,86,"3994"
D1083,5,05/22/2021,PEM88PI976,"2745","1249"
D1083,5,05/25/2021,PEP9CNXD35,"1249",0
D1083,6,06/22/2021,PFM0FMYJ00,"3870",0
D1083,7,07/21/2021,PGL7MLV42R,"4500",260
D1083,7,07/22/2021,PGM6N9LT1I,260,0
D1083,8,08/20/2021,PHK2TTCP2A,"4606",56
D1083,9,09/20/2021,PIK76AK5VZ,"4760",0
D1083,10,11/08/2021,PK81D4G5IP,"5100",10
D1083,10,11/08/2021,PK89DA2S1F,10,0
D1083,11,12/09/2021,PL99UZ7JXP,"4950",160
D1083,11,12/09/2021,PL97V96JQB,100,60
D1083,11,12/09/2021,PL98V9JQEE,60,0
D1083,12,02/01/2022,QB16H5ELZE,100,"5430"
D1083,12,03/23/2022,QCN1680JKX,60,"5370"
D1084,1,01/11/2021,PAB2IW5GBA,300,"4900"
D1084,1,01/16/2021,PAG4P087CW,300,"4600"
D1084,1,01/20/2021,PAK5SKXWV1,400,"4200"
D1084,1,2/6/2021,PB65EEG36R,"4200",0
D1084,2,03/08/2021,PC88GFH1OA,"5200",0
D1084,3,04/05/2021,PD52HYXEXQ,"3900","1540"
D1084,3,04/06/2021,PD65II7IXV,"1540",0
D1085,1,01/19/2021,PAJ9RMUNWZ,"3250","9050"
D1085,1,01/26/2021,PAQ2ZV3UM6,"3250","5800"
D1085,1,02/02/2021,PB2392ME1Z,"3250","2550"
D1085,1,02/02/2021,PB24960IQU,"2550",0
D1085,2,02/09/2021,PB96HVY3QU,"3250","8850"
D1085,2,02/16/2021,PBH0R43XTY,"3250","5600"
D1085,2,02/22/2021,PBM1XGEGMF,"5600",0
D1085,3,03/02/2021,PC20867GOE,"4225","12155"
D1085,3,03/09/2021,PC92HGICOU,"4225","7930"
D1085,3,03/17/2021,PCH3RKM3CT,"4225","3705"
D1085,3,03/18/2021,PCI9T0QZEP,3705,0
D1085,4,03/28/2021,PCS9773I8L,"2540","13060"
D1085,4,03/29/2021,PCT27TY2ZA,"1360","11700"
D1085,4,04/05/2021,PD52GZU70O,"2150","9550"
D1085,4,04/06/2021,PD66IRHXFG,1270,"8280"
D1085,4,04/07/2021,PD77JHYW2X,530,"7750"
D1085,4,04/10/2021,PDA1NNV7IT,2700,"5050"
D1085,4,04/11/2021,PDB9PY6RSJ,1200,"3850"
D1085,4,04/15/2021,PDF7U39X93,3900,50
D1085,5,04/24/2021,PDO06XMCIY,"2000","10300"
D1085,5,04/27/2021,PDR8BDDIB2,"1225","9075"
D1085,5,04/05/2021,PE45JWISWL,"2000","7075"
D1085,5,05/05/2021,PE54L2O7GY,1300,"5775"
D1085,5,05/06/2021,PE68MYMIDE,5775,0
D1085,6,05/15/2021,PEF4YH192G,"2600","7080"
D1085,6,05/24/2021,PEO6BYH33S,"2600","4480"
D1085,6,05/25/2021,PEP7CKPPWX,"4480",0
D1085,7,06/02/2021,PF20NDK1H6,"3575","10725"
D1085,7,06/10/2021,PFA0Y6ZBAY,"2000","8725"
D1085,7,06/11/2021,PFB8ZDBX9C,"1425","7300"
D1085,7,06/17/2021,PFH58ONRK3,1400,"5900"
D1085,7,06/21/2021,PFL5E23MC7,2100,"3800"
D1085,7,06/22/2021,PFM9FHF06L,"3800",0
D1085,8,07/01/2021,PG14RTWZ8I,"2275","5985"
D1085,8,07/07/2021,PG79208X29,"5985",0
D1085,9,07/16/2021,PGG1EAY6VB,"3065","8535"
D1085,9,07/21/2021,PGL0LHVFLU,"8535",0
D1085,10,07/29/2021,PGT7WVRLNN,"3900","10020"
D1085,10,08/04/2021,PH4672OK1C,"10020",0
D1085,11,08/12/2021,PHC3IHHRQX,"4225","10855"
D1085,11,08/16/2021,PHG1ODRSTP,"10855",0
D1085,12,08/28/2021,PHS55Y9QRT,"3075","15975"
D1085,12,08/30/2021,PHU48XUGHU,"1800","14175"
D1085,12,09/08/2021,PI85MSA6OF,"14175",0
D1085,13,10/04/2021,PJ45R5A0AX,"16640",0
D1085,14,10/28/2021,PJS6V09TO8,"15000","4500"
D1085,14,10/28/2021,PJ45R5A0AY,"4500",0
D1086,1,01/21/2021,PAL3UCW5QX,"1625","4475"
D1086,1,01/29/2021,PAT63VS87Y,"1625","2850"
D1086,1,02/04/2021,PB46CEUE2Y,100,"2750"
D1086,1,02/04/2021,PB40CEW9DA,100,"2650"
D1086,1,02/04/2021,PB47CEYNOF,100,"2550"
D1086,1,02/04/2021,PB47CF2FAN,100,"2450"
D1086,1,02/04/2021,PB43CF6B0J,100,"2350"
D1086,1,02/04/2021,PB48CFCG94,2350,0
D1086,2,02/12/2021,PBC4M2RYOK,"1625","4275"
D1086,2,02/19/2021,PBJ3URH6RL,"1625","2650"
D1086,2,02/21/2021,PBL4WBDF6M,"1178","1472"
D1086,2,02/22/2021,PBM3XH8H5N,1472,0
D1086,3,03/01/2021,PC157X8Z1L,"1625","4425"
D1086,3,03/08/2021,PC89GN99AR,"1625","2800"
D1086,3,03/12/2021,PCC8MCWE6M,"1453","1347"
D1086,3,03/13/2021,PCD2MFDCWI,370,977
D1086,3,03/13/2021,PCD6MQ3VTK,977,0
D1086,4,03/21/2021,PCL3XR5SCN,"2000","6540"
D1086,4,03/25/2021,PCP83U8KDO,"1100","5440"
D1086,4,03/28/2021,PCS16ZOI0X,100,"5340"
D1086,4,03/28/2021,PCS66ZSJ7Q,95,"5245"
D1086,4,03/30/2021,PCU4A7IVGM,2250,"2995"
D1086,4,04/01/2021,PD18CT1XL2,100,"2895"
D1086,4,04/01/2021,PD15CT5QGH,100,"2795"
D1086,4,04/01/2021,PD17CTBH17,100,"2695"
D1086,4,04/01/2021,PD18CTFB88,100,"2595"
D1086,4,04/01/2021,PD10CTMP34,100,"2495"
D1086,4,04/01/2021,PD19CUEEOF,2495,0
D1086,5,04/09/2021,PD90M6VFOW,100,"8510"
D1086,5,04/09/2021,PD98M6YGBE,100,"8410"
D1086,5,04/09/2021,PD97M70HLF,100,"8310"
D1086,5,04/10/2021,PDA9OQGJEZ,50,"8260"
D1086,5,04/12/2021,PDC1QBPQUD,2160,"6100"
D1086,5,04/18/2021,PDI7YO76AV,100,"6000"
D1086,5,04/18/2021,PDI1YOBEP3,100,"5900"
D1086,5,04/19/2021,PDJ9ZR48U5,562,"5338"
D1086,5,04/24/2021,PDN16D7RUX,3788,"1550"
D1086,5,04/24/2021,PDO46RELTC,1550,0
D1086,6,05/02/2021,PE28HGN3YA,"2500","6100"
D1086,6,05/09/2021,PE95RINH23,"2500","3600"
D1086,6,05/12/2021,PEC9UX7HY3,100,"3500"
D1086,6,05/12/2021,PEC6UXATYA,100,"3400"
D1086,6,05/12/2021,PEC0UXJHJM,3400,0
D1086,7,05/20/2021,PEK35WNDQT,"2280","6610"
D1086,7,06/05/2021,PF54RQO9YY,"6570",40
D1086,7,06/05/2021,PF58RSSKVO,40,0
D1086,8,06/15/2021,PFF15SAFNP,"2275","7245"
D1086,8,06/28/2021,PFS0OVFBWM,578,"6667"
D1086,8,06/29/2021,PFT2Q9AVCY,100,"6567"
D1086,8,06/29/2021,PFT9Q9C9MV,86,"6481"
D1086,8,06/30/2021,PFU4RPDIIS,100,"6381"
D1086,8,06/30/2021,PFU5RPEY5P,100,"6281"
D1086,8,06/30/2021,PFU4RPG7M2,93,"6188"
D1086,8,07/06/2021,PG64ZD8PNU,2250,"3938"
D1086,8,07/06/2021,PG651F8KFB,3938,0
D1087,1,01/22/2021,PAM4VCV0WS,500,"5975"
D1087,1,01/23/2021,PAN9W9RVM3,"1150","4825"
D1087,1,01/29/2021,PAT74BL19V,"1000","3825"
D1087,1,1/30/2021,PAU05RMZVA,625,"3200"
D1087,1,2/5/2021,PB54DM441A,"1625","1575"
D1087,1,2/10/2021,PBA9JENYSV,1575,0
D1087,2,02/19/2021,PBJ5TODZ77,800,"3540"
D1087,2,02/23/2021,PBN6ZDZDFA,200,"3340"
D1087,2,02/24/2021,PBO510FIIN,138,"3202"
D1087,2,02/26/2021,PBQ63JJX2U,1138,"2064"
D1087,2,03/04/2021,PC46BSX11C,1750,314
D1087,2,03/05/2021,PC59CG8ZKN,314,0
D1087,3,03/13/2021,PCD7MYMMGL,750,"5000"
D1087,3,03/15/2021,PCF1P37WO5,855,"4145"
D1087,3,03/19/2021,PCJ6UQ7X3W,"1950","2195"
D1087,3,03/19/2021,PCJ7UQITL3,2000,195
D1087,3,03/19/2021,PCJ3USZCZ3,100,95
D1087,3,03/19/2021,PCJ9UT0UWX,95,0
D1087,4,03/26/2021,PCQ353JRUT,500,"5550"
D1087,4,03/29/2021,PCT38UD9A3,"1125","4425"
D1087,4,03/31/2021,PCV9BCK943,280,"4145"
D1087,4,04/02/2021,PD22DO96E6,900,"3245"
D1087,4,04/03/2021,PD31ECR5K3,500,"2745"
D1087,4,04/08/2021,PD82L6HODG,2745,0
D1087,5,04/21/2021,PDL539BFN9,995,"6305"
D1087,5,04/22/2021,PDM04K3OB8,460,"5845"
D1087,5,05/03/2021,PE37J91DDH,"1500","4345"
D1087,5,05/13/2021,PED5VTDU2P,1000,"3345"
D1087,5,05/15/2021,PEF9ZOI8DL,3345,0
D1088,1,01/21/2021,PAL4UF899I,"3250","12550"
D1088,1,01/29/2021,PAT24FKYOA,"3250","9300"
D1088,1,02/13/2021,PBD6N6EFRQ,925,"8375"
D1088,1,2/17/2021,PBH4RC0ZQY,"3000","5375"
D1088,1,2/23/2021,PBN7Z8KW6L,500,"4875"
D1088,1,2/24/2021,PBP32SD5JL,500,"4375"
D1089,1,02/19/2021,PBJ4U1GIAY,"26000",0
D1089,2,03/19/2021,PCJ1UAVRN5,"26000",0
D1089,3,04/16/2021,PDG2VPP9VQ_D2,"39000",0
D1089,4,05/14/2021,PEE0XE3TUQ,"39000",0
D1089,5,06/11/2021,PFB3ZK4XHJ,"52000",0
D1089,6,07/10/2023,PBN7Z8KW6T,"52000",0
D1089,7,08/06/2021,PH639OPSJN,"58500",0
D1089,8,09/03/2021,PI34F38NJQ,"65000",0
D1089,9,10/01/2021,PJ11M67QN7,"65000",0
D1089,10,10/29/2021,PJT4VG936O,"65000",0
D1089,11,11/26/2021,PKQ78EBBAN,"65000",0
D1089,12,12/24/2021,PLO0LI39FE,"65000",0
D1089,13,01/21/2022,QAL2WSYGQ6,"65000",0
D1089,14,02/18/2022,QBI5D3WEXZ,"65000",0
D1089,15,03/18/2022,QCI6UZ1XUM,"65000",0
D1089,16,04/16/2022,QDG6I0772M,"65000",0
D1089,17,05/17/2022,QEH65ABWPS,"65000",0
D1089,18,06/19/2022,QFJ11E2MTX,"65000",0
D1089,19,07/16/2022,QGG7JMVCCB,"65000",0
D1089,20,08/19/2022,QHJ6FQAJRY,"65000",0
D1089,21,09/23/2022,QIN3IHCXP3,"65000",0
D1089,22,10/21/2022,QJL4BX7O5Y,"65000",0
D1089,23,11/18/2022,QKI16S0CNH,"65000",0
D1089,24,01/20/2023,RAK6RX6SG6,"65000",0
D1089,25,01/20/2023,RAK6RX6SG6_D2,"65000",0
D1089,26,02/24/2023,RBO2DS1WY,"65000",0
D1089,27,03/23/2023,RCN6FSJZAY,"65000",0
D1089,28,06/02/2023,RF261O6258,"65000",0
D1089,29,07/07/2023,RG77X06N73,"65000",0
D1090,1,02/08/2021,PB86GAAGLI,"2000","4500"
D1090,1,02/15/2021,PBF7P8I2C7,"1000","3500"
D1090,1,02/19/2021,PBJ5TMJ6OZ,"2000","1500"
D1090,1,2/21/2021,PBM6X8NCSW,"1500",0
D1090,2,03/03/2021,PC359HQDHN,900,"5900"
D1090,2,03/05/2021,PC50C55JLI,950,"4950"
D1090,2,03/10/2021,PCA9IOYKLR,850,"4100"
D1090,2,03/18/2021,PCI0SWG29S,"1000","3100"
D1090,2,03/23/2021,PCN9Z8MKVN,2700,400
D1090,2,03/23/2021,PCN4ZODNLS,400,0
D1091,1,02/06/2021,PB64EBFJ0A,"1000","2600"
D1091,1,02/13/2021,PBD0N1BMBM,"1000","1600"
D1091,1,02/18/2021,PBI8SMPJAO,"1600",0
D1091,2,03/04/2021,PC47B2URZH,"11600",0
D1091,3,03/24/2021,PCO91UG76J,"12300",0
D1091,4,04/14/2021,PDE0TDS55U,"14640",0
D1091,5,05/08/2021,PE80PEKHTA,"16380",0
D1091,6,06/05/2021,PF50RB9UGW,"16900",0
D1091,7,06/25/2021,PFP4JTRZ86,"15860",0
D1091,8,08/24/2021,PHO9ZT7XRD,"1450","22250"
D1091,8,08/27/2021,PHR14H1EH3,"15000","7250"
D1091,8,09/02/2021,PI21E7357Z,"2950","4300"
D1091,8,09/07/2021,PI74L5ZP6M,2000,"2300"
D1091,8,09/14/2021,PIE4VLOI5A,1300,"1000"
D1091,8,09/17/2021,PIH629K6FO,1000,0
D1091,9,10/08/2021,PJ86XM9EI0,"3490",0
D1091,10,10/21/2021,PJL6J867TW,"5700",0
D1091,11,11/09/2021,PK91EXN5TH,"6050",0
D1091,12,11/16/2021,PKG0R18VCQ,"1675","4475"
D1091,12,11/29/2021,PKT3CVW49Z,"4475",0
D1091,13,12/23/2021,PLN1JTD1K9,"6400",0
D1091,14,01/20/2022,QAK5VFF08L,"6500",0
D1091,15,02/17/2022,QBH6BEE1Y2,"13000",0
D1091,16,03/18/2022,QCI7UY84L5,250,"14350"
D1091,16,03/18/2022,QCI1UZI0H1,50,"14300"
D1091,16,04/02/2022,QD25OV4OR5,"2000","12300"
D1091,16,04/02/2022,QD20OYYPYY,400,"11900"
D1091,16,04/04/2022,QD49SPV6VX,1000,"10900"
D1091,16,04/07/2022,QD71YH94EN,1000,"9900"
D1091,16,04/16/2022,QDG0GVI1RW,9900,0
D1091,17,12/19/2022,QBH6BEE1Y2_D2,"6050",0
D1091,18,1/17/2022,RAH5L8HEW3,"6500",0
D1091,19,2/14/2023,RBE6MJGT28,"6450",0
D1091,20,3/15/2023,RCF8U76Q0Y,"6500",0
D1091,21,4/26/2023,RDQ137BLEZ,500,"7400"
D1091,21,05/06/2023,RE61UGEKM9,"4000","3400"
D1091,21,05/08/2023,RE8520VS0J,600,"2800"
D1091,21,05/30/2023,REU0REDY9I,1000,"1800"
D1091,21,05/30/2023,REU0RFD10E,600,"1200"
D1091,21,06/01/2023,RF16XSHXM8,500,700
D1091,21,06/05/2023,RF51A5YKWZ,700,0
D1092,1,02/12/2021,PBC5M6Z9BH,"1000","5500"
D1092,1,02/13/2021,PBD8NHMGSC,625,"4875"
D1092,1,02/19/2021,PBJ8UN29ZE,"1325","3550"
D1092,1,2/26/2021,PBQ344XLKV,"1300","2250"
D1092,1,3/4/2021,PC40B3EHE6,625,"1625"
D1092,1,3/5/2021,PC57CBY7B7,"1625",0
D1092,2,03/19/2021,PCJ8VBH4UU,"1625","6275"
D1092,2,03/30/2021,PCU398LYA1,300,"5975"
D1092,2,04/01/2021,PD10CBEVKC,"1500","4475"
D1092,2,04/06/2021,PD67IYNUTD,100,"4375"
D1092,2,04/07/2021,PD71K6OPVZ,100,"4275"
D1092,2,04/07/2021,PD78K6KPVQ,100,"4175"
D1092,2,04/07/2021,PD76K6QXKG,50,"4125"
D1092,2,04/12/2021,PDC7Q4NMO3,100,"4025"
D1092,2,04/12/2021,PDC4Q4PVWG,100,"3925"
D1092,2,04/12/2021,PDC7Q4VQMN,100,"3825"
D1092,2,04/14/2021,PDE6TEZX3C,100,"3725"
D1092,2,04/16/2021,PDG1VU4KMJ,200,"3525"
D1092,2,04/17/2021,PDH2XSDUEE,100,"3425"
D1092,2,04/17/2021,PDH4XSFQQ6,100,"3325"
D1092,2,04/21/2021,PDL6306872,100,"3225"
D1092,2,05/01/2021,PE10G5POB4,200,"3025"
D1092,2,05/05/2021,PE53L128KL,200,"2825"
D1092,2,05/25/2021,PEP9CG5QYB,100,"2725"
D1092,2,05/25/2021,PEP0CG7ZN2,100,"2625"
D1092,2,05/25/2021,PEP7CGAP8B,100,"2525"
D1092,2,05/26/2021,PEQ4E61VS4,100,"2425"
D1092,2,05/28/2021,PES6H39JJO,1000,"1425"
D1092,2,06/11/2021,PFB512M9XX,100,"1325"
D1092,2,06/11/2021,PFB412P8TO,100,"1225"
D1092,2,06/16/2021,PFG27YV60E,100,"1125"
D1092,2,06/22/2021,PFM7FVSC0V,625,500
D1092,2,06/26/2021,PFQ5KSZL8X,500,0
D1093,1,02/16/2021,PBG2QM3NEE,"3250","8850"
D1093,1,02/23/2021,PBN2Z0W79Y_D2,"3050","5800"
D1093,1,02/24/2021,PBO5106HZV,200,"5600"
D1093,1,3/1/2021,,"5600",0
D1093,2,03/09/2021,PC96I0LKJ8,"3250","9750"
D1093,2,03/27/2021,PCR65GL1WQ,"2500","7250"
D1093,2,03/29/2021,PCT08D8UL0,"7250",0
D1093,3,04/26/2021,PDQ69L4NR2,"2944","12856"
D1093,3,04/29/2021,PDT2DB18JK,"1966","10890"
D1093,3,07/21/2021,PGL3LESYDD,"10890",0
D1094,1,02/12/2021,PBC2LPMY6E,435,"11865"
D1094,1,02/13/2021,PBD5N0UZLV,435,"11430"
D1094,1,02/14/2021,PBE2OB472Y,435,"10995"
D1094,1,2/15/2021,PBF1PIA7O7,435,"10560"
D1094,1,2/16/2021,PBG8QQJSRW,435,"10125"
D1094,1,2/17/2021,PBH9RXBIZP,435,"9690"
D1094,1,02/18/2021,PBI7T6K3KT,435,"9255"
D1094,1,02/19/2021,PBJ5UF4SC1,435,"8820"
D1094,1,02/20/2021,PBK1VP1HVB,435,"8385"
D1094,1,02/21/2021,PBL9WSCX5T,435,"7950"
D1094,1,02/22/2021,PBM8XVVSK0,435,"7515"
D1094,1,02/23/2021,PBN0Z0Z2L2,435,"7080"
D1094,1,02/24/2021,PBO61A3FS4,435,"6645"
D1094,1,02/25/2021,PBP52LKZE3,435,"6210"
D1094,1,02/26/2021,PBQ73V9HLL,435,"5775"
D1094,1,02/27/2021,PBR95EIE03,435,"5340"
D1094,1,02/28/2021,PBS46HXFDA,435,"4905"
D1094,1,03/01/2021,PC197P8J3H,435,"4470"
D1094,1,03/02/2021,PC2290KHTW,435,"4035"
D1094,1,03/03/2021,PC37AHQYE1,435,"3600"
D1094,1,03/04/2021,PC41BUEN8F,435,"3165"
D1094,1,03/05/2021,PC58CICOSE,3165,0
D1094,2,03/07/2021,PC77EY10HB,435,"12000"
D1094,2,03/07/2021,PC79FLYEUZ,435,"11565"
D1094,2,03/08/2021,PC83GW7P0X,435,"11130"
D1094,2,03/09/2021,PC98IEX382,435,"10695"
D1094,2,03/10/2021,PCA5JML247,435,"10260"
D1094,2,03/11/2021,PCB4KV72J0,435,"9825"
D1094,2,03/12/2021,PCC8M9548A,435,"9390"
D1094,2,03/13/2021,PCD9NJFF1L,435,"8955"
D1094,2,03/14/2021,PCE8OSAZC4,435,"8520"
D1094,2,03/15/2021,PCF8Q4ULK2,435,"8085"
D1094,2,03/16/2021,PCG0RBBCXG,435,"7650"
D1094,2,03/17/2021,PCH6SQ4EF4,435,"7215"
D1094,2,03/18/2021,PCI7TXXFTX,435,"6780"
D1094,2,03/19/2021,PCJ4VAHY20,435,"6345"
D1094,2,03/20/2021,PCK5WMICLZ,435,"5910"
D1094,2,03/21/2021,PCL5XS3OPR,435,"5475"
D1094,2,03/22/2021,PCM3Z1NZXB,435,"5040"
D1094,2,03/23/2021,PCN41BI16C,435,"4605"
D1094,2,03/24/2021,PCO71QBTI7,4505,100
D1094,2,03/24/2021,PCO71QOB55,100,0
D1094,3,03/25/2021,PCP23R4H1A,435,"11665"
D1094,3,03/26/2021,PCQ5545MK9,435,"11230"
D1094,3,03/27/2021,PCR86EDBHM,435,"10795"
D1094,3,03/28/2021,PCS27LG832,435,"10360"
D1094,3,03/29/2021,PCT08SO0P0,435,"9925"
D1094,3,03/30/2021,PCU6A53H42,435,"9490"
D1094,3,03/31/2021,PCV3BEBQSN,435,"9055"
D1094,3,04/01/2021,PD11CRPT0N,435,"8620"
D1094,3,04/02/2021,PD22E7IXIC,435,"8185"
D1094,3,04/03/2021,PD31FKA2TZ,435,"7750"
D1094,3,04/04/2021,PD49GS1F95,435,"7315"
D1094,3,04/06/2021,PD65JAC1PX,432,"6883"
D1094,3,04/07/2021,PD70KP3WDC,435,"6448"
D1094,3,04/08/2021,PD81LXVBYL,435,"6013"
D1094,3,04/09/2021,PD97NCUBT7,435,"5578"
D1094,3,04/10/2021,PDA3ON29Y1,435,"5143"
D1094,3,04/11/2021,PDB6PYHSC0,435,"4708"
D1094,3,04/12/2021,PDC2QNVFT8,4708,0
D1094,4,04/13/2021,PDD6SGYNWI,435,"11065"
D1094,4,04/14/2021,PDE1TSF7UR,400,"10665"
D1094,4,04/15/2021,PDF0V4WLR0,450,"10215"
D1094,4,04/16/2021,PDG8WD8N0M,435,"9780"
D1094,4,04/17/2021,PDH2XOOEKM,435,"9345"
D1094,4,04/18/2021,PDI4YZT6UU,435,"8910"
D1094,4,04/19/2021,PDJ719DMMF,300,"8610"
D1094,4,04/20/2021,PDK62JAXV6,435,"8175"
D1094,4,04/21/2021,PDL63NX6Z6,435,"7740"
D1094,4,04/23/2021,PDN05OWW3E,7740,0
D1094,5,04/24/2021,PDO97NO7T9,435,"12165"
D1094,5,04/25/2021,PDP98VA8U7,435,"11730"
D1094,5,04/26/2021,PDQ7A7OU8D,370,"11360"
D1094,5,04/27/2021,PDR1BGC4QR,400,"10960"
D1094,5,04/29/2021,PDT3CXFGR5,450,"10510"
D1094,5,04/29/2021,PDT1E2J2D1,400,"10110"
D1094,5,05/01/2021,PE10GYL9XC,450,"9660"
D1094,5,05/02/2021,PE24I61HY8,435,"9225"
D1094,5,05/03/2021,PE33JHJCKV,400,"8825"
D1094,5,05/04/2021,PE41KT5GU1,400,"8425"
D1094,5,05/05/2021,PE53MAN3ZZ,365,"8060"
D1094,5,05/06/2021,PE63NMEN51,370,"7690"
D1094,5,05/07/2021,PE71OZJQ5H,350,"7340"
D1094,5,05/08/2021,PE85QCNAW7,350,"6990"
D1094,5,05/09/2021,PE92RNHPXM,300,"6690"
D1094,5,05/10/2021,PEA6T1RUDG,420,"6270"
D1094,5,05/11/2021,PEB6UBKKO6,390,"5880"
D1094,5,05/12/2021,PEC2VPREB4,350,"5530"
D1094,5,05/14/2021,PEE6YA3HLQ,300,"5230"
D1094,5,05/15/2021,PEF4ZMDTMS,300,"4930"
D1094,5,05/16/2021,PEG11SFCZP,300,"4630"
D1094,5,05/17/2021,PEH72793S3,4630,0
D1094,6,05/18/2021,PEI34FPH3T,600,"18400"
D1094,6,05/19/2021,PEJ95QA3YL,500,"17900"
D1094,6,05/20/2021,PEK97163TD,500,"17400"
D1094,6,05/22/2021,PEM38G2L0B,500,"16900"
D1094,6,05/23/2021,PEN7A1ALW3,500,"16400"
D1094,6,05/23/2021,PEN8AWJKRU,530,"15870"
D1094,6,05/24/2021,PEO9C5OP9J,500,"15370"
D1094,6,05/25/2021,PEP2DFKFJK,500,"14870"
D1094,6,05/27/2021,PER0FY6MEE,500,"14370"
D1094,6,05/28/2021,PES4HEU1VG,500,"13870"
D1094,6,05/29/2021,PET8ISOO5E,400,"13470"
D1094,6,05/30/2021,PEU8JZR6CE,450,"13020"
D1094,6,06/01/2021,PF18LYJGXA,460,"12560"
D1094,6,06/02/2021,PF22MTZVOQ,450,"12110"
D1094,6,06/03/2021,PF36PEYPSU,800,"11310"
D1094,6,06/04/2021,PF45QT4DIP,975,"10335"
D1094,6,06/06/2021,PF62TKP2D8,600,"9735"
D1094,6,06/08/2021,PF80VL38NY,1000,"8735"
D1094,6,06/10/2021,PFA0YCMJT4,8735,0
D1094,7,06/12/2021,PFC81N5QCQ,400,"19050"
D1094,7,06/13/2021,PFD53SZR7P,400,"18650"
D1094,7,06/15/2021,PFF55QBJ4P,400,"18250"
D1094,7,06/16/2021,PFG477SE4E,500,"17750"
D1094,7,06/18/2021,PFI4A1TESM,350,"17400"
D1094,7,06/20/2021,PFK2DTP07I,500,"16900"
D1094,7,06/23/2021,PFN4GKK2J2,300,"16600"
D1094,7,06/25/2021,PFP1JSH51L,530,"16070"
D1094,7,06/27/2021,PFR8NEA2Q8,500,"15570"
D1094,7,06/29/2021,PFT2OZG1E2,300,"15270"
D1094,7,07/01/2021,PG14RQGWGC,360,"14910"
D1094,7,07/02/2021,PG22TRJBEW,530,"14380"
D1094,7,07/04/2021,PG41XHQWCV,420,"13960"
D1094,7,07/05/2021,PG56YYMBIC,400,"13560"
D1094,7,07/08/2021,PG8638ID9U,13560,0
D1094,8,07/09/2021,PG915QNNBD,500,"25300"
D1094,8,07/11/2021,PGB27JK3U8,500,"24800"
D1094,8,07/12/2021,PGC38SL11J,600,"24200"
D1094,8,07/14/2021,PGE2BCPPDG,500,"23700"
D1094,8,07/15/2021,PGF2E6XLRG,400,"23300"
D1094,8,07/17/2021,PGH7G5LI3T,300,"23000"
D1094,8,07/18/2021,PGI1IEVEXV,400,"22600"
D1094,8,07/20/2021,PGK6JWBYUU,550,"22050"
D1094,8,07/21/2021,PGM2MNB7ZE,500,"21550"
D1094,8,07/23/2021,PGN6PKB0OQ,500,"21050"
D1094,8,07/25/2021,PGP5SBI157,400,"20650"
D1094,8,07/27/2021,PGR0TZFM4K,1000,"19650"
D1094,8,07/31/2021,PGV8ZVUWIC,2100,"17550"
D1094,8,08/02/2021,PH234T77LF,1400,"16150"
D1094,8,08/04/2021,PH426L6TYG,1150,"15000"
D1094,8,08/05/2021,PH548KZBXC,15000,0
D1094,9,08/09/2021,PH93EBM907,500,"25500"
D1094,9,08/12/2021,PHC1IAJNTR,500,"25000"
D1094,9,08/12/2021,PHC1IAM7TF,200,"24800"
D1094,9,08/15/2021,PHF3MT5165,1000,"23800"
D1094,9,08/16/2021,PHG4O6RBEM,500,"23300"
D1094,9,08/17/2021,PHH8PBRIYS,450,"22850"
D1094,9,09/18/2021,PHI5R6LOTD,1000,"21850"
D1094,9,09/19/2021,PHJ1T254KB,600,"21250"
D1094,9,09/21/2021,PHL8VQXSU0,350,"20900"
D1094,9,09/23/2021,PHN9XW1U0N,550,"20350"
D1094,9,09/24/2021,PHO9Z27JLZ,1000,"19350"
D1094,9,09/25/2021,PHP51NR8A1,420,"18930"
D1094,9,09/27/2021,PHR14UXLC1,400,"18530"
D1094,9,08/29/2021,PHT27S6A1A,500,"18030"
D1094,9,08/30/2021,PHU99B2FZH,900,"17130"
D1094,9,08/31/2021,PHV1AIRFN3,500,"16630"
D1094,9,09/02/2021,PI22DQ83FM,16630,0
D1094,10,09/04/2021,PI43GJZ65H,700,"25100"
D1094,10,09/07/2021,PI76L1H5WA,400,"24700"
D1094,10,09/19/2021,PIJ74SZ1J5,500,"24200"
D1094,10,09/21/2021,PIL36YUIVT,500,"23700"
D1094,10,09/21/2021,PIL56YWTSL,150,"23550"
D1094,10,09/25/2021,PIP6DA8LKE,350,"23200"
D1094,10,09/26/2021,PIQ5F5ELWN,800,"22400"
D1094,10,09/27/2021,PIR6H683VG,1350,"21050"
D1094,10,09/29/2021,PIT7IYHPDF,400,"20650"
D1094,10,09/30/2021,PIU6KVRVMK,20650,0
D1094,11,10/24/2021,PJO3OMABY7,500,"25500"
D1094,11,10/28/2021,PJS5U3Y6W5,"25500",0
D1094,12,11/22/2021,PKM12062TH,600,"31000"
D1094,12,11/22/2021,PKM920QZFL,70,"30930"
D1094,12,11/25/2021,PKP75Y1TTJ,"1000","29930"
D1094,12,11/29/2021,PKT2DC496I,2000,"27930"
D1094,12,12/01/2021,PL10G2LJ9S,2000,"25930"
D1094,12,12/02/2021,PL24HZE9JA,700,"25230"
D1094,12,12/06/2021,PL66P5LNV6,650,"24580"
D1094,12,12/10/2021,PLA8WS7UBU,500,"24080"
D1094,12,12/13/2021,PLD72TJMOL,500,"23580"
D1094,12,12/15/2021,PLF86GWB8A,500,"23080"
D1094,12,12/16/2021,PLH2963PVS,550,"22530"
D1094,12,12/20/2021,PLK5ECA473,500,"22030"
D1094,12,12/23/2021,PLN4K1KZCG,500,"21530"
D1094,12,12/29/2021,PLT4TE8HD8,500,"21030"
D1094,12,12/30/2021,PLU5VHKHEL,500,"20530"
D1094,12,01/04/2022,QA4144G22D,500,"20030"
D1094,12,01/06/2022,QA667VC92U,500,"19530"
D1094,12,01/10/2022,QAA4EQYYSI,500,"19030"
D1094,12,01/14/2022,QAE4L3N2M8,500,"18530"
D1094,12,01/17/2022,QAH4QLC56O,500,"18030"
D1094,12,01/21/2022,QAK0VMIIS8,500,"17530"
D1094,12,01/28/2022,QAS2A43L8G,500,"17030"
D1094,12,02/01/2022,QB12H5E4NY,500,"16530"
D1094,12,02/04/2022,QB46MZW1QK,60,"16470"
D1094,12,02/04/2022,QB49N01XQB,350,"16120"
D1094,12,02/09/2022,QB95V9E5UL,500,"15620"
D1094,12,02/11/2022,QBB5ZX3U0J,477,"15143"
D1094,12,02/17/2022,QBH0BMXOZU,500,"14643"
D1094,12,02/24/2022,QBO2O4I48E,502,"14141"
D1094,12,02/28/2022,QBS3VJH4IJ,302,"13839"
D1094,12,03/04/2022,QC404SS49M,300,"13539"
D1094,12,03/15/2022,QCF0PO42C8,50,"13489"
D1094,12,03/21/2022,QCL51OKUA5,300,"13189"
D1094,12,03/24/2022,QCO977L72Z,100,"13089"
D1094,12,03/24/2022,QCO677NRFW,50,"13039"
D1094,12,03/26/2022,QCQ1BMGD4Z,177,"12862"
D1094,12,04/05/2022,QD51V7VB47,100,"12762"
D1094,12,04/09/2022,QD98451AVC,200,"12562"
D1094,12,04/19/2022,QDJ9MQF4VV,150,"12412"
D1094,12,05/10/2022,QEA2REVEJM,20,"12392"
D1094,12,07/18/2022,QGI2OD4Y02,50,"12342"
D1094,12,08/19/2022,QHJ2GBYWYU,50,"12292"
D1094,12,08/20/2022,QHK0IIL8LO,48,"12244"
D1094,12,09/21/2022,QIL3EIWXUB,150,"12094"
D1094,12,10/29/2022,QJT5UGAJI7,50,"12044"
D1095,1,02/19/2021,PBJ3UCUC09,100,"3800"
D1095,1,02/19/2021,PBJ9UCZJPN,30,"3770"
D1095,1,02/20/2021,PBK9VQLLMD,100,"3670"
D1095,1,02/20/2021,PBK9VQPU1L,30,"3640"
D1095,1,2/21/2021,PBL7X25FT3,100,"3540"
D1095,1,2/21/2021,PBL4X2JD9I,30,"3510"
D1095,1,02/22/2021,PBM1Y6RNLZ,100,"3410"
D1095,1,02/22/2021,PBM5Y6VNNN,30,"3380"
D1095,1,02/23/2021,PBN9Z9H7F1,100,"3280"
D1095,1,02/23/2021,PBN9Z9O4MP,30,"3250"
D1095,1,02/25/2021,PBP42VUOJS,100,"3150"
D1095,1,02/25/2021,PBP72VX62X,30,"3120"
D1095,1,02/24/2021,PBO41LZ1T2,100,"3020"
D1095,1,02/24/2021,PBO21M1W5G,30,"2990"
D1095,1,02/26/2021,PBQ444HC2A,100,"2890"
D1095,1,02/26/2021,PBQ044L1DM,30,"2860"
D1095,1,02/27/2021,PBR85GSVJY,100,"2760"
D1095,1,02/27/2021,PBR05GWWFU,30,"2730"
D1095,1,02/28/2021,PBS36MGSHT,100,"2630"
D1095,1,02/28/2021,PBS46MKFUG,30,"2600"
D1095,1,03/01/2021,PC167PYJ38,"3900","1300"
D1095,2,03/01/2021,PC167PYJ38_D2,"1300","2600"
D1095,2,03/04/2021,PC44BWKDH6,100,"2500"
D1095,2,03/04/2021,PC40BWNXQK,30,"2470"
D1095,2,03/05/2021,PC58D807WI,100,"2370"
D1095,2,03/05/2021,PC59D8371H,30,"2340"
D1095,2,03/07/2021,PC79FJJ7UJ,100,"2240"
D1095,2,03/07/2021,PC79FJMLKH,30,"2210"
D1095,2,03/07/2021,PC74FJZPQY,100,"2110"
D1095,2,03/07/2021,PC72FK40YE,30,"2080"
D1095,2,03/09/2021,PC90I63Q20,100,"1980"
D1095,2,03/09/2021,PC93I68CG3,30,"1950"
D1095,2,03/09/2021,PC97I6D5S7,30,"1920"
D1095,2,03/09/2021,PC95I6KGZZ,100,"1820"
D1095,2,03/10/2021,PCA2JE101W,100,"1720"
D1095,2,03/10/2021,PCA4JE4H8C,30,"1690"
D1095,2,03/11/2021,PCB3KRJDH7,100,"1590"
D1095,2,03/11/2021,PCB9KRPAWF,30,"1560"
D1095,2,03/14/2021,PCE2OKLM2I,100,"1460"
D1095,2,03/14/2021,PCE5OKP2CH,30,"1430"
D1095,2,03/14/2021,PCE5OKSU7L,100,"1330"
D1095,2,03/14/2021,PCE9OKWGIJ,30,"1300"
D1095,2,03/14/2021,PCE8OL03AK,100,"1200"
D1095,2,03/14/2021,PCE3OL4743,30,"1170"
D1095,2,03/18/2021,PCI5TLUEW9,100,"1070"
D1095,2,03/18/2021,PCI1TLXX0P,30,"1040"
D1095,2,03/18/2021,PCI8TM1LQE,100,940
D1095,2,03/18/2021,PCI5TM4RAN,30,910
D1095,2,03/18/2021,PCI3TM94DV,100,810
D1095,2,03/18/2021,PCI6TMD5K2,30,780
D1095,2,03/18/2021,PCI8TMHC7G,100,680
D1095,2,03/26/2021,PCQ156UQEZ,100,580
D1095,2,03/26/2021,PCQ156WN0F,30,550
D1095,2,03/27/2021,PCR26EVJBQ,100,450
D1095,2,03/27/2021,PCR96EYOS3,30,420
D1095,2,03/28/2021,PCS17G8Z5Z,100,320
D1095,2,03/28/2021,PCS27GFB8U,30,290
D1095,2,03/30/2021,PCU29SVVA8,100,190
D1095,2,03/30/2021,PCU79T0UKJ,100,90
D1095,2,03/30/2021,PCU09T5R0U,60,30
D1095,2,03/31/2021,PCV9BEV9IL,30,0
D1095,3,05/08/2021,PE89QD1P63,100,"3800"
D1095,3,05/08/2021,PE84QD5F82,30,"3770"
D1095,3,05/09/2021,PE96RN2UX6,100,"3670"
D1095,3,05/09/2021,PE90RN9FOM,30,"3640"
D1095,3,05/10/2021,PEA6T0283O,100,"3540"
D1095,3,05/10/2021,PEA9T07SMD,30,"3510"
D1095,3,05/11/2021,PEB1UCP027,100,"3410"
D1095,3,05/11/2021,PEB5UCSIGB,30,"3380"
D1095,3,05/12/2021,PEC0V8X5DU,100,"3280"
D1095,3,05/12/2021,PEC2V933HY,30,"3250"
D1095,3,05/14/2021,PEE0Y9BBZA,100,"3150"
D1095,3,05/14/2021,PEE2Y9FR9S,100,"3050"
D1095,3,05/14/2021,PEE0Y9JNFU,60,"2990"
D1095,3,05/15/2021,PEF6ZLNWE6,100,"2890"
D1095,3,05/15/2021,PEF3ZLRJNN,30,"2860"
D1095,3,05/17/2021,PEH333EUIF,100,"2760"
D1095,3,05/17/2021,PEH133KCMB,100,"2660"
D1095,3,05/17/2021,PEH233MT8M,60,"2600"
D1095,3,05/20/2021,PEK95SLYV5,100,"2500"
D1095,3,05/20/2021,PEK05SM03W,100,"2400"
D1095,3,05/20/2021,PEK35SM6WP,60,"2340"
D1095,3,05/23/2021,PEN0ATCPC2,300,"2040"
D1095,3,05/25/2021,PEP7DASBRD,200,"1840"
D1095,3,06/03/2021,PF34OZFDPC,1200,640
D1095,3,06/05/2021,PF57R0CYNB,640,0
D1095,4,06/10/2021,PFA6YLKHZY,650,"3190"
D1095,4,07/02/2021,PG22TQF7KA,"3190",0
D1095,5,07/06/2021,PG601E9Z74,400,"4800"
D1095,5,07/06/2021,PG691EC3V3,296,"4504"
D1095,5,07/31/2021,PGV4ZSMQDA,"4444",60
D1095,5,07/31/2021,PGV4ZTFULE,200,140
D1095,5,07/31/2021,PGV0ZU17GG,60,200
D1095,6,07/31/2021,PGV4ZTFULE_D2,200,"5240"
D1095,6,08/29/2021,PHT98NNSC5,970,"4270"
D1095,6,09/06/2021,PI64KPPLIA,"4300",30
D1095,7,10/17/2021,PJH0E07TP0,130,"3770"
D1095,7,10/18/2021,PJI0FLK7L6,130,"3640"
D1095,7,10/20/2021,PJK6INKCY4,260,"3380"
D1095,7,11/08/2021,PK85EI4ATZ,1000,"2380"
D1095,7,11/12/2021,PKC4KEDDIG,2000,380
D1095,7,11/14/2021,PKE9N57T55,380,0
D1095,8,01/16/2022,QAG6PHLJ0E,"1000","5320"
D1095,8,01/29/2022,QAT6B3VQD2,"1000","4320"
D1095,8,02/13/2022,QBD93X789J,"1450","2870"
D1095,8,03/26/2022,QCQ2BQL8JM,500,"2370"
D1095,8,5/31/2023,REV0V3B9GA,1100,"1270"
D1095,8,5/31/2023,REV4VAJF90,150,"1120"
D1095,8,5/31/2023,PENALTIES W/OFF,1120,0
D1096,1,03/02/2021,PC2597ZUK9,"3034","9466"
D1096,1,03/17/2021,PCH3RR4AW3,"9466",0
D1096,2,04/14/2021,PDE9SV3DEZ,"13000",0
D1096,3,05/17/2021,PEH72FS3UJ,"16320",0
D1096,4,06/21/2021,PFL9EDY049,"16320",0
D1096,5,07/21/2021,PGL0LTIBZ6,"15600",720
D1096,5,07/21/2021,PGL5LU7NR7,720,0
D1096,6,09/02/2021,PI24DP3Q5W,450,"8310"
D1096,6,09/04/2021,PI47GR8TPR,"6900","1410"
D1096,6,09/06/2021,PI62JONX8A,"1410",0
D1096,7,09/22/2021,PIM68VVSQW,100,"2500"
D1096,7,09/23/2021,PIN6APR4LO,100,"2400"
D1096,7,09/24/2021,PIO3CH8FWJ,100,"2300"
D1096,7,09/27/2021,PIR0FXX8RO,100,"2200"
D1096,7,09/29/2021,PIT4J3DP36,100,"2100"
D1096,7,09/30/2021,PIU2L9JX46,100,"2000"
D1096,7,10/01/2021,PJ18MO03HC,100,"1900"
D1096,7,10/02/2021,PJ22PF69HA,100,"1800"
D1096,7,10/07/2021,PJ72WFOU1K,100,"1700"
D1096,7,10/07/2021,PJ79WLRVJ9,100,"1600"
D1096,7,10/11/2021,PJB03TX3IY,200,"1400"
D1096,7,10/12/2021,PJC85J6ZH6,100,"1300"
D1096,7,10/13/2021,PJD57GZDLD,100,"1200"
D1096,7,10/14/2021,PJE9848GMB,100,"1100"
D1096,7,10/14/2021,PJE68U0058,100,"1000"
D1096,7,10/15/2021,PJF4AOHUX0,100,900
D1096,7,10/18/2021,PJI4ECF5KS,900,0
D1096,8,10/19/2021,PJJ9GCUPZV,100,"2500"
D1096,8,10/20/2021,PJK4IJBLLY,100,"2400"
D1096,8,10/22/2021,PJM1LIH703,100,"2300"
D1096,8,10/25/2021,PJP9Q5QH5F,100,"2200"
D1096,8,10/27/2021,PJR9TA89NZ,100,"2100"
D1096,8,11/01/2021,PK101OZ3RU,100,"2000"
D1096,8,11/01/2021,PK191P1TG7,100,"1900"
D1096,8,11/01/2021,PK121P6T10,100,"1800"
D1096,8,11/01/2021,PK161PA6JU,100,"1700"
D1096,8,11/03/2021,PK3464W2P0,100,"1600"
D1096,8,11/03/2021,PK3265ZHZO,100,"1500"
D1096,8,11/03/2021,PK3967DPSP,100,"1400"
D1096,8,11/4/2021,PK477OWKA9,100,"1300"
D1096,8,11/12/2012,PKC6KL6WKC,100,"1200"
D1096,8,11/12/2012,PKC0KLW4TY,100,"1100"
D1096,8,11/12/2012,PKC2KOFV02,100,"1000"
D1096,8,11/15/2021,PKF7PI93JX,100,900
D1096,8,11/16/2021,PKG2Q1NGUQ,900,0
D1096,9,11/18/2021,PKI5TZYHVT,100,"3800"
D1096,9,11/18/2021,PKI3U0CTLB,30,"3770"
D1096,9,11/18/2021,PKI0U306AQ,100,"3670"
D1096,9,11/18/2021,PKI1U33W35,30,"3640"
D1096,9,11/19/2021,PKJ9VVEWAB,100,"3540"
D1096,9,11/19/2021,PKJ7VXBOAN,30,"3510"
D1096,9,11/20/2021,PKK6XSDQRY,100,"3410"
D1096,9,11/21/2021,PKL1YOP6KR,30,"3380"
D1096,9,11/23/2021,PKN62E7J4U,100,"3280"
D1096,9,11/23/2021,PKN32EH3JX,30,"3250"
D1096,9,11/23/2021,PKN63KYICO,100,"3150"
D1096,9,11/24/2021,PKO35B34YV,100,"3050"
D1096,9,11/24/2021,PKO65BG9VO,30,"3020"
D1096,9,11/26/2021,PKQ97T16PL,100,"2920"
D1096,9,11/26/2021,PKQ07T456E,30,"2890"
D1096,9,11/26/2021,PKQ67T6L94,100,"2790"
D1096,9,11/27/2021,PKR49HR0EC,30,"2760"
D1096,9,11/30/2021,PKU9EXUXAT,100,"2660"
D1096,9,11/30/2021,PKU7F01JKR,30,"2630"
D1096,9,11/30/2021,PKU8FF85VY,1,"2629"
D1096,9,12/03/2021,PL37K6DN0P,100,"2529"
D1096,9,12/03/2021,PL38K6HDMU,30,"2499"
D1096,9,12/07/2021,PL74RQZG78,100,"2399"
D1096,9,12/07/2021,PL76RR4Z3A,30,"2369"
D1096,9,12/07/2021,PL72RUFLK4,100,"2269"
D1096,9,12/07/2021,PL77RUJPSX,60,"2209"
D1096,9,12/11/2021,PLB0YXFED6,100,"2109"
D1096,9,12/11/2021,PLB3YXIHD3,50,"2059"
D1096,9,12/11/2021,PLB4YXME6A,100,"1959"
D1096,9,12/11/2021,PLB2YYU25M,100,"1859"
D1096,9,12/11/2021,PLB9Z45TVF,100,"1759"
D1096,9,12/13/2021,PLD82KQCK8,1000,759
D1096,9,12/13/2021,PLD02LPE4O,700,59
D1096,9,12/13/2021,PLD02M527M,59,0
D1096,10,12/16/2021,PLG18CZID5,100,"3800"
D1096,10,12/16/2021,PLG68R2DYM,100,"3700"
D1096,10,12/16/2021,PLG38R77XV,30,"3670"
D1096,10,12/16/2021,PLG68VWQ7W,60,"3610"
D1096,10,12/17/2021,PLH69854KK,60,"3550"
D1096,10,12/18/2021,PLI9BJ5P2R,100,"3450"
D1096,10,12/18/2021,PLI4BJ8HUE,30,"3420"
D1096,10,12/19/2021,PLJ9DI7Y7P,100,"3320"
D1096,10,12/19/2021,PLJ2DIM2MA,30,"3290"
D1096,10,12/21/2021,PLL8H25H8E,100,"3190"
D1096,10,12/21/2021,PLL5H43ELL,100,"3090"
D1096,10,12/21/2021,PLL8H46OOS,60,"3030"
D1096,10,12/24/2021,PLO0LOMFJE,100,"2930"
D1096,10,12/24/2021,PLO5LOPESD,60,"2870"
D1096,10,12/24/2021,PLO2LOTLRU,100,"2770"
D1096,10,12/24/2021,PLO9MTK2YR,60,"2710"
D1096,10,12/24/2021,PLO3MTO265,100,"2610"
D1096,10,12/24/2021,PLO2MTU6CS,100,"2510"
D1096,10,1/11/2022,QAB7G65D7P,2510,0
D1096,11,01/12/2022,QAC0IRAXNE,130,"3770"
D1096,11,01/13/2022,QAE2KSV9V8,130,"3640"
D1096,11,01/14/2022,QAE7LYIFPJ,130,"3510"
D1096,11,01/16/2022,QAG7P2BIIN,100,"3410"
D1096,11,01/16/2022,QAG6P2M6MO,100,"3310"
D1096,11,01/16/2022,QAG1P2IQ5F,60,"3250"
D1096,11,01/18/2022,QAI6REZM1W,130,"3120"
D1096,11,01/18/2022,QAI8SSX0FE,130,"2990"
D1096,11,01/22/2022,QAM7ZJGW4L,90,"2900"
D1096,11,01/22/2022,QAM7ZJMPKV,60,"2840"
D1096,11,01/22/2022,QAM1ZJTZIZ,100,"2740"
D1096,11,01/22/2022,QAM0ZJZDB2,100,"2640"
D1096,11,01/22/2022,QAM9ZK5W7Z,100,"2540"
D1096,11,01/22/2022,QAM8ZKA67A,100,"2440"
D1096,11,01/22/2022,QAM7ZKEUNF,100,"2340"
D1096,11,01/25/2022,QAP747I19D,100,"2240"
D1096,11,01/25/2022,QAP647KDUW,30,"2210"
D1096,11,01/27/2022,QAR87R6JWM,100,"2110"
D1096,11,01/27/2022,QAR97RB527,30,"2080"
D1096,11,02/01/2022,QB18HPXQ6Q,30,"2050"
D1096,11,02/01/2022,QB18HQ38HW,100,"1950"
D1096,11,02/01/2022,QB16HQ9DQU,100,"1850"
D1096,11,02/06/2022,QB64QLDXYW,100,"1750"
D1096,11,02/06/2022,QB63QLIRO7,100,"1650"
D1096,11,02/08/2022,QB88TEQQ4E,1650,0
D1096,12,02/19/2022,QBJ9F0YC85,"1300","3740"
D1096,12,03/02/2022,QC221BY6HS,"2500","1240"
D1096,12,03/04/2022,QC464KV6IM,"1240",0
D1096,13,03/05/2022,QC597LBO01,200,"4680"
D1096,13,03/06/2022,QC65944ITV,100,"4580"
D1096,13,03/06/2022,QC6894CG3Y,100,"4480"
D1096,13,03/06/2022,QC6394LENH,50,"4430"
D1096,13,03/07/2022,QC76BE913S,100,"4330"
D1096,13,03/07/2022,QC75BECAMB,100,"4230"
D1096,13,03/07/2022,QC70BEEO70,50,"4180"
D1096,13,03/08/2022,QC81D8K7S5,100,"4080"
D1096,13,03/08/2022,QC86D8OENY,100,"3980"
D1096,13,03/08/2022,QC80D8RXRC,50,"3930"
D1096,13,03/10/2022,QCA4H62VB2,100,"3830"
D1096,13,03/11/2022,QCB8JAESUM,100,"3730"
D1096,13,03/11/2022,QCB0JAG6SG,100,"3630"
D1096,13,03/12/2022,QCC8KY4V2C,100,"3530"
D1096,13,03/12/2022,QCC4L98F7Y,100,"3430"
D1096,13,03/15/2022,QCF0PHL0OS,100,"3330"
D1096,13,03/19/2022,QCJ9WUN8SN,100,"3230"
D1096,13,03/19/2022,QCJ3WUTTO9,100,"3130"
D1096,13,03/19/2022,QCJ0WVND7E,100,"3030"
D1096,13,03/24/2022,QCO173WRIJ,3030,0
D1096,14,03/24/2022,QCO58IA1GH,250,"4950"
D1096,14,03/26/2022,QCQ8B76Q44,100,"4850"
D1096,14,03/26/2022,QCQ4B7AVNW,100,"4750"
D1096,14,03/26/2022,QCQ9C4VS4P,100,"4650"
D1096,14,03/26/2022,QCQ6C8K5KG,100,"4550"
D1096,14,03/27/2022,QCR4DX6E8U,100,"4450"
D1096,14,03/29/2022,QCT5H9V1S9,100,"4350"
D1096,14,03/29/2022,QCT1HADE07,100,"4250"
D1096,14,03/30/2022,QCU2JD44NE,100,"4150"
D1096,14,03/30/2022,QCU4JD8LF8,100,"4050"
D1096,14,03/31/2022,QCV2KSIF5G,100,"3950"
D1096,14,03/31/2022,QCV9LK3XW5,100,"3850"
D1096,14,04/01/2022,QD11NRVC53,100,"3750"
D1096,14,04/01/2022,QD12NRZNCW,100,"3650"
D1096,14,04/02/2022,QD25Q3P7R7,200,"3450"
D1096,14,04/03/2022,QD38RY4FLW,100,"3350"
D1096,14,04/05/2022,QD57VM9D07,100,"3250"
D1096,14,04/08/2022,QD831JR6I7,100,"3150"
D1096,14,04/08/2022,QD861K5GZ4,100,"3050"
D1096,14,04/13/2022,QDD6CETIDA,100,"2950"
D1096,14,04/14/2022,QDE6E4R3PI,50,"2900"
D1096,14,04/18/2022,QDI2L659IS,1980,920
D1096,14,04/19/2022,QDJ3MQSFGL,920,0
D1096,15,04/20/2022,QDK2OGCNA2,100,"7700"
D1096,15,04/20/2022,QDK1OGGBVD,100,"7600"
D1096,15,04/20/2022,QDK2OGJZ1W,60,"7540"
D1096,15,04/22/2022,QDM7T0GAGV,500,"7040"
D1096,15,04/23/2022,QDN1USHOX9,260,"6780"
D1096,15,04/26/2022,QDQ4ZUF8TW,100,"6680"
D1096,15,04/26/2022,QDQ1ZUKG8R,100,"6580"
D1096,15,04/26/2022,QDQ8ZUPVE8,100,"6480"
D1096,15,05/05/2022,QE56H4I10Q,100,"6380"
D1096,15,05/05/2022,QE50H4LJY0,100,"6280"
D1096,15,05/06/2022,QE68KLH72Q,100,"6180"
D1096,15,05/06/2022,QE69KLJXQF,100,"6080"
D1096,15,05/06/2022,QE68KLMBJ0,100,"5980"
D1096,15,05/06/2022,QE60KLOG7M,100,"5880"
D1096,15,05/06/2022,QE61KLQALN,100,"5780"
D1096,15,05/07/2022,QE73KUYNID,100,"5680"
D1096,15,05/07/2022,QE75KV3BPZ,100,"5580"
D1096,15,05/07/2022,QE74KVHG0U,100,"5480"
D1096,15,05/16/2022,QEG53FSA59,5480,0
D1096,16,05/24/2022,QEO9JL8YOX,"1900","5900"
D1096,16,05/31/2022,QEV0X5UOYO,"1500","4400"
D1096,16,05/31/2022,QEV3XM85RD,400,"4000"
D1096,16,06/09/2022,QF96FYOXR8,1900,"2100"
D1096,16,06/14/2022,QFE8P8IPB6,2100,0
D1096,17,06/22/2022,QFM67C9H4M,950,"8890"
D1096,17,06/23/2022,QFN77XUIU9,"1500","7390"
D1096,17,06/29/2022,QFT1JYY8U1,"2600","4790"
D1096,17,07/06/2022,QG68Y79M9W,4790,0
D1096,18,08/03/2022,QH31KKE3GD,"10400",0
D1096,19,09/01/2022,QI136FE6EX,"10400",0
D1096,20,09/30/2022,QIU9XMPO23,"10400",0
D1096,21,10/21/2022,QJL2BLVBOO,1,"10399"
D1096,21,10/21/2022,QJL3BLZHM7,950,"9449"
D1096,21,10/23/2022,QJN2HHTNJM,"1300","8149"
D1096,21,10/29/2022,QJT9T694KB,8050,99
D1096,21,10/29/2022,QJT5T83A0P,100,1
D1096,22,11/29/2022,QKT3VOCZMJ,"8380","2500"
D1096,22,11/29/2022,QKT5VNVGLN,"2500",0
D1096,23,12/24/2022,QLO7VTWTCT_D2,"2400","8000"
D1096,23,12/28/2022,QLS16M0ZOJ,"8000",0
D1096,24,01/19/2023,RAJ2OX0AQY,"9840",0
D1096,25,01/26/2023,RAQ09JW3CK,400,"10000"
D1096,25,01/28/2023,RAS4EZ9C1I,500,"9500"
D1096,25,01/31/2023,RAV7MBEPCX,260,"9240"
D1096,25,2/1/2023,RB14OFN0W0,400,"8840"
D1096,25,2/17/2023,RBH6U7VGAC,8440,400
D1096,25,2/17/2023,RBH0U7AZF8_D2,400,0
D1096,26,03/18/2023,RCI62ZW0E8,"10400",0
D1096,27,04/15/2023,RDF57S7Z1R,"10350",30
D1096,28,04/15/2023,RDF57S7Z1R_D2,30,"10290"
D1096,28,04/20/2023,RDK9LC69SN,100,"10190"
D1096,28,05/13/2023,RED6G0MBU2,"10190",0
D1096,29,05/15/2023,REF4N3YFKE,200,"12440"
D1096,29,06/13/2023,RFD7XYQH4N,500,"11940"
D1096,29,06/13/2023,RFD3Z7YIT5,500,"11440"
D1096,29,6/28/2023,RFS26BLLUI,300,"11140"
D1096,29,07/05/2023,RG58RH4CQW,500,"10640"
D1096,29,07/17/2023,RGH3QQ3JUT,200,"10440"
D1096,29,08/04/2023,RH4682VYNI,200,"10240"
D1096,29,08-10-2023 0:00:00,RHA7RY8J3L,300,"9940"
D1096,29,08-09-2023 0:00:00,RH94MQDDGO,350,"9590"
D1096,29,8/15/2023,RHF479VG92,300,"9290"
D1096,29,08-12-2023 0:00:00,RHC2YA01HA,300,"8990"
D1096,29,08-11-2023 0:00:00,RHB3V4S6W7,300,"8690"
D1096,29,08/16/2023,RHG8B0EIV4,300,"8390"
D1097,1,02/27/2021,PBR64MB31K,"6600","1000"
D1097,2,03/03/2021,PC309XGAA2,"5500","5700"
D1097,2,03/03/2021,PC36A3BC6O,"5000",700
D1097,2,03/04/2021,PC47B87CQ3,"2500","1800"
D1097,3,03/19/2021,PCJ3UMDN0P,"26000","3000"
D1097,4,02/27/2021,PBR64MB31K_D2,"1000","38000"
D1097,4,03/04/2021,PC47B87CQ3_D2,1800,"36200"
D1097,4,03/29/2021,PCJ3UMDN0P_D2,3000,"33200"
D1097,4,04/16/2021,PDG0VY18W4,33300,100
D1097,5,05/15/2021,PEF6Z48XQK,"18200","22600"
D1097,5,05/15/2021,PEF6Z4W816,2000,"20600"
D1097,5,05/15/2021,PEF4ZOZ4SS,3000,"17600"
D1097,5,05/17/2021,PEH925W60T,14100,"3500"
D1097,5,05/17/2021,PEH12CCDY3,"3500",0
D1097,6,06/15/2021,PFF56C28ST,"39000",0
D1097,7,07/14/2021,PGE0C77CNO,"22200","18600"
D1097,7,07/15/2021,PGF8D69E0Q,18600,0
D1097,8,08/13/2021,PHD2K55HZ0,"39000",0
D1097,9,09/11/2021,PIB3RA7ICT,"39000",0
D1097,10,10/14/2021,PJE08AB1BY,"40800",0
D1097,11,12/31/2021,PLV2WHXCYY,"16000","49000"
D1097,11,01/06/2022,QA6988M3DZ,40000,"9000"
D1097,11,01/06/2022,QA628X8X0U,7400,"1600"
D1097,11,01/07/2022,QA739B5QHF,1600,0
D1097,12,02/04/2022,QB40M1UWG4,"17000","48000"
D1097,12,02/04/2022,QB45MMU5JR,48000,0
D1097,13,03/05/2022,QC555LM90X,"46000","19000"
D1097,13,02/05/2022,QC546U73CG,2600,"16400"
D1097,13,02/05/2022,QC586Y5I8M,16400,0
D1097,14,04/08/2022,QD891JVT45,"66000","2000"
D1097,14,04/08/2022,QD831KNIXN,2000,0
D1097,15,05/17/2022,QEH65XUK30,"2000","77000"
D1097,15,05/18/2022,QEI182KO9X,2000,"75000"
D1097,15,05/21/2022,QEL2DOBDO2,5200,"69800"
D1097,15,05/28/2022,QES5QON3PJ,5100,"64700"
D1097,15,06/03/2022,QF324Y0GJ4,5000,"59700"
D1097,15,06/17/2022,QFH5V0X9FR,2000,"57700"
D1097,15,06/20/2022,QFK52SMIVJ,3000,"54700"
D1097,15,06/30/2022,QFU3LV1OJ7,1000,"53700"
D1097,15,07/08/2022,QG823ODYLC,1000,"52700"
D1097,15,07/13/2022,QGD4E2LDMM,1500,"51200"
D1097,15,07/23/2022,QGN5XB0QG9,3000,"48200"
D1097,15,07/28/2022,QGS28A6J9U,2000,"46200"
D1097,15,08/30/2022,QHU0278ABW,2000,"44200"
D1097,15,09/15/2022,QIF6ZO7S48,3000,"41200"
D1098,1,03/10/2021,PCA5J74BB3,"1000","14800"
D1098,1,03/16/2021,PCG9QQ3383,"1000","13800"
D1098,1,03/17/2021,PCH2SN2BTY,"1000","12800"
D1098,1,03/19/2021,PCJ4VDPDO8,500,"12300"
D1098,1,4/6/2021,PD67IVISIT,490,"11810"
D1098,1,4/7/2021,PD72KP311C,510,"11300"
D1098,1,04/09/2021,PD90MAV7L4,500,"10800"
D1098,1,04/09/2021,PD96NB9NCS,500,"10300"
D1098,1,04/12/2021,PDC2QPS2HY,600,"9700"
D1098,1,04/14/2021,PDE7TRA4GV,500,"9200"
D1098,1,04/17/2021,PDH0WVRMMG,500,"8700"
D1098,1,04/20/2021,PDK91YJO3D,500,"8200"
D1098,1,05/03/2021,PE31IM2G2V,500,"7700"
D1098,1,06/03/2021,PF39OB13NR,500,"7200"
D1098,1,06/07/2021,PF72UF32M0,500,"6700"
D1098,1,06/08/2021,PF87WAF5AZ,500,"6200"
D1098,1,06/28/2021,PFS2OUMOD4,1000,"5200"
D1098,1,07/05/2021,PG56YX1EQI,500,"4700"
D1098,1,07/07/2021,PG732RRFMP,500,"4200"
D1098,1,07/16/2021,PGG1F7E3W5,700,"3500"
D1098,1,07/21/2021,PGL2MMBBSI,500,"3000"
D1098,1,07/29/2021,PGT8X49SKY,500,"2500"
D1098,1,08/03/2021,PH375BZ4SJ,500,"2000"
D1098,1,08/05/2021,PH5694KA62,500,"1500"
D1098,1,08/10/2021,PHA4FF0RI4,550,950
D1098,1,08/17/2021,PHH0PMQ5KM,550,400
D1098,1,08/18/2021,PHI8R0N9RC,400,0
D1099,1,03/08/2021,PC86H80KU6,"1625","4875"
D1099,1,03/15/2021,PCF2Q43P4U,"1625","3250"
D1099,1,03/24/2021,PCN0ZF7O40,"1625","1625"
D1099,1,03/29/2021,PCT78RZVSX,"1625",0
D1099,2,06/05/2021,PF53R374BV,"1625","4625"
D1099,2,06/11/2021,PFB91BLI0N,"1625","3000"
D1099,2,06/18/2021,PFI8AQHNQQ,"3000",0
D1099,3,06/29/2021,PFT4P7IF3G,"1625","4775"
D1099,3,07/05/2021,PG58XRKQFW,"1625","3150"
D1099,3,07/14/2021,PGE4BNZLEU,"3150",0
D1099,4,07/28/2021,PGS2VQ5MWG,"2275","6685"
D1099,4,08/07/2021,PH73BC3SYZ,"2275","4410"
D1099,4,08/07/2021,PH78C6K1E0,"2275","2135"
D1099,4,08/09/2021,PH91EEEBPD,2135,0
D1099,5,08/21/2021,PHL4V7OQWE,"2275","6825"
D1099,5,08/31/2021,PHV8BE3HU8,"2275","4550"
D1099,5,09/06/2021,PI69K68C7V,"4550",0
D1099,6,09/25/2021,PIO5CD9K4R,"2275","6825"
D1099,6,10/01/2021,PJ15N4P0SP,"2275","4550"
D1099,6,10/09/2021,PJ90ZNQYP2,"2275","2275"
D1099,6,10/12/2021,PJC75SM917,2275,0
D1099,7,02/06/2022,QB62R1TU6O,"8890",0
D1099,8,03/08/2022,QC89BHS7RT,"9100",0
D10100,1,03/08/2021,PC82GP4O94,"1625","4875"
D10100,1,03/25/2021,PCP03V1PVE,980,"3895"
D10100,1,03/27/2021,PCR75J0GEN,"1000","2895"
D10100,1,03/29/2021,PCT28B3B36,850,"2045"
D10100,1,3/29/2021,PCT68NOSVM,2050,5
D10100,2,04/08/2021,PD84LDPRFI,430,"6070"
D10100,2,04/09/2021,PD93NCTYPF,"1200","4870"
D10100,2,04/15/2021,PDF0UFY2P4,"1625","3245"
D10100,2,04/22/2021,PDM93ZDDRN,1620,"1625"
D10100,2,04/23/2021,PDN95SXE45,1625,0
D10100,3,05/05/2021,PE53L2GDTR,"1625","4875"
D10100,3,05/16/2021,PEG4ZVH0KG,"1625","3250"
D10100,3,05/19/2021,PEJ64MR9G8,"3250",0
D10100,4,06/07/2021,PF74TT00CE,"1600","4900"
D10100,4,06/16/2021,PFG77EIYAJ,"4900",0
D10101,1,04/01/2021,PD12C76WKK,"19500",0
D10101,2,05/03/2021,PE33IZYCMR,"20400",0
D10101,3,06/02/2021,PF28NJDBIE,"20400",0
D10101,4,07/07/2021,PG782V7NLO,"7000","20200"
D10101,4,07/08/2021,PG81371QLN,"20200",0
D10101,5,08/05/2021,PH538GTXAH,"25800",0
D10101,6,09/02/2021,PI22E79CUU,"25800",0
D10101,7,10/01/2021,PJ19M2VY2X,"26000",0
D10101,8,11/04/2021,PK406R93HS,"27200",0
D10101,9,12/02/2021,PL23IK99QB,"10000","16000"
D10101,9,12/03/2021,PL34JKAJ9M,"16000",0
D10101,10,12/30/2021,PLU8V26O46,"25600",0
D10101,11,01/28/2022,QAS7A8RIIL,"26000",0
D10101,12,02/27/2022,QBR7TVST3H,"7000","20200"
D10101,12,02/28/2022,QBS5W8Z8V1,"10000","10200"
D10101,12,03/02/2022,QC26ZG6LO4,"3000","7200"
D10101,12,03/06/2022,QC649FI03Y,3500,"3700"
D10101,12,03/07/2022,QC76B3D1QW,2000,"1700"
D10101,12,03/08/2022,QC80DF0VJM,1700,0
D10101,13,05/09/2022,QE97Q1DJPX,"5000","8000"
D10101,13,05/11/2022,QEB6SUZEUE,"8000",0
D10101,14,05/18/2022,QEI78R9VM5,"7000","10550"
D10101,14,05/19/2022,QEJ6AIXQF4,"3000","7550"
D10101,14,05/26/2022,QEQ7MEVA0Z,"7550",0
D10101,15,05/31/2022,QEV5WJGPQR,"5000","12250"
D10101,15,06/02/2022,QF211ECO19,"5000","7250"
D10101,15,06/08/2022,QF85DC1JIR,"7250",0
D10101,16,06/13/2022,QFD3OTTCO5,"7000","25250"
D10101,16,06/17/2022,QFH6WUPI24,"4000","21250"
D10101,16,06/27/2022,QFR7GDBOA3,"10000","11250"
D10101,16,07/01/2022,QG12OUPMF6,4000,"7250"
D10101,16,07/06/2022,QG66YF54K8,7250,0
D10101,17,07/19/2022,QGJ4R72PKI,"10000","16000"
D10101,17,07/21/2022,QGL0UUDULG,"5000","11000"
D10101,17,07/30/2022,QGU8D6DI8K,"2500","8500"
D10101,17,08/02/2022,QH27J4QEVN,3000,"5500"
D10101,17,08/04/2022,QH46MJLKJK,5500,0
D10101,18,08/20/2022,QHK9HHTT6V,"15000","9000"
D10101,18,08/20/2022,QHK0IPKVAQ,"9000",0
D10101,19,09/15/2022,QIF0176MQ8,"20000","12250"
D10101,19,09/16/2022,QIG537LJ37,"12250",0
D10101,20,10/07/2022,QJ72FFSH0M,"30750",0
D10101,21,10/19/2022,QJJ78FKMWP,"10000","15600"
D10101,21,11/03/2022,QK376SAKAN,"15600",0
D10101,22,12/03/2022,QL389CDGM6,"25800",0
D10101,23,12/19/2022,QLJ9IIIDIT,"29250",0
D10101,24,01/10/2023,RAA83U3EVC,"17700",0
D10101,25,02/02/2023,RB28RQWDIM,"10000","2400"
D10101,25,02/06/2023,RB633E85X5,"2400",0
D10102,1,03/13/2021,PCD8NKB2Y8,"3250","10350"
D10102,1,03/22/2021,PCM2XZCXQS,"1625","8725"
D10102,1,03/25/2021,PCP62PH3MM,"1625","7100"
D10102,1,04/01/2021,PD14BYZTTG,"2000","5100"
D10102,1,4/4/2021,PD47G69K29,4500,600
D10102,1,4/6/2021,PD61ICFVF5,600,0
D10102,2,04/15/2021,PDF1UKW77F,"3250","10350"
D10102,2,04/22/2021,PDM14EIA0Z,"1625","8725"
D10102,2,04/27/2021,PDR0AOF1KU,"3250","5475"
D10102,2,05/05/2021,PE59LJHOMB,5475,0
D10102,3,05/15/2021,PEF7Z49WE3,"1450","11550"
D10103,1,03/16/2021,PCG0REQ86Y,"1325","4275"
D10103,1,03/18/2021,PCI6TKXV3U,"1300","2975"
D10103,1,03/18/2021,PCI9TP62WF,"2975",0
D10103,2,03/26/2021,PCQ456L660,"1625","4875"
D10103,2,04/06/2021,PD67J0VI8L,"1625","3250"
D10103,2,04/10/2021,PDA6NVEAOO,"1625","1625"
D10103,2,04/14/2021,PDF1TXTPPF,1625,0
D10103,3,04/23/2021,PDN668EUJE,"1160","5340"
D10103,3,05/03/2021,PE30J17MFG,"1960","3380"
D10103,3,05/07/2021,PE75O702EX,"1700","1680"
D10103,3,05/07/2021,PE79OF8WPZ,1680,0
D10103,4,05/14/2021,PEE6XMNK4E,"1900","6860"
D10103,4,06/16/2021,PFG17W2NST,300,"6560"
D10103,4,06/17/2021,PFH39RQAAV,300,"6260"
D10103,4,06/18/2021,PFI3B4MPKB,100,"6160"
D10103,4,06/18/2021,PFI5B4T68H,100,"6060"
D10103,4,06/18/2021,PFI1B4YX1D,100,"5960"
D10103,4,06/24/2021,PFO4J7F9MM,"3000","2960"
D10103,4,06/28/2021,PFS5OSNLIB,1950,"1010"
D10103,4,06/29/2021,,1010,0
D10104,1,03/24/2021,PCO82M65ZS,"1625","4875"
D10104,1,03/31/2021,PCV6BGA3WO,"1625","3250"
D10104,1,04/07/2021,PD71KNI8DJ,"1625","1625"
D10104,1,04/12/2021,PDC1QDIK8V,"1625",0
D10104,2,04/20/2021,PDJ013OJ9O,"1625","4875"
D10104,2,04/26/2021,PDQ89S5OKW,"3000","1875"
D10104,2,04/26/2021,PDQ19SOW21,"1875",0
D10104,3,05/03/2021,PE38JFGEMM,"2275","6825"
D10104,3,05/11/2021,PEB9TG45HX,"2275","4550"
D10104,3,05/17/2021,PEH034QBKQ,"2275","2275"
D10104,3,05/18/2021,PEI13MLOGP,2275,0
D10104,4,05/27/2021,PER7FJ6YDZ,"2275","6825"
D10104,4,06/01/2021,PF16LWYCIO,"2275","4550"
D10104,4,06/08/2021,PF84VYXGU0,"4550",0
D10104,5,06/16/2021,PFG87WBJHM,"2600","7800"
D10104,5,06/22/2021,PFM1GGI2PT,"2600","5200"
D10104,5,06/29/2021,PFT9PM1GX7,"5200",0
D10104,6,07/06/2021,PG631ESE7T,"3250","9750"
D10104,6,07/14/2021,PGE4BUIVMW,"9750",0
D10105,1,04/01/2021,PD12C76WKK_D2,975,"3105"
D10105,1,04/12/2021,PDC3QLTCTL,975,"2130"
D10105,1,04/19/2021,PDJ5ZARP2V,975,"1155"
D10105,1,04/22/2021,PDM34BAG61,"1155",0
D10105,2,05/03/2021,PE35IWV8MT,975,"2925"
D10105,2,05/07/2021,PE78OIOB56,975,"1950"
D10105,2,05/18/2021,PEI53ISMPT,975,975
D10105,2,05/20/2021,PEK56570SJ,975,0
D10105,3,05/28/2021,PES8GPHQ2M,975,"2925"
D10105,3,06/12/2021,PFC526N261,975,"1950"
D10105,3,06/04/2021,PF40QE729W,975,975
D10105,3,06/17/2021,PFH98N4PIL,975,0
D10105,4,06/25/2021,PFP2JDKM1W,"1625","4875"
D10105,4,07/03/2021,PG38V839H0,800,"4075"
D10105,4,07/10/2021,PGA86QLVFO,820,"3255"
D10105,4,07/12/2021,PGC88VGCSS,800,"2455"
D10105,4,07/05/2021,PG51XWB6NB,800,"1655"
D10105,4,07/15/2021,PGF9D9N09F,1655,0
D10105,5,07/22/2021,PGM8N5TPCE,"1625","4875"
D10105,5,07/31/2021,PGV7ZWWDCN,900,"3975"
D10105,5,08/02/2021,PH213UC5YH,700,"3275"
D10105,5,08/07/2021,PH79C2K3ZR,1050,"2225"
D10105,5,08/11/2021,PHB4H2YH04,500,"1725"
D10105,5,08/12/2021,PHC2IUKNX8,1725,0
D10105,6,08/19/2021,PHJ6SUH9I4,"1450","5050"
D10105,6,08/24/2021,PHO4ZO5YCE,"1100","3950"
D10105,6,08/28/2021,PHS267UZNQ,700,"3250"
D10105,6,09/03/2021,PI36F4R10O,1600,"1650"
D10105,6,09/09/2021,PI98O5L9YA,1650,0
D10105,7,09/16/2021,PIG4Z4K48I,"1600","4900"
D10105,7,09/24/2021,PIO4BVIZHW,"1350","3550"
D10105,7,09/28/2021,PIS1HIRSXN,500,"3050"
D10105,7,10/01/2021,PJ13MBIM4L,1450,"1600"
D10105,7,10/05/2021,PJ51SQV98J,1625,25
D10105,8,10/13/2021,PJD06YM7CO,"1625","4875"
D10105,8,10/19/2021,PJJ0G3KTKM,"1400","3475"
D10105,8,10/27/2021,PJR8SL1PZI,"1600","1875"
D10105,8,11/02/2021,PK2239K8YI,1875,0
D10105,9,11/11/2021,PKB3I3BW1D,"1625","4875"
D10105,9,11/16/2021,PKG7PZEYUT,950,"3925"
D10105,9,11/17/2021,PKH4S47L7M,525,"3400"
D10105,9,11/27/2021,PKR29MFOD4,1400,"2000"
D10105,9,11/29/2021,PKT3D83X5B,2000,0
D10106,1,03/31/2021,PCV7AQ49ZD,"3250","9750"
D10106,1,04/08/2021,PD82LGMR88,"3250","6500"
D10106,1,04/14/2021,PDE9TDGZV5,"3250","3250"
D10106,1,04/22/2021,PDL43N6FT8,"3250",0
D10106,2,05/18/2021,PEI03WR9ZO,"3250","9050"
D10106,2,05/26/2021,PEQ4EPL5IG,"3250","5800"
D10106,2,06/01/2021,PF11MDWZ8V,"5800",0
D10106,3,06/08/2021,PF85VZ7GXX,"4875","13575"
D10106,3,06/16/2021,PFG57H9LB5,"4875","8700"
D10106,3,06/23/2021,PFN9HAYNGJ,"8700",0
D10106,4,06/30/2021,,"16800",0
D10106,5,07/28/2021,PGS5VHFF3T,"17550",0
D10106,6,08/04/2021,PH466GY9N8,"4875","14625"
D10106,6,08/12/2021,PHC1J5DH25,"4875","9750"
D10106,6,08/21/2021,PHL4W7VT1Y,"4875","4875"
D10106,6,08/25/2021,PHP01KRAU2,4875,0
D10106,7,09/06/2021,PI62KQ9BVA,"19000","4200"
D10106,7,09/09/2021,PI96P7EE5G,"4200",0
D10106,8,09/28/2021,PIS4HGCPLS,"4500","8500"
D10106,8,10/06/2021,PJ68UILXW4,"4000","4500"
D10106,8,10/09/2021,PJ99ZEUOS3,"4500",0
D10106,9,10/21/2021,PJL1J0L7IL,"3250","9750"
D10106,9,10/29/2021,PJT4VZ8NFM,"3250","6500"
D10106,9,11/03/2021,PK324NIJ9O,"3250","3250"
D10106,9,11/06/2021,PK669OSOLA,3250,0
D10106,10,11/25/2021,PKP860IQKS,"12100",0
D10106,11,02/21/2022,QBL6IRM4S2,"4060",0
D10106,12,05/19/2023,,"11200",0
D10106,13,05/15/2023,REF0LNZB50,"11200",0
D10106,14,08/07/2023,RH74HYOJTG,"26000",0
D10107,1,04/03/2021,PD39EGRO4J,"4000","7400"
D10107,1,04/05/2021,PD53HY1S4T,"7400",0
D10107,2,04/16/2021,PDG0VRD3M4,"2550","8950"
D10107,2,04/17/2021,PDH1WMOFT9,700,"8250"
D10107,2,04/20/2021,PDK51Y1YYV,"8250",0
D10107,3,04/28/2021,PDS7C5F6F9,"3900","10740"
D10107,3,05/04/2021,PE49KII4W7,"2200","8540"
D10107,3,05/10/2021,PEA3S40X8Z,"8540",0
D10107,4,05/27/2021,PER2FBUJ8Y,"1850","13750"
D10107,4,06/07/2021,PF78UI9H8Q,"13750",0
D10107,5,07/06/2021,PG67Z5MDVL,"7000","10220"
D10107,5,07/16/2021,PGG3EXD6NT,"10220",0
D10107,1,04/05/2021,PD59H7QLAD,"1625","4875"
D10108,1,04/13/2021,PDD5RNYEZH,"1625","3250"
D10108,1,04/16/2021,PDG0VJT5B0,"1625","1625"
D10108,1,04/17/2021,PDH6WW5PRK,"1625",0
D10108,2,04/26/2021,PDQ1930J0F,"1625","4875"
D10108,2,05/06/2021,PE61NM1QWR,"3250","1625"
D10108,2,05/08/2021,PE81PHZJB9,"1625",0
D10108,3,05/24/2021,PEO0AYMKMC,"2300","6800"
D10108,3,05/24/2021,PEO5AYPMX1,"1600","5200"
D10108,3,06/04/2021,PF45Q8NQQV,"5200",0
D10108,4,06/28/2021,PFS5NTUU0X,"2000","7100"
D10108,4,06/30/2021,PFU8QEQI2C,"1000","6100"
D10108,4,07/02/2021,PG24TM60HK,"6100",0
D10108,5,07/09/2021,PG945J481M,"2000","7100"
D10108,5,07/17/2021,PGH7GGKR7V,"7100",0
D10108,6,08/05/2021,PH598KCBHB,"2000","7100"
D10108,6,08/10/2021,PHA5F9L5FP,"3400","3700"
D10108,6,08/12/2021,PHC1IXFPTV,"1100","2600"
D10108,6,08/14/2021,PHE6L8VNQW,2600,0
D10108,7,08/23/2021,PHN7XTVW1B,"5000","2848"
D10108,7,08/23/2021,PHN4YS3FEA,"2848",0
D10108,8,10/22/2021,PJM9KLLYIZ,"2275","6825"
D10108,8,11/01/2021,PK162V4WAM,"2275","4550"
D10108,8,11/09/2021,PK99EQMM05,"2000","2550"
D10108,8,11/11/2021,PKB3IFJE7P,2550,0
D10108,9,11/19/2021,PKJ1VQGTJZ,"2000","7100"
D10108,9,11/30/2021,PKU8ENP5N8,"1000","6100"
D10108,9,12/09/2021,PL92UGY3A4,"6100",0
D10108,10,12/28/2021,PLS7S2YS9B,"2000","7100"
D10108,10,01/06/2022,QA697P6ZSD,"7100",0
D10108,11,01/28/2022,QAS39QERV1,"8610",0
D10108,12,23/02/2022,QBN2LOXR5,"9000",40
D10108,13,03/15/2022,QCF2PFY4BI,"6000","6900"
D10108,13,03/22/2022,QCM332K31T,6900,0
D10108,14,03/22/2022,QCM944QADH,500,"11900"
D10108,14,03/23/2022,QCN66KTPD8,500,"11400"
D10108,14,04/07/2022,QD74Z51DV4,500,"10900"
D10108,14,04/10/2022,QDA36O75ID,1000,"9900"
D10108,14,04/12/2022,QDC791MSKR,1500,"8400"
D10108,14,04/13/2022,QDD6BW3H30,8400,0
D10108,15,05/04/2022,QE47FFF9AN,"12200",0
D10108,16,05/30/2022,QEU8VB2MHA,"15360",0
D10108,17,06/20/2022,QFK9376DTV,"14750",0
D10108,18,07/18/2022,QGI7P8APYP,"15480",0
D10108,19,08/12/2022,QHC23UTS52,"4000","11480"
D10108,19,08/15/2022,QHF59C9RH1,11480,0
D10108,20,09/13/2022,QID6VS9O7C,"15480",0
D10108,21,10/12/2022,QJC0QQOOGE,"16320",0
D10108,22,11/07/2022,QK71FLRN69,"15360",0
D10108,23,12/06/2022,QL62HNY31O,"16320",0
D10108,24,01/03/2023,RA34LZD48S,"15600",0
D10108,25,01/30/2023,RAU0HZ7EOS,"15360",0
D10108,26,02/27/2023,RBR3LQZ8NP,"15600",0
D10108,27,03/27/2023,RCR5PTLPZF,"15600",0
D10108,28,05/01/2023,RE15HT5SDD,"1000","17960"
D10108,28,06/01/2023,RF17XLMIY9,200,"17760"
D10108,28,06/30/2023,RFU6CCYVZM,100,"17660"
D10108,28,07/26/2023,RGQ0GBDTQ0,100,"17560"
D10108,28,07/27/2023,RGR8KGCBY0,100,"17460"
D10108,28,07/29/2023,RGT9OY74Q9,100,"17360"
D10108,28,07/31/2023,RGV1VRV5UH,100,"17260"
D10108,28,08/04/2023,RH427QGHF6,100,"17160"
D10108,28,08/08/2023,RH87JWA2PJ,100,"17060"
D10108,28,08/15/2023,RHF260IYFY,100,"16960"
D10108,28,08/21/2023,RHL1NAFWMJ,100,"16860"
D10109,1,04/04/2021,PD44GHXXVY,"3250","9750"
D10109,1,04/15/2021,PDF0ULV8KA,500,"9250"
D10109,1,04/19/2021,PDJ317J8DP,"1350","7900"
D10109,1,04/26/2021,PDQ09P7G1M,"7900",0
D10109,2,05/11/2021,PEB7TI2U3F,"1900","11100"
D10109,,05/17/2021,PEH427A7FS,"3300","7800"
D10109,2,05/24/2021,PEO0BNCIEM,"7800",0
D10109,3,06/21/2021,PFL9EB035L,"15600",0
D10109,4,07/19/2021,PGJ4IYOQ2U,"15600",0
D10109,5,08/17/2021,PHH9POTTI9,"15600",0
D10109,6,09/03/2021,PI31G752PL,650,"18850"
D10109,6,09/04/2021,PI40HSJC0O,70,"18780"
D10109,6,09/11/2021,PIB3RXKCD3,800,"17980"
D10109,6,09/15/2021,PIF4XCRIHM,17980,0
D10109,7,10/14/2021,PJE98ND21H,"19350",150
D10109,7,10/14/2021,PJE18P338J,100,50
D10109,7,10/14/2021,PJE28PNG32,50,0
D10109,8,11/12/2021,PKC5JN2DJT,"19500",0
D10109,9,12/15/2021,PLF06K0SIS,800,"22900"
D10109,9,12/18/2021,PLI5CHH62B,400,"22500"
D10109,9,12/22/2021,PLM2IVV7RI,800,"21700"
D10109,9,01/13/2022,QAD3J50J4B,500,"21200"
D10109,9,02/16/2022,QBG69IQ5XU,300,"20900"
D10109,9,02/24/2022,QBO8NRLI54,250,"20650"
D10109,9,03/23/2022,QCN869NX52,287,"20363"
D10110,1,04/10/2021,PDA4OHQG10,"4875","14625"
D10110,1,04/17/2021,PDH1XB0HWX,"4875","9750"
D10110,1,04/24/2021,PDO46TS51A,"4875","4875"
D10110,1,05/01/2021,PE18GPLAXS,"4875",0
D10110,2,06/08/2021,PF85VFGLGB,"2500","41300"
D10110,2,06/11/2021,PFB51GV601,"2000","39300"
D10110,2,06/21/2021,PFL3E1DSC5,"39300",0
D10110,2,08/12/2021,PHC8IOT4HG,"3250","9750"
D10110,3,08/19/2021,PHJ3SRFW79,"3250","6500"
D10110,3,08/26/2021,PHQ33S6TDT,"1800","4700"
D10110,3,08/26/2021,PHQ13SGRX9,1450,"3250"
D10110,3,08/31/2021,PHV1AJ2A4B,3250,0
D10110,4,09/07/2021,PI77LI8SY3,"3250","9750"
D10110,4,09/14/2021,PIE0WPV6Y2,"3250","6500"
D10110,4,09/21/2021,PIL37T8DO7,"3250","3250"
D10110,4,09/24/2021,PIO0BJI1NI,3250,0
D10110,5,10/01/2021,PJ17NHIBC1,"3900","11700"
D10110,5,10/08/2021,PJ84YQ8O1G,"3900","7800"
D10110,5,10/15/2021,PJF3AHOE7B,"3900","3900"
D10110,5,10/16/2021,PJG4BF9QEY,3900,0
D10110,6,10/25/2021,PJP9PXWZV3,"3900","11700"
D10110,6,11/02/2021,PK223YPFZU,"3900","7800"
D10110,6,11/13/2021,PKD8L5AK3Y,"7800",0
D10110,7,12/01/2021,PL19G5UP5X,"4000","12320"
D10110,7,12/10/2021,PLA1X0ZBPR,"1000","11320"
D10110,7,12/21/2021,PLL4G9WRRS,"5000","6320"
D10110,7,12/22/2021,PLM6I6DJMI,6320,0
D10110,8,03/29/2022,QCT4GHUOK2,"15500",100
D10110,8,03/29/2022,QCT9GIPPPF,100,0
D10110,9,05/04/2022,QE42EQF9K8,"2000","16960"
D10110,9,05/10/2022,QEA7RCZOJF,"1000","15960"
D10110,9,05/11/2022,QEB7T4JZJ1,"2000","13960"
D10110,9,05/18/2022,QEI97CWLRF,550,"13410"
D10110,9,05/20/2022,QEK8AS6MFM,500,"12910"
D10110,9,06/04/2022,QF425D3K10,4000,"8910"
D10110,9,06/08/2022,QF86EO2YES,1000,"7910"
D10110,9,06/16/2022,QFG0U3BHI6,750,"7160"
D10110,9,06/21/2022,QFL64YYXB0,660,"6500"
D10110,9,07/05/2022,QG56W9DGN8,300,"6200"
D10110,9,07/12/2022,QGC5CPAEC7,500,"5700"
D10110,9,07/21/2022,QGL7UJADFP,500,"5200"
D10110,9,07/29/2022,QGT2AKE1OI,500,"4700"
D10110,9,08/20/2021,QHK9IDMQR3,250,"4450"
D10110,9,08/21/2022,QHL9K9RYOZ,400,"4050"
D10110,9,08/22/2022,QHM6LS7G7W,300,"3750"
D10110,9,09/03/2022,QI35BBHIZN,2000,"1750"
D10110,9,09/09/2022,QI96NRKYPC,250,"1500"
D10110,9,09/21/2022,QIL5EPHC9X,250,"1250"
D10110,9,09/27/2022,QIR7RN792J,500,750
D10110,9,09/29/2022,QIT6VME5L8,750,0
D10111,1,04/15/2021,PDF8UGRTVU,"1650","4850"
D10111,1,04/21/2021,PDL338JV25,"1600","3250"
D10111,1,04/23/2021,PDN85O3RZ4,"3250",0
D10111,2,05/04/2021,PE45JSIJ0L,900,"5600"
D10111,2,05/17/2021,PEH32NWJLB,"5600",0
D10111,3,07/13/2021,PGD4ABPCV0,100,"9380"
D10111,3,07/13/2021,PGD9ABS8FR,20,"9360"
D10111,3,07/14/2021,PGE9C5UZSJ,500,"8860"
D10111,3,09/02/2021,PI21DZZDAF,100,"8760"
D10111,3,09/02/2021,PI22E01DSG,100,"8660"
D10112,1,04/08/2021,PD81LYC4L9,100,"6400"
D10112,1,04/08/2021,PD86LYH7IO,17,"6383"
D10112,1,04/08/2021,PD89LYSMDL,100,"6283"
D10112,1,04/10/2021,PDA0NG5CLI,100,"6183"
D10112,1,04/10/2021,PDA8NG5HUC,17,"6166"
D10112,1,04/10/2021,PDA0NG5IYY,100,"6066"
D10112,1,04/12/2021,PDC3Q0ZPKH,350,"5716"
D10112,1,04/12/2021,PDC5Q3TIVD,90,"5626"
D10112,1,04/13/2021,PDC0R7IY2W,100,"5526"
D10112,1,04/13/2021,PDC5R7M05T,100,"5426"
D10112,1,04/13/2021,PDC8R7OGNG,17,"5409"
D10112,1,04/14/2021,PDE5SY4KAT,217,"5192"
D10112,1,04/15/2021,PDF4UL6DQI,217,"4975"
D10112,1,04/16/2021,PDG7VHMNHR,100,"4875"
D10112,1,04/16/2021,PDG7VHQADP,100,"4775"
D10112,1,04/16/2021,PDG0VIN95Y,17,"4758"
D10112,1,04/17/2021,PDH0WKHLBE,100,"4658"
D10112,1,04/17/2021,PDH5WKLQKB,100,"4558"
D10112,1,04/17/2021,PDH0WKO702,17,"4541"
D10112,1,04/19/2021,PDJ3Z943HZ,100,"4441"
D10112,1,04/19/2021,PDJ8Z986O6,100,"4341"
D10112,1,04/19/2021,PDJ9Z9G5JF,100,"4241"
D10112,1,04/19/2021,PDJ1Z9JRY7,100,"4141"
D10112,1,04/19/2021,PDJ6Z9M3AC,34,"4107"
D10112,1,04/20/2021,PDK12EOBWX,100,"4007"
D10112,1,04/21/2021,PDL236BITA,334,"3673"
D10112,1,04/22/2021,PDM650MBUI,100,"3573"
D10112,1,04/22/2021,PDM950OWCL,80,"3493"
D10112,1,04/23/2021,PDN75DI8ET,100,"3393"
D10112,1,04/23/2021,PDN95DP803,90,"3303"
D10112,1,04/24/2021,PDO471ZUEW,100,"3203"
D10112,1,04/25/2021,PDP38WAYCH,100,"3103"
D10112,1,04/25/2021,PDP38WDG63,40,"3063"
D10112,1,04/26/2021,PDQ89AWD9K,100,"2963"
D10112,1,04/26/2021,PDQ3A9LDRN,100,"2863"
D10112,1,04/28/2021,PDS0BT8CU0,400,"2463"
D10112,1,05/01/2021,PE16FXHOES,100,"2363"
D10112,1,05/01/2021,PE19FXK20J,100,"2263"
D10112,1,05/01/2021,PE13FXMCND,100,"2163"
D10112,1,05/05/2021,PE56L6WQUG,2163,0
D10112,2,05/20/2021,PEK35WWJ87,"1000","5500"
D10112,2,05/28/2021,PES4GXJUWO,"1000","4500"
D10112,2,06/03/2021,PF31OYJ3DD,"3930",570
D10112,2,06/03/2021,PF31P0VWW1,570,0
D10112,3,06/18/2021,PFI2B5OQNI,820,"5980"
D10112,3,06/21/2021,PFL5F378N9,100,"5880"
D10112,3,06/21/2021,PFL3F39SVR,100,"5780"
D10112,3,06/21/2021,PFL7F3C7Z5,100,"5680"
D10112,3,06/21/2021,PFL0F3IF72,100,"5580"
D10112,3,06/22/2021,PFM8GEPBGG,100,"5480"
D10112,3,06/22/2021,PFM7GES5F9,100,"5380"
D10112,3,06/22/2021,PFM2GEUEUS,100,"5280"
D10112,3,06/28/2021,PFS9OUHDIR,100,"5180"
D10112,3,06/28/2021,PFS2OUKUUI,100,"5080"
D10112,3,07/02/2021,PG25U8COM9,3900,"1180"
D10112,3,07/02/2021,PG28UK66XI,100,"1080"
D10112,3,07/02/2021,PG21UK9FD9,100,980
D10112,3,07/02/2021,PG24UKCAT8,100,880
D10112,3,07/03/2021,PG35V9ZYJR,100,780
D10112,3,07/03/2021,PG30VA2WAU,100,680
D10112,3,07/03/2021,PG37VAYOA3,100,580
D10112,3,07/03/2021,PG34VB6KV0,100,480
D10112,3,07/03/2021,PG37VB9KEH,100,380
D10112,3,07/03/2021,PG32VBCFNU,100,280
D10112,3,07/03/2021,PG37VBMPO9,100,180
D10112,3,07/03/2021,PG37VBQEZF,100,80
D10112,3,07/03/2021,PG30VBTTAU,80,0
D10112,4,07/25/2021,PGP2RNEIBE,100,"6400"
D10112,4,07/25/2021,PGP3RNIKN7,100,"6300"
D10112,4,07/25/2021,PGP2RO47BE,100,"6200"
D10112,4,07/25/2021,PGP9RO8DD9,100,"6100"
D10112,4,07/25/2021,PGP4ROCRAO,100,"6000"
D10112,4,07/27/2021,PGR0U69H7G,750,"5250"
D10112,4,07/28/2021,PGS2VK1K28,3800,"1450"
D10112,4,07/31/2021,PGV017Y918,1450,0
D10112,5,08/05/2021,PH5695B2Z4,100,"7200"
D10112,5,08/05/2021,PH5495M5VW,100,"7100"
D10112,5,08/05/2021,PH5195Q295,100,"7000"
D10112,5,08/05/2021,PH5095UE0W,100,"6900"
D10112,5,08/05/2021,PH5995YT1B,100,"6800"
D10112,5,08/22/2021,PHM1WCD0IV,100,"6700"
D10112,5,08/22/2021,PHM7WCF9KT,100,"6600"
D10112,5,08/22/2021,PHM6WCH7XU,100,"6500"
D10112,5,08/22/2021,PHM9WCJFAL,100,"6400"
D10112,5,08/24/2021,PHO31AUUNT,100,"6300"
D10112,5,08/24/2021,PHO31B02IV,100,"6200"
D10112,5,08/24/2021,PHO81B6UPK,50,"6150"
D10112,5,09/07/2021,PI78L6HEKU,4300,"1850"
D10112,5,09/08/2021,PI84N4BMKO,1850,0
D10113,1,04/17/2021,PDH1XDR1HF,975,"2925"
D10113,1,04/28/2021,PDS2CA7BB6,975,"1950"
D10113,1,05/03/2021,PE36IXDAK2,"1950",0
D10113,2,05/21/2021,PEL97PD1Q7,"1000","2900"
D10113,2,05/31/2021,PEV7KE30FP,"2900",0
D10113,3,06/12/2021,PFC01X0PUG,"3900",0
D10113,4,07/08/2021,PG813IAPGT,"5200",0
D10113,5,07/20/2021,PGK5KD35G3,"1400","3800"
D10113,5,07/28/2021,PGS6WDM5MW,550,"3250"
D10113,5,08/05/2021,PH518PFPAD,"3250",0
D10113,6,09/05/2021,PI54I49WXI,"1900","3450"
D10113,6,09/08/2021,PI87N07SJ5,"2000","1450"
D10113,6,09/13/2021,PID3V49UVX,"1450",0
D10114,1,04/16/2021,PDG3VQSIZP,"1625","4325"
D10114,1,04/23/2021,PDN25UWO6U,725,"3600"
D10114,1,04/23/2021,PDN95VBF7P,900,"2700"
D10114,1,04/26/2021,PDQ79AOSND,"2700",0
D10114,2,05/03/2021,PE36IYCWFK,"1625","4225"
D10114,2,05/10/2021,PEA0SJVSKE,700,"3525"
D10114,2,05/10/2021,PEA8SK2VFC,925,"2600"
D10114,2,05/11/2021,PEB8TJJSL2,1700,900
D10114,2,05/11/2021,PEB1TJNXON,900,0
D10114,3,05/19/2021,PEJ44I5322,"1375","7515"
D10114,3,05/19/2021,PEJ24I5B7C,900,"6615"
D10114,3,05/25/2021,PEP7CTVLIL,"2275","4340"
D10114,3,06/01/2021,PF16MKVGAC,2275,"2065"
D10114,3,06/04/2021,PF43PTN0A1,2065,0
D10114,4,06/11/2021,PFB81L446W,"1225","4525"
D10114,4,06/17/2021,PFH28WDEE6,"3700",825
D10114,4,06/17/2021,PFH98WV3Y1,25,800
D10114,4,06/17/2021,PFH68WLL2C,800,0
D10114,5,06/24/2021,PFO0J1S4BC,"2275","6195"
D10114,5,06/29/2021,PFT3Q7M6CZ,"1775","4420"
D10114,5,06/29/2021,PFT3Q7PY3N,500,"3920"
D10114,5,07/06/2021,PG69ZT35EX,900,"3020"
D10114,5,07/06/2021,PG68ZSY3NA,3020,0
D10114,6,07/13/2021,PGD7B8KH4H,725,"5175"
D10114,6,07/13/2021,PGD3B8NC81,900,"4275"
D10114,6,07/22/2021,PGM8N6KHGQ,"3400",875
D10114,6,07/22/2021,PGM3N6TS2F,875,0
D10114,7,08/03/2021,PH294TRV3F,"1375","8145"
D10114,7,08/03/2021,PH204U0HP4,900,"7245"
D10114,7,08/25/2021,PHP42T4UHW,"1000","6245"
D10114,7,08/26/2021,PHQ048GD0E,2000,"4245"
D10114,7,08/31/2021,PHV8AWZRSQ,3645,600
D10114,7,08/31/2021,PHV4AX3ZQW,600,0
D10114,8,09/09/2021,PI97P990QX,"1625","4725"
D10114,8,09/18/2021,PII93VCJFJ,300,"4425"
D10114,8,09/21/2021,PIL985FK8X,"1325","3100"
D10114,8,09/25/2021,PIP9D95G01,3100,0
D10114,9,10/16/2021,PJG8CLSY80,"1625","4625"
D10114,9,10/18/2021,PJI1EALMCR,"3825",800
D10114,9,10/18/2021,PJI6EAQBDM,800,0
D10114,10,11/11/2021,PKB3IYR7BL,"5000","4100"
D10114,10,11/15/2021,PKF6O8DVQY,"4100",0
D10114,11,12/13/2021,PLD42DKOMS,"9000",100
D10114,11,12/13/2021,PLD62DO6QA,100,0
D10114,12,01/08/2022,QA87B7LW51,"2600","6500"
D10114,12,01/10/2022,QAA1E9MGHN,"6500",0
D10114,13,02/09/2022,QB92V0J0NY,850,"10210"
D10114,13,02/10/2022,QBA0X8BPHQ,650,"9560"
D10114,13,02/14/2022,QBE55BBVVL,500,"9060"
D10114,13,02/18/2022,QBI9D1LW1V,480,"8580"
D10114,13,03/23/2022,QCN55ELGVN,500,"8080"
D10114,13,03/26/2022,QCQ6BXNR5C,100,"7980"
D10114,13,03/31/2022,QCV9KF6U2V,200,"7780"
D10114,13,04/04/2022,QD40SUOS3W,200,"7580"
D10114,13,04/05/2022,QD66W3A9SY,200,"7380"
D10114,13,04/09/2022,QD9445VNIS,200,"7180"
D10114,13,04/11/2022,QDB68EA6VC,200,"6980"
D10114,13,04/13/2022,QDD9BOTTJH,200,"6780"
D10114,13,04/16/2022,QDG5H9BHBZ,200,"6580"
D10114,13,04/20/2022,QDK1OKMQQD,200,"6380"
D10114,13,04/23/2022,QDN8TYVO9G,200,"6180"
D10114,13,09/21/2022,QIL1EJYU45,100,"6080"
D10114,13,10/29/2022,QJT9UGTW7F,100,"5980"
D10115,1,04/28/2021,PDS5CD3935,350,"3730"
D10115,1,05/10/2021,PEA5SPNOFF,737,"2993"
D10115,1,05/19/2021,PEJ54UGWM1,150,"2843"
D10116,2,06/10/2021,PFA9Z8J8TZ,"12400",0
D10116,3,07/09/2021,PG924LIUR2,"19200",0
D10116,4,08/07/2021,PH72BANEWC,"19500",0
D10116,5,09/04/2021,PI45GOONP3,"19350",0
D10116,6,10/07/2021,PJ71WLMVJ1,"6120","18700"
D10116,6,10/07/2021,PJ71WPK5YP,"2800","15900"
D10116,6,10/12/2021,PJC051GZ6C,"15900",0
D10116,7,11/11/2021,PKB4ICQCCE,"13600",0
D10116,8,12/11/2021,PLB9XNUL3T,"10000","3600"
D10116,8,12/11/2021,PLB9XXWZBF,"3000",600
D10116,8,12/11/2021,PLB7XYKZ4V,600,0
D10116,9,01/08/2022,QA80B1ZGRK,"12900",0
D10116,10,02/05/2022,QB55O3TCQ1,"15480",0
D10116,11,03/05/2022,QC597HLB3F,"15480",0
D10116,12,12/02/2022,QL2160BDJH,"13000",0
D10116,13,12/31/2022,QLV4EQ8F2O,"13000",0
D10116,14,12/31/2023,QLV4EQ8F2O_D2,"13000",0
D10116,15,01/30/2023,RAU2J1VCTU,"13600",600
D10116,16,,,,
D10116,17,05/02/2023,RE28JIM1NK,"16320",0
D10116,18,06/29/2023,RFT38JD3FP,"8000","10960"
D10116,18,07/06/2023,RG69UGR0J7,"5000","5960"
D10117,1,05/04/2021,PE49KQHABP,"2000","11000"
D10117,1,05/07/2021,PE74O5VJBY,"1250","9750"
D10117,1,05/13/2021,PED6W3I5LW,"2000","7750"
D10117,1,05/19/2021,PEJ44SLBJQ,"2500","5250"
D10117,1,05/24/2021,PEO7B62ER7,5250,0
D10117,2,06/03/2021,PF33OSWWDT,"2000","11000"
D10117,2,06/09/2021,PF91WWLQOV,"2950","8050"
D10117,2,06/22/2021,PFM8FNJZ74,"8050",0
D10117,3,07/01/2021,PG12S521G0,"3500","10100"
D10117,3,07/08/2021,PG843AD4I6,"2000","8100"
D10117,3,07/21/2021,PGL6L9ORU0,"7500",600
D10117,3,07/21/2021,PGL2LF7HMA,600,0
D10117,4,08/06/2021,PH629NZDYI,"2000","11000"
D10117,4,08/19/2021,PHJ7SB61C9,"11000",0
D10117,5,09/02/2021,PI27DLC91V,"2250","10750"
D10117,5,09/16/2021,PIG8Z1UZ3Y,"11000",250
D10117,6,10/08/2021,PJ83XOUMHR,"2000","11000"
D10117,6,11/14/2021,PJE48F8FDK,"11000",0
D10117,7,11/11/2021,PKB0I99MRU,"13000",0
D10117,8,12/09/2021,PL99UQG3X1,"13000",0
D10117,9,01/06/2022,QA6683A258,"13000",0
D10117,10,02/03/2022,QB30KL4GAY,"13000",0
D10117,11,03/03/2022,QC372L91BN,"13000",0
D10117,12,03/29/2022,QCT6GA8ZSE,"13000",0
D10117,13,04/25/2022,QDP2XQ2RKO,"13000",0
D10117,14,05/24/2022,QEO9J7G8DV,"13000",0
D10117,15,06/21/2022,QFL44SEEZE,"13000",0
D10117,16,07/20/2022,QGK2SQW6XC,"13600",0
D10117,17,08/18/2022,QHI9EP8TMB,"13000",0
D10117,18,09/15/2022,QIF01R88U6,"13000",0
D10117,19,10/14/2022,QJE0UTBN0C,"13600",0
D10117,20,11/12/2022,QKC2SEYLCS,"13600",0
D10117,21,12/10/2022,QLA5UL2V33,"13000",0
D10117,22,01/09/2023,RA992G47YB,"11000","2600"
D10117,22,01/10/2023,RAA03J84Q0,"2600",0
D10117,23,02/07/2023,RB764RI2VE,"13000",0
D10117,24,03/09/2023,RC92ETC7K0,"13600",0
D10117,25,04/17/2023,RDH8DTRA68,"1000","14800"
D10117,25,05/05/2023,RE55SC7V8J,"1500","13300"
D10117,25,05/05/2023,RE50T24BYU,"13300",0
D10118,1,05/20/2021,PEK569NSRH,"1500","11500"
D10118,1,05/21/2021,PEL57IUCJ9,"1750","9750"
D10118,1,05/28/2021,PES3GDP9LJ,"9750",0
D10118,2,06/22/2021,PFM8FIAAFA,"12700",0
D10118,3,07/16/2021,PGG4F1IDDO,"15120",0
D10118,4,08/13/2021,PHD7JVSX0L,"15600",0
D10118,5,09/10/2021,PIA2PR0OFG,"19000",500
D10118,5,09/10/2021,PIA4PSXDOQ,500,0
D10118,6,10/08/2021,PJ83Y2RVLD,"19500",0
D10118,7,11/05/2021,PK508UFNVI,"19500",0
D10118,8,12/03/2021,PL34JQCDLI,"19500",0
D10119,1,05/07/2021,PE78OYONTE,"1625","4875"
D10119,1,05/14/2021,PEE7Y2KZWT,"1625","3250"
D10119,1,05/21/2021,PEL47NBGB6,"3250",0
D10119,2,05/30/2021,PEU5JGTZJR,"1625","4875"
D10119,2,06/05/2021,PF57SBIZVJ,"2000","2875"
D10119,2,06/14/2021,PFE84LK7KQ,"1625","1250"
D10119,2,06/14/2021,PFE15MPM7P,1250,0
D10119,3,06/25/2021,PFP2JYOOFQ,"2275","6825"
D10119,3,07/02/2021,PG23TVCXFD,"2275","4550"
D10119,3,07/08/2021,PG8548YZ3L,"2275","2275"
D10119,3,07/10/2021,PGA561KWG5,2275,0
D10119,4,07/19/2021,PGJ0JAK3H6,"2275","6825"
D10119,4,07/26/2021,PGQ2SXZSGW,"2275","4550"
D10119,4,08/03/2021,PH3155BAY1,"2275","2275"
D10119,4,08/03/2021,PH3658X5B4,2275,0
D10119,5,08/14/2021,PHE4M6WXH4,"2000","11000"
D10119,5,08/22/2021,PHM2WBLCWE,"3300","7700"
D10119,5,08/27/2021,PHR34YMPWB,"7700",0
D10119,6,09/16/2021,PIG2YXHGRA,"3250","9750"
D10119,6,09/24/2021,PIO0BXT0T8,"9750",0
D10119,7,10/22/2021,PJM4KRLRC2,"13000",0
D10119,8,11/16/2021,PKG0Q9D4FS,"8000","5000"
D10119,8,11/16/2021,PKG3Q9XVG3,"5000",0
D10119,9,12/09/2021,PL90UAF2YY,"3500","9500"
D10119,9,12/14/2021,PLE348OUYD,"9500",0
D10119,10,01/10/2022,QAA2ENEIFI,"13000",0
D10119,11,02/05/2022,QB57NZGVG1,"13000",0
D10119,12,03/04/2022,QC494FXNVD,"13000",0
D10119,13,03/03/2022,QCU1IGNNHJ,"13000",0
D10119,14,04/25/2022,QDP6XQ0XUE,"12900",0
D10119,15,05/19/2022,QEJ8A9WL6K,"7000","5800"
D10119,15,05/21/2022,QEL5D16N6B,"5800",0
D10119,16,06/17/2022,QFH4VD5BB8,"13000",0
D10119,17,07/14/2022,QGE6G3QWTU,"19500",0
D10119,18,08/10/2022,QHA9YXWE51,"19500",0
D10119,19,09/06/2022,QI65GOF2JJ,"19500",0
D10119,20,10/04/2022,QJ449FWY9K,"14500","5900"
D10119,20,10/05/2022,QJ55A2EF4F,"5900",0
D10119,21,11/01/2022,QK161B1JVS,"19500",0
D10119,22,11/28/2022,QKS7TH2UP9,"19500",0
D10119,23,12/02/2022,QLM1Q8UWE1,"18900",0
D10119,24,01/17/2023,RAH4M56VAK,"19200",0
D10119,25,02/20/2022,RBK13A03TL,"19500",900
D10119,25,02/20/2022,RBK248GONW,900,0
D10119,26,03/14/2023,RCE9RGZ2OF,"18600",0
D10119,27,03/11/2023,RDB6WH4Q7K,"19500",0
D10119,28,05/09/2023,RE914VUUS3,"19500",0
D10119,29,06/06/2023,RF64CQU7JU,"19500",0
D10119,30,07/06/2023,RG63TKXOA7,"19500",0
D10119,31,08/05/2023,RH57BB3E85,"19500",0
D10120,1,05/07/2021,PE72O6UZRK,"1630","4870"
D10120,1,05/15/2021,PEF3ZI8QHT,"5000",130
D10120,2,05/25/2021,PEP6CZSITE,"1650","4850"
D10120,2,05/26/2021,PEQ3DXZL0B,"4875",25
D10120,3,06/02/2021,PF26N9D65K,"2275","6825"
D10120,3,06/09/2021,PF91X96J3V,"6825",0
D10120,4,06/16/2021,PFG5808QZ3,"2000","7100"
D10120,4,06/23/2021,PFN6HPPXAG,"2275","4825"
D10120,4,07/01/2021,PG17RU834Z,"2000","2825"
D10120,4,07/03/2021,PG30V1II8O,2825,0
D10120,5,07/13/2021,PGD99YS6BL,"2300","10700"
D10120,5,07/19/2021,PGJ9IM6E1D,"3000","7700"
D10120,5,07/31/2021,PGV210HITM,"7785",85
D10120,6,08/09/2021,PH90DY1B0Q,"2000","11000"
D10121,1,06/01/2021,PF17LVLHYX,"5400","1400"
D10121,1,06/07/2021,PF77UNR6C9,100,"1300"
D10121,1,06/07/2021,PF74UNTMDM,100,"1200"
D10121,1,06/09/2021,PF95XAT4TF,527,673
D10121,1,06/10/2021,PFA9YBRBZ1,677,4
D10121,2,07/10/2021,PGA8613NTG,"6800",0
D10122,1,05/15/2021,PEF7ZLP1DH,"3250","9750"
D10122,1,05/22/2021,PEM89O3NHM,"3250","6500"
D10122,1,05/29/2021,PET3IQWNJP,"3250","3250"
D10122,1,06/04/2021,PF45Q8XJ6N,"3250",0
D10122,2,06/11/2021,PFB01I1GOK,"3250","9750"
D10122,2,06/18/2021,PFI3B5NCP7,"3250","6500"
D10122,2,06/25/2021,PFP3KK4V71,"3250","3250"
D10122,2,07/02/2021,PG23UKHFM9,3250,0
D10122,3,07/10/2021,PGA374AGFV,"3250","9750"
D10122,3,07/17/2021,PGH7H5AI7F,"3250","6500"
D10122,3,07/24/2021,PGO3QYD5A5,"3250","3250"
D10122,3,07/31/2021,PGV3ZX5SUH,3250,0
D10122,4,08/07/2021,PH72C7R55G,"3250","9750"
D10122,4,08/14/2021,PHE8M6XLD8,"3250","6500"
D10122,4,08/21/2021,PHL6W679NY,"3250","3250"
D10122,4,08/24/2021,PHO3Z756OV,3250,0
D10122,5,08/31/2021,PHV8BF949U,"3250","9750"
D10122,5,09/07/2021,PI77M99YCL,"3250","6500"
D10122,5,09/14/2021,PIE1W9NNXL,"3250","3250"
D10122,5,09/21/2021,PIL16YHXU1,3250,0
D10122,6,09/28/2021,PIS7IMI7LL,"3250","9750"
D10122,6,10/05/2021,PJ53U0AKDF,"3250","6500"
D10122,6,10/12/2021,PJC063Q6IQ,"3250","3250"
D10122,6,10/19/2021,PJJ1FTS617,3250,0
D10122,7,10/26/2021,PJQ1R7X5J5,"3250","9750"
D10122,7,11/02/2021,PK2940A6E5,"3250","6500"
D10122,7,11/09/2021,PK93FW3639,"3250","3250"
D10122,7,11/16/2021,PKG8PR3HUQ,3250,0
D10122,8,11/24/2021,PKN73SIPHV,"3250","9750"
D10122,8,11/30/2021,PKU7FFNMZR,"3250","6500"
D10122,8,12/07/2021,PL79RJWMD1,"3250","3250"
D10122,8,12/14/2021,PLE23XHXCE,3250,0
D10122,9,12/21/2021,PLL1H7AK1B,"3250","9750"
D10122,9,12/28/2021,PLS8T1Z0HG,"3250","6500"
D10122,9,01/04/2022,QA4958ACR7,"3250","3250"
D10122,9,01/06/2022,QA647G4TWQ,3250,0
D10122,10,01/13/2022,QAD8KASQ54,"3250","9750"
D10122,10,01/20/2022,QAK6W4CY3G,"3250","6500"
D10122,10,01/27/2022,QAR791NGXZ,"3250","3250"
D10122,10,02/03/2022,QB31K3PK7L,3250,0
D10122,11,02/10/2022,QBA9YF0APZ,"3250","9750"
D10122,11,02/17/2022,QBH0C54UHW,"3250","6500"
D10122,11,02/24/2022,QBO2ONLWHU,"3250","3250"
D10122,11,03/02/2022,QC2015U2F2,3250,0
D10122,12,03/10/2022,QCA2GZQN0M,"3250","9750"
D10122,12,03/17/2022,QCH6UDORF2,"3250","6500"
D10122,12,03/24/2022,QCO68I5A3W,"3250","3250"
D10122,12,03/31/2022,QCV5K6DS71,3250,0
D10122,13,04/07/2022,QD77ZY9AVD,"3250","9750"
D10122,13,04/14/2022,QDE3EK1I2X,"3250","6500"
D10122,13,04/21/2022,QDL7R1UEAF,"3250","3250"
D10122,13,04/27/2022,QDR72PV969,3250,0
D10122,14,05/05/2022,QE59I3MLDR,"3250","9750"
D10122,14,05/12/2022,QEC4W8JVTK,"3250","6500"
D10122,14,05/19/2022,QEJ1A29V7R,"3250","3250"
D10122,14,05/24/2022,QEO0IKMZ82,3250,0
D10122,15,05/31/2022,QEV5XWTHOF,"3250","9750"
D10122,15,06/07/2022,QF75CGPVSN,"3250","6500"
D10122,15,06/14/2022,QFE1QNKQE7,"3250","3250"
D10122,15,06/20/2022,QFK63IPBEA,3250,0
D10122,16,06/28/2022,QFS1J2MO7R,"3250","9750"
D10122,16,07/05/2022,QG55XJ88VV,"3250","6500"
D10122,16,07/12/2022,QGC7D1YIYH,"3250","3250"
D10122,16,07/18/2022,QGI7P10Z97,3250,0
D10122,17,07/26/2022,QGQ15MZ0SB,"3250","9750"
D10122,17,08/02/2022,QH22K0D7WA,"3250","6500"
D10122,17,08/09/2022,QH90Y3ZC56,"3250","3250"
D10122,17,08/12/2022,QHC936YJJ,3250,0
D10122,18,08/19/2022,QHJ1HF9E51,"3250","9750"
D10122,18,08/26/2022,QHQ4UTMW2O,"3250","6500"
D10122,18,09/02/2022,QI28A3YOM0,"3250","3250"
D10122,18,09/08/2022,QI89MQEEYT,3250,0
D10122,19,09/16/2022,QIG14OZ0HL,"3250","9750"
D10122,19,09/23/2022,QIN7JLACFZ,"3250","6500"
D10122,19,09/30/2022,QIU2Z7YY2U,"3250","3250"
D10122,19,10/06/2022,QJ69CHUQIL,3250,0
D10122,20,10/13/2022,QJD8U7TMG4,"3250","9750"
D10122,20,10/20/2022,QJK2AWEPBU,"3250","6500"
D10122,20,10/27/2022,QJR8QGGVYA,"3250","3250"
D10122,20,11/03/2022,QK335XT2CH,3250,0
D10122,21,11/10/2022,QKA4OMPJYK,"3250","9750"
D10122,21,11/17/2022,QKH95KWI0T,"3250","6500"
D10122,21,11/24/2022,QKO5LHTEI1,"3250","3250"
D10122,21,12/02/2022,QL174226ZN,3250,0
D10122,22,12/09/2022,QL94STYJLS,"3250","9750"
D10122,22,12/16/2022,QLG3CMWXE5,"3250","6500"
D10122,22,12/23/2022,QLN6V7FYJA,"3250","3250"
D10122,22,12/29/2022,QLT5ABME6H,3250,0
D10122,23,01/06/2023,RA67UA6U0B,"3250","9750"
D10122,23,01/13/2023,RAD1C8X00N,"3250","6500"
D10122,23,01/20/2023,RAK2TRUNC6,"3250","3250"
D10122,23,01/26/2023,RAQ09U0H5Y,"3250",0
D10122,24,02/03/2023,RB39UDE5ST,"3250","9750"
D10122,24,02/10/2023,RBA2DZ6W6K,"3250","6500"
D10122,24,02/17/2023,RBH0W41O3Q,"3250","3250"
D10122,24,02/21/2023,RBL25C1M3O,"3250",0
D10122,25,03/01/2023,RC16S85ZDW,"3250","9750"
D10122,25,03/08/2023,RC84CL0Q5K,"3250","6500"
D10122,25,03/15/2023,RCF9VDQP27,"3250","3250"
D10122,25,03/20/2023,RCK67RMYQ0,"3250",0
D10122,26,03/28/2023,RCS0UMYAMW,"3250","9750"
D10122,26,04/26/2023,RDQ226VB7K,"2000","7750"
D10122,26,05/01/2023,RE14FXW40U,"1000","6750"
D10122,26,05/07/2023,RE85ZXL0MT,"1000","5750"
D10123,1,05/14/2021,PEE0XGW78O,100,"2925"
D10123,1,05/14/2021,PEE0XGYY08,9,"2916"
D10123,1,05/15/2021,PEF7ZHHNMD,100,"2816"
D10123,1,05/15/2021,PEF8ZHKV8M,9,"2807"
D10123,1,05/16/2021,PEG41GXRYI,100,"2707"
D10123,1,05/16/2021,PEG41H13E8,9,"2698"
D10123,1,05/17/2021,PEH12OX21J,100,"2598"
D10123,1,05/17/2021,PEH02P0HD8,9,"2589"
D10123,1,05/18/2021,PEI94AL7XJ,100,"2489"
D10123,1,05/18/2021,PEI548X63L,9,"2480"
D10123,1,05/19/2021,PEJ45QHREU,100,"2380"
D10123,1,05/19/2021,PEJ05QO0IW,9,"2371"
D10123,1,05/20/2021,PEK16Z20I5,100,"2271"
D10123,1,05/20/2021,PEK96Z5KMV,9,"2262"
D10123,1,05/22/2021,PEM88EVR30,9,"2253"
D10123,1,05/22/2021,PEM58F8TB9,100,"2153"
D10123,1,05/23/2021,PEN19U3RUR,100,"2053"
D10123,1,05/23/2021,PEN89U7L42,9,"2044"
D10123,1,05/23/2021,PEN9AIZMJ5,100,"1944"
D10123,1,05/23/2021,PEN1AJ3OE1,9,"1935"
D10123,1,05/24/2021,PEO4BPKBHU,100,"1835"
D10123,1,05/24/2021,PEO4BPN2Z8,9,"1826"
D10123,1,05/25/2021,PEP3DAK28P,9,"1817"
D10123,1,05/25/2021,PEP4DANZ7Q,100,"1717"
D10123,1,05/26/2021,PEQ4ED3EC8,100,"1617"
D10123,1,05/26/2021,PEQ8ED9RBO,9,"1608"
D10123,1,05/27/2021,PER6FPHL30,100,"1508"
D10123,1,05/27/2021,PER5FPLPSB,9,"1499"
D10123,1,05/28/2021,PES1H73U1X,100,"1399"
D10123,1,05/28/2021,PES4H783AE,9,"1390"
D10123,1,05/29/2021,PET9IL832R,100,"1290"
D10123,1,05/29/2021,PET4ILBLKS,9,"1281"
D10123,1,05/30/2021,PEU5JZ2K8L,100,"1181"
D10123,1,05/30/2021,PEU9JZ4JFR,9,"1172"
D10123,1,05/31/2021,PEV0LAIRUO,100,"1072"
D10123,1,05/31/2021,PEV3LAKY8Z,9,"1063"
D10123,1,06/01/2021,PF18MO6VNW,100,963
D10123,1,06/01/2021,PF15MO82ZT,9,954
D10123,1,06/02/2021,PF20NBL4P6,954,0
D10123,2,06/02/2021,PF28O1JRSY,100,"2930"
D10123,2,06/02/2021,PF28O1LDV8,7,"2923"
D10123,2,06/03/2021,PF38PHAVEG,100,"2823"
D10123,2,06/03/2021,PF33PHDC01,11,"2812"
D10123,2,06/05/2021,PF55S8569J,100,"2712"
D10123,2,06/05/2021,PF55S87P2P,9,"2703"
D10123,2,06/05/2021,PF55S8A1IF,100,"2603"
D10123,2,06/05/2021,PF52S8FHNG,9,"2594"
D10123,2,06/07/2021,PF77UV7YDH,100,"2494"
D10123,2,06/07/2021,PF78UVP7Z0,9,"2485"
D10123,2,06/07/2021,PF77UX0SPV,100,"2385"
D10123,2,06/07/2021,PF79UX9X95,9,"2376"
D10123,2,06/08/2021,PF85WHRSND,100,"2276"
D10123,2,06/08/2021,PF80WHSZUI,9,"2267"
D10123,2,06/11/2021,PFB2ZBUTUW,100,"2167"
D10123,2,06/11/2021,PFB4ZBXD8E,9,"2158"
D10123,2,06/11/2021,PFB1ZC1N9B,9,"2149"
D10123,2,06/12/2021,PFC42W5TOM,100,"2049"
D10123,2,06/12/2021,PFC42W8PS4,9,"2040"
D10123,2,06/14/2021,PFE55M0TRR,100,"1940"
D10123,2,06/14/2021,PFE85M3MG0,9,"1931"
D10123,2,06/14/2021,PFE55M6J3Z,9,"1922"
D10123,2,06/14/2021,PFE55M9581,100,"1822"
D10123,2,06/15/2021,PFF669WNVA,1822,0
D10123,3,06/16/2021,PFG08IBLP2,100,"3500"
D10123,3,06/16/2021,PFG08IEE74,30,"3470"
D10123,3,06/19/2021,PFJ4BDMHEW,100,"3370"
D10123,3,06/19/2021,PFJ0BDOUS4,30,"3340"
D10123,3,06/19/2021,PFJ2BT7UIW,100,"3240"
D10123,3,06/19/2021,PFJ1BTALW3,30,"3210"
D10123,3,06/23/2021,PFN3HQ1XND,30,"3180"
D10123,3,06/23/2021,PFN3HQ7I4L,100,"3080"
D10123,3,06/26/2021,PFQ9LVFZBV,30,"3050"
D10123,3,06/26/2021,PFQ1LVJSTN,100,"2950"
D10123,3,06/28/2021,PFS4ONMKC8,100,"2850"
D10123,3,06/30/2021,PFU2RFT02E,50,"2800"
D10123,3,06/30/2021,PFU2RFY08I,100,"2700"
D10123,3,07/01/2021,PG11SC8A5N,900,"1800"
D10123,3,07/02/2021,PG30UYIORC,1800,0
D10123,4,07/05/2021,PG52XJ3LH4,100,"3980"
D10123,4,07/05/2021,PG53XJ4205,30,"3950"
D10123,4,07/09/2021,PG975FY1PR,100,"3850"
D10123,4,07/09/2021,PG925G44P8,30,"3820"
D10123,4,07/13/2021,PGD3AEFUT5,5,"3815"
D10123,4,07/13/2021,PGD9AEI8S1,200,"3615"
D10123,4,07/13/2021,PGD0AELOXS,30,"3585"
D10123,4,07/13/2021,PGD8AEOGSQ,30,"3555"
D10123,4,07/16/2021,PGG4EN7SZW,1,"3554"
D10123,4,07/16/2021,PGG9ENAQND,30,"3524"
D10123,4,07/16/2021,PGG3ENDYIB,200,"3324"
D10123,4,07/17/2021,PGH0GQEPTA,150,"3174"
D10123,4,07/21/2021,PGL0M150U2,30,"3144"
D10123,4,07/21/2021,PGL6M183UW,100,"3044"
D10123,4,07/26/2021,PGQ0TOHFVE,30,"3014"
D10123,4,07/26/2021,PGQ8TOKPQ4,100,"2914"
D10123,4,07/26/2021,PGQ9TOOGZ1,100,"2814"
D10123,4,08/02/2021,PH2843MZIG,2814,0
D10123,5,08/03/2021,PH336E68JF,30,"3870"
D10123,5,08/03/2021,PH306E7BRK,100,"3770"
D10123,5,08/04/2021,PH437SBSLN,100,"3670"
D10123,5,08/06/2021,PH64APH6NI,100,"3570"
D10123,5,08/06/2021,PH68APM3Q2,100,"3470"
D10123,5,08/06/2021,PH66APS0AS,30,"3440"
D10123,5,08/09/2021,PH90F5SLJM,100,"3340"
D10123,5,08/09/2021,PH93F5UCCJ,100,"3240"
D10123,5,08/09/2021,PH97F5WW85,30,"3210"
D10123,5,08/16/2021,PHG1O2DW05,1,"3209"
D10123,5,08/16/2021,PHG4O2JQSU,100,"3109"
D10123,5,08/16/2021,PHG7O352V7,100,"3009"
D10123,5,08/16/2021,PHG4O3DPB8,100,"2909"
D10123,5,08/17/2021,PHH3QG0NQH,100,"2809"
D10123,5,08/18/2021,PHI8QM52BC,50,"2759"
D10123,5,08/20/2021,PHK6UI7YGG,50,"2709"
D10123,5,08/31/2021,PHV1AXTSUB,2709,0
D10123,6,09/02/2021,PI20EQGZU4,30,"4050"
D10123,6,09/02/2021,PI28EQKUSA,100,"3950"
D10123,6,09/02/2021,PI29EQMIK9,100,"3850"
D10123,6,09/03/2021,PI30G74K94,100,"3750"
D10123,6,09/03/2021,PI32G76Z8A,100,"3650"
D10123,6,09/03/2021,PI38G79NXU,30,"3620"
D10123,6,09/06/2021,PI64KLMUJC,100,"3520"
D10123,6,09/27/2021,PIR2G8ZRWY,1,"3519"
D10123,6,09/27/2021,PIR1G93IXR,1,"3518"
D10123,6,09/27/2021,PIR0G97VGQ,1940,"1578"
D10123,6,09/27/2021,PIR1G9CU9Z,20,"1558"
D10123,6,09/30/2021,PIU0KU2TQS,1000,558
D10123,6,10/01/2021,PJ17MLWOBR,558,0
D10123,7,10/07/2021,PJ75X2QIDX,100,"3000"
D10123,7,10/07/2021,PJ74X2VOWC,100,"2900"
D10123,7,10/07/2021,PJ72X30P2Y,100,"2800"
D10123,7,10/07/2021,PJ75X3D2UJ,100,"2700"
D10123,7,10/07/2021,PJ77X3HUM7,100,"2600"
D10123,7,10/07/2021,PJ77X3M65N,100,"2500"
D10123,7,10/07/2021,PJ78X3TB3Y,100,"2400"
D10123,7,10/07/2021,PJ72X42SYQ,100,"2300"
D10123,7,10/07/2021,PJ78X4EDKE,40,"2260"
D10123,7,10/16/2021,PJG3B82ARP,100,"2160"
D10123,7,10/16/2021,PJG8B855AY,100,"2060"
D10123,7,10/16/2021,PJG9B88MVT,100,"1960"
D10123,7,10/16/2021,PJG0B8CK7M,100,"1860"
D10123,7,10/16/2021,PJG6B8GYBG,100,"1760"
D10123,7,10/19/2021,PJJ7G98RSJ,1760,0
D10123,8,10/31/2021,PJV7YWHFWH,1,"4299"
D10123,8,10/31/2021,PJV5YWKJ6J,700,"3599"
D10123,8,11/03/2021,PK335YKYDH,100,"3499"
D10123,8,11/03/2021,PK375YRHYF,100,"3399"
D10123,8,11/03/2021,PK335YX3BH,100,"3299"
D10123,8,11/03/2021,PK315Z1O8D,100,"3199"
D10123,8,11/17/2021,PKH6S4EK3M,3199,0
D10123,9,12/19/2021,PLJ7CULRON,"3900",180
D10123,9,12/20/2021,PLK1EK47KL,180,0
D10124,1,06/12/2021,PFC62BRWQI,"6350",0
D10124,2,07/09/2021,PG984LIDNY,"6400",0
D10124,3,08/06/2021,PH669XJ4DS,"9030",0
D10124,4,08/21/2021,PHL1V78NCF,"2000","7100"
D10124,4,09/04/2021,PI42GN19JE,"7100",0
D10124,5,10/04/2021,PJ47RH6QFV,"9100",0
D10124,6,10/30/2021,PJU6XFKWCO,"8890",0
D10124,7,11/25/2021,PKP96G2MFD,"8890",0
D10124,8,12/17/2021,PLH197TS9T,"12300",0
D10124,9,01/07/2022,QA719X8ZYR,"12200",0
D10124,10,01/22/2022,QAM9YBEXTD,"11600",0
D10124,11,02/21/2023,QBL4ISARJW,"16320",0
D10124,12,03/18/2022,QCI5UWKC0V,"15120",0
D10124,13,04/19/2022,QDJ8MSRZ6K,"15600",720
D10124,13,04/19/2022,QDJ0MTGYFE,720,0
D10124,14,05/19/2022,QEJ4944PT8,"2200","16760"
D10124,14,05/26/2022,QEQ6NJ52W0,"1000","15760"
D10124,14,05/31/2022,QEV7WWPG3J,"1200","14560"
D10124,14,06/17/2022,QFH3W221UV,1050,"13510"
D10124,14,06/22/2022,QFM771YSX9,1000,"12510"
D10124,14,07/05/2022,QG59W9P7ZB,900,"11610"
D10124,14,07/16/2022,QGG4JQFUW2,600,"11010"
D10124,14,07/25/2022,QGP034K2EC,1000,"10010"
D10124,14,08/03/2022,QH36KCJ7J4,1000,"9010"
D10124,14,08/23/2022,QHN1NO9CX5,1150,"7860"
D10124,14,09/17/2022,QIH05QFN56,1000,"6860"
D10124,14,09/24/2022,QIO4KKLG1Q,1000,"5860"
D10124,14,10/05/2022,QJ55B6K24H,1000,"4860"
D10124,14,10/17/2022,QJH42PNTLO,500,"4360"
D10124,14,06/24/2023,RFO6U3JNVA,500,"3860"
D10124,14,07/01/2023,RG13F85RG7,500,"3360"
D10124,14,07/15/2023,RGF9LJXLIH,600,"2760"
D10124,14,08/04/2023,RH438X5FF7,1200,"1560"
D10125,1,05/21/2021,PEL27B0VM6,900,"13700"
D10125,1,05/22/2021,PEM28GFZT4,450,"13250"
D10125,1,05/25/2021,PEP1CRTXI7,215,"13035"
D10125,1,05/26/2021,PEQ8DOYS90,980,"12055"
D10125,1,06/06/2021,PF65TB20QR,500,"11555"
D10125,1,06/21/2021,PFL9F0X51F,500,"11055"
D10126,1,05/31/2021,PEV8KRD4DG,"1625","4875"
D10126,1,06/06/2021,PF60SPZ0F2,"1625","3250"
D10126,1,06/10/2021,PFA1YPKYBH,"3250",0
D10126,2,06/23/2021,PFN1HLLT21,"6500",0
D10126,3,07/02/2021,PG21UHVME7,"1500","11500"
D10126,3,07/03/2021,PG33VZ7HWB,"1500","10000"
D10126,3,07/07/2021,PG772CARD3,"1850","8150"
D10126,3,07/13/2021,PGD7A2F0Y1,8150,0
D10126,4,07/30/2021,PGU6YZQWDG,"3100","9900"
D10126,4,08/04/2021,PH406RYHQU,"5000","4900"
D10126,4,08/04/2021,PH437PZXH1,700,"4200"
D10126,4,08/05/2021,PH5386QY6N,4200,0
D10126,5,08/25/2021,PHP42LYPQG,"5380","7620"
D10126,5,08/25/2021,PHP32O9LDJ,30,"7590"
D10126,5,09/01/2021,PI14C1OU0M,"7590",0
D10126,6,09/09/2021,PI92PAS1UI,"1500","11500"
D10126,6,09/22/2021,PIM78WBC1X,"11500",0
D10126,7,10/17/2021,PJH8DEVK64,100,"12900"
D10126,7,10/17/2021,PJH7DF46VN,"4450","8450"
D10126,7,10/17/2021,PJH9DFGA9L,100,"8350"
D10126,7,10/17/2021,PJH6DFJDLA,100,"8250"
D10126,7,10/17/2021,PJH2DFMJZI,100,"8150"
D10126,7,10/17/2021,PJH7DFR3QN,100,"8050"
D10126,7,10/18/2021,PJI6EDRLXI,8050,0
D10126,8,11/01/2021,PK112N8XM3,25,"12975"
D10126,8,11/02/2021,PK204IU6XE,200,"12775"
D10126,8,11/03/2021,PK315Y7PTL,130,"12645"
D10126,8,11/04/2021,PK487LAQ86,100,"12545"
D10126,8,11/04/2021,PK407LUJNA,20,"12525"
D10126,8,11/05/2021,PK519JQPYD,100,"12425"
D10126,8,11/6/2021,PK62BCK8XI,100,"12325"
D10126,8,11/15/2021,PKF7P187DD,12300,25
D10126,8,11/15/2021,PKF1P1BAKT,25,0
D10126,9,12/01/2021,PL15FOQWVH,50,"12950"
D10126,9,12/01/2021,PL15FORKPJ,"3000","9950"
D10126,9,12/01/2021,PL13HB9K83,120,"9830"
D10126,9,12/02/2021,PL20J2N7RM,50,"9780"
D10126,9,12/07/2021,PL79QO5G6R,9780,0
D10126,10,01/10/2022,QAA0EKIB3O,160,"15640"
D10126,10,01/11/2022,QAB1GMXQZ9,"1600","14040"
D10126,10,01/12/2022,QAC7HVOPYB,200,"13840"
D10126,10,01/13/2022,QAD3KGYVAH,2900,"10940"
D10126,10,01/15/2022,QAF3MDOIHT,250,"10690"
D10126,10,01/17/2022,QAH5R5BQDN,100,"10590"
D10126,10,01/17/2022,QAH2R5E7VI,100,"10490"
D10126,10,01/17/2022,QAH3R5HM3T,20,"10470"
D10126,10,01/31/2022,QAV1G50DJD,50,"10420"
D10126,10,01/31/2022,QAV6G51FT0,100,"10320"
D10126,10,02/01/2022,QB13I0938F,100,"10220"
D10126,10,02/01/2022,QB19I09MTL,50,"10170"
D10126,10,02/02/2022,QB20JSYTBE,100,"10070"
D10126,10,02/02/2022,QB20JT0BIS,100,"9970"
D10126,10,02/02/2022,QB21JT1MJ1,30,"9940"
D10126,10,02/03/2022,QB38LLKR3Q,100,"9840"
D10126,10,02/03/2022,QB30LLNDKC,40,"9800"
D10126,10,02/04/2022,QB41NKETI7,100,"9700"
D10126,10,02/07/2022,QB71T0UXMR,100,"9600"
D10126,10,02/09/2022,QB90WP2VQY,100,"9500"
D10126,10,02/09/2022,QB97WP3TE9,40,"9460"
D10126,10,02/10/2022,QBA9YJ4SVN,100,"9360"
D10126,10,02/11/2022,QBB316VUKF,100,"9260"
D10126,10,02/11/2022,QBB816ZI6C,20,"9240"
D10126,10,02/14/2022,QBE66SR7LM,100,"9140"
D10126,10,02/15/2022,QBF18N4R8V,100,"9040"
D10126,10,02/17/2022,QBH6AL8DM2,100,"8940"
D10126,10,02/17/2022,QBH1AL8U7F,50,"8890"
D10126,10,02/18/2022,QBI5E6B0ZJ,100,"8790"
D10126,10,02/18/2022,QBI3E6F2W9,50,"8740"
D10126,10,02/21/2022,QBL3HT5A0H,100,"8640"
D10126,10,02/21/2022,QBL0HT5A9K,50,"8590"
D10126,10,02/23/2022,QBN0MZOPZY,100,"8490"
D10126,10,02/23/2022,QBN1MZRHP5,20,"8470"
D10126,10,02/24/2022,QBO0OQWRS8,100,"8370"
D10126,10,02/27/2022,QBR1U79WET,100,"8270"
D10126,10,03/01/2022,QC12Y7FQHS,100,"8170"
D10126,10,03/01/2022,QC12Y7J06Q,50,"8120"
D10126,10,03/01/2022,QC14Y9O5KW,50,"8070"
D10126,10,03/02/2022,QC2216C6XO,50,"8020"
D10126,10,03/03/2022,QC323GGB38,70,"7950"
D10126,10,03/04/2022,QC485K96NA,60,"7890"
D10126,10,03/08/2022,QC88D5820K,60,"7830"
D10126,10,03/09/2022,QC94FC3RXE,100,"7730"
D10126,10,03/13/2022,QCD5LBGZ9N,40,"7690"
D10126,10,03/15/2022,QCF7QSCAH9,35,"7655"
D10126,10,03/23/2022,QCN66L05KO,100,"7555"
D10126,10,03/23/2022,QCN96L3BF3,100,"7455"
D10126,10,03/24/2022,QCO38KHJQX,100,"7355"
D10126,10,03/24/2022,QCO68KJQ9E,100,"7255"
D10126,10,03/26/2022,QCQ3AM04I9,100,"7155"
D10126,10,05/19/2023,REJ5VL52N3,7155,0
D10127,1,05/26/2021,,200,"6300"
D10127,1,05/27/2021,PER9FHP0TX,100,"6200"
D10127,1,05/27/2021,PER8FHUSRG,100,"6100"
D10127,1,05/27/2021,PER6FI20WE,17,"6083"
D10127,1,05/28/2021,PES2GQBU0Y,100,"5983"
D10127,1,05/28/2021,PES9GQK4FX,100,"5883"
D10127,1,05/28/2021,PES1GQP49L,17,"5866"
D10127,1,05/29/2021,PET4I4MQMM,100,"5766"
D10127,1,05/29/2021,PET2I4QHW0,100,"5666"
D10127,1,05/29/2021,PET0I4TIU6,17,"5649"
D10127,1,05/30/2021,PEU9JKSQ1F,100,"5549"
D10127,1,05/30/2021,PEU0JKWU4A,100,"5449"
D10127,1,05/30/2021,PEU6JL03C6,17,"5432"
D10127,1,06/01/2021,PF15LIRNGP,100,"5332"
D10127,1,06/01/2021,PF11LITXH3,100,"5232"
D10127,1,06/01/2021,PF15LIW76B,17,"5215"
D10127,1,06/02/2021,PF26N0YZ22,100,"5115"
D10127,1,06/02/2021,PF29N12V2F,100,"5015"
D10127,1,06/02/2021,PF26N170OG,17,"4998"
D10127,1,06/03/2021,PF31OJB92B,100,"4898"
D10127,1,06/03/2021,PF35OJMJM9,100,"4798"
D10127,1,06/03/2021,PF35OJQ4CF,17,"4781"
D10127,1,06/04/2021,PF40Q5A06I,100,"4681"
D10127,1,06/04/2021,PF48Q5DYFA,100,"4581"
D10127,1,06/04/2021,PF41Q5I1DD,17,"4564"
D10127,1,06/05/2021,PF59RTIMXZ,100,"4464"
D10127,1,06/05/2021,PF51RTMHQF,100,"4364"
D10127,1,06/05/2021,PF53RTST87,17,"4347"
D10127,1,06/07/2021,PF72U49JAA,100,"4247"
D10127,1,06/07/2021,PF78U4D1X2,100,"4147"
D10127,1,06/07/2021,PF75U4HAIV,100,"4047"
D10127,1,06/07/2021,PF70U4KN08,17,"4030"
D10127,1,06/08/2021,PF82VUPR54,100,"3930"
D10127,1,06/08/2021,PF87VUSKC1,100,"3830"
D10127,1,06/08/2021,PF81VUVDMJ,17,"3813"
D10127,1,06/10/2021,PFA8YL263W,100,"3713"
D10127,1,06/10/2021,PFA2YLA2SM,100,"3613"
D10127,1,06/10/2021,PFA9YLFKIV,100,"3513"
D10127,1,06/10/2021,PFA7YLKUNT,100,"3413"
D10127,1,06/10/2021,PFA7YM9L4R,17,"3396"
D10127,1,06/11/2021,PFB11EVHRL,100,"3296"
D10127,1,06/11/2021,PFB21F12VW,100,"3196"
D10127,1,06/12/2021,PFC72VQOIL,100,"3096"
D10127,1,06/12/2021,PFC02VXBFS,100,"2996"
D10127,1,06/12/2021,PFC32WDE11,17,"2979"
D10127,1,06/12/2021,PFC32WGEVN,17,"2962"
D10127,1,06/12/2021,PFC32WOUWN,17,"2945"
D10127,1,06/13/2021,PFD849M7GU,100,"2845"
D10127,1,06/13/2021,PFD649OTGY,100,"2745"
D10127,1,06/13/2021,PFD14A03EP,17,"2728"
D10127,1,06/13/2021,PFD14A1W9Z,17,"2711"
D10127,1,06/14/2021,PFE15OLJCP,100,"2611"
D10127,1,06/14/2021,PFE95OQYXH,100,"2511"
D10127,1,06/14/2021,PFE35OTVRR,17,"2494"
D10127,1,06/15/2021,PFF672J90O,100,"2394"
D10127,1,06/15/2021,PFF772U0NZ,100,"2294"
D10127,1,06/15/2021,PFF17338Z5,17,"2277"
D10127,1,06/20/2021,PFK2CYGCM6,100,"2177"
D10127,1,06/20/2021,PFK3CYJWCT,100,"2077"
D10127,1,06/20/2021,PFK3CYODS7,100,"1977"
D10127,1,06/20/2021,PFK9CYT10D,100,"1877"
D10127,1,06/20/2021,PFK4CYVNFY,100,"1777"
D10127,1,06/20/2021,PFK0CYYZFA,100,"1677"
D10127,1,06/20/2021,PFK0CZ1HXC,100,"1577"
D10127,1,06/20/2021,PFK1DT1MAB,100,"1477"
D10127,1,06/21/2021,PFL4F3CJOG,100,"1377"
D10127,1,06/21/2021,PFL3F3HCLP,100,"1277"
D10127,1,06/21/2021,PFL3F3M6CF,17,"1260"
D10127,1,06/22/2021,PFM0GFAZNQ,100,"1160"
D10127,1,06/22/2021,PFM2GFFAHO,100,"1060"
D10127,1,06/23/2021,PFN3HVOTC5,1060,0
D10127,2,06/27/2021,PFR2NCE66Q,130,"3770"
D10127,2,06/28/2021,PFS4OTAOLQ,130,"3640"
D10127,2,06/28/2021,PFS3OTH6JX,130,"3510"
D10127,2,06/29/2021,PFT0QACPRA,130,"3380"
D10127,2,07/01/2021,PG13T6QS4F,130,"3250"
D10127,2,07/02/2021,PG24UOZV72,130,"3120"
D10127,2,07/04/2021,PG46XGQ92A,130,"2990"
D10127,2,07/15/2021,PGF7E2KE7P,1300,"1690"
D10127,2,07/18/2021,PGI6IDEOKM,500,"1190"
D10127,2,07/18/2021,PGI5IDWW87,30,"1160"
D10127,2,07/18/2021,PGI1IDYHMH,30,"1130"
D10127,2,07/24/2021,PGO0R0PCGK,1130,0
D10127,3,11/26/2021,PKQ38VGODL,400,"3410"
D10127,3,11/27/2021,PKR8AR9L4W,570,"2840"
D10127,3,12/06/2021,PL61Q154MN,985,"1855"
D10127,3,12/11/2021,PLB9YT561T,1855,0
D10127,4,01/10/2022,QAA3F3BJEL,"4550",0
D10127,5,02/07/2022,QB72SM9YHM,"3900",0
D10127,6,03/11/2022,QCB2IJQIUQ,"3900",0
D10127,7,04/11/2022,QDB47JQ55M,"4080",0
D10127,8,02/04/2023,RB44X8RMLI,570,"3510"
D10127,8,02/05/2023,RB55ZNE8CN,80,"3430"
D10127,8,02/07/2023,RB7846YJIC,160,"3270"
D10127,8,02/08/2023,RB818D0E5B,127,"3143"
D10127,8,02/13/2023,RBD6LM3RO4,460,"2683"
D10127,8,02/14/2023,RBE6OBWOXC,130,"2553"
D10127,8,02/15/2023,RBF4R14F8Y,130,"2423"
D10127,8,02/17/2023,RBH6V85AIO,130,"2293"
D10127,8,02/20/2023,RBK84V2J7K,200,"2093"
D10127,8,02/22/2023,RBM48TI1YO,250,"1843"
D10127,8,02/23/2023,RBN9A0HNEP,100,"1743"
D10127,8,02/24/2023,RBO8CL8AIY,130,"1613"
D10127,8,02/24/2023,RBO6E1677Q,150,"1463"
D10127,8,02/25/2023,RBP4GA1KPC,150,"1313"
D10127,8,02/27/2023,RBR9LYS2S1,133,"1180"
D10127,8,02/28/2023,RBS4OFU2LM,300,880
D10127,8,02/28/2023,RBS7POZCCJ,300,580
D10127,8,03/01/2023,RC14RITUUA,580,0
D10127,9,3/28/2023,RCS3SZWFW1,390,"3510"
D10127,9,3/30/2023,RCU5ZPNRH3,130,"3380"
D10127,9,04-01-2023 0:00:00,RD136UFIXL,320,"3060"
D10127,9,04-02-2023 0:00:00,RD209CYSDO,200,"2860"
D10127,9,04-07-2023 0:00:00,RD71N5WADD,604,"2256"
D10127,9,04-07-2023 0:00:00,RD78N7CHYK,50,"2206"
D10127,9,04-12-2023 0:00:00,RDC8YHJWWY,260,"1946"
D10127,9,4/15/2023,RDF5A1EGXB,295,"1651"
D10127,9,4/16/2023,RDG0CIF4G0,394,"1257"
D10127,9,04/20/2022,RDK8LNYL22,400,857
D10127,9,04/22/2023,RDM5T3SQHR,857,0
D10127,10,06/13/2023,RFD9Y4Z51Z,570,"3510"
D10127,10,06/13/2023,RFD8ZGP7PA,330,"3180"
D10127,10,07/03/2023,RG37KQ311V,200,"2980"
D10127,,,,,
D10128,1,06/01/2021,PF11MOC0BR,"1000","5500"
D10128,1,06/02/2021,PF23O2SPRH,625,"4875"
D10128,1,06/15/2021,PFF271WRFU,60,"4815"
D10128,1,06/23/2021,PFN1GWXX1V,"4815",0
D10128,2,07/04/2021,PG47XFPQFD,500,"6000"
D10128,2,07/06/2021,PG691F5TZT,50,"5950"
D10128,2,07/13/2021,PGD3B7XP8J,100,"5850"
D10128,2,07/14/2021,PGE3CMMA61,40,"5810"
D10128,2,07/16/2021,PGG5EDSE9R,200,"5610"
D10128,2,07/17/2021,PGH2H1SRVI,60,"5550"
D10128,2,07/17/2021,PGH3H2V2UV,150,"5400"
D10128,2,07/21/2021,PGL7LNOT2N,5400,0
D10128,3,08/19/2021,PHJ0SSTCDU,"6800",0
D10129,1,06/07/2021,PF78UZ0JPY,"7000","6000"
D10129,1,06/23/2021,PFN2GQJAA6,"6000",0
D10129,2,07/27/2021,PGR6V0DVNS,"8000","5600"
D10129,2,07/28/2021,PGS7VQ9IIP,"3700","1900"
D10129,2,07/28/2021,PGS8VXIL4G,"1900",0
D10130,1,06/04/2021,PF42PREO02,570,"7330"
D10130,1,06/11/2021,PFB5ZHJLYJ,500,"6830"
D10130,1,06/23/2021,PFN3HH7YH1,"2785","4045"
D10130,1,07/01/2021,PG15RZE2Z7,400,"3645"
D10130,1,07/06/2021,PG65YZVVL3,400,"3245"
D10130,1,07/08/2021,PG832ZH2TN,200,"3045"
D10130,1,07/28/2021,PGS5WOQ2YR,80,"2965"
D10130,1,07/28/2021,PGS2WOTOYO,40,"2925"
D10130,1,08/19/2021,PHJ8SX6PGU,2925,0
D10131,1,06/03/2021,PF34P0BOU4,813,"2437"
D10131,1,06/10/2021,PFA4YPU9QK,813,"1624"
D10131,1,06/17/2021,PFH59HLQLL,813,811
D10131,1,06/24/2021,PFO0IXE6QS,811,0
D10131,2,07/02/2021,PG25UDNNXX,813,"2437"
D10131,2,07/09/2021,PG915HH5IJ,813,"1624"
D10131,2,07/17/2021,PGH6GPB3N8,813,811
D10131,2,07/23/2021,PGN1PGSOML,811,0
D10131,3,08/04/2021,PH437RFSPL,975,"2925"
D10131,3,08/15/2021,PHF0MLMYDS,975,"1950"
D10131,3,08/19/2021,PHJ2T6EVSY,975,975
D10131,3,08/24/2021,PHO2ZQWBXK,975,0
D10131,4,09/08/2021,PI82NN18V6,975,"2925"
D10131,4,09/13/2021,PID6U1HA4Y,975,"1950"
D10131,4,09/21/2021,PIL988IWPX,"1740",210
D10131,4,09/22/2021,PIM79RCT4V,210,0
D10131,5,10/06/2021,PJ69UB1R73,975,"2925"
D10131,5,10/12/2021,PJC660D5BG,975,"1950"
D10131,5,10/21/2021,PJL4JNJ0VW,975,975
D10131,5,10/25/2021,PJP3Q2SW2N,975,0
D10131,6,11/06/2021,PK60AVGED6,975,"2925"
D10131,6,11/13/2021,PKD7M4JOR1,975,"1950"
D10131,6,11/18/2021,PKI6U8ZQNE,975,975
D10131,6,11/24/2021,PKO54PTAJN,975,0
D10131,7,12/01/2021,PL17HCYG85,"1138","3412"
D10131,7,12/22/2021,PLM9IF63QV,"3314",98
D10131,7,12/22/2021,PLM4IFA0CY,100,2
D10131,8,01/31/2022,QAV8FX3WX2,"4550",0
D10131,8,01/31/2022,QAV0FXGV9G,2,2
D10131,9,02/22/2022,QBM4KRJXTQ,"3500","1050"
D10131,9,03/01/2022,,"1050",0
D10131,10,03/14/2022,QCE1NG2B77,"1000","6150"
D10131,10,03/30/2022,QCU6IJ1XLO,"6150",0
D10132,1,05/28/2021,PES1HBS573,100,"2750"
D10132,1,05/28/2021,PES0HBU138,9,"2741"
D10132,1,05/29/2021,PET2IQMP6A,100,"2641"
D10132,1,05/29/2021,PET9IQPGB3,9,"2632"
D10132,1,05/31/2021,PEV6L89ZGW,100,"2532"
D10132,1,05/31/2021,PEV7L8EZFJ,90,"2442"
D10132,1,06/02/2021,PF26O0Y09Y,246,"2196"
D10132,1,06/05/2021,PF51S6T9IB,218,"1978"
D10132,1,06/07/2021,PF77V2OOAV,109,"1869"
D10132,1,06/08/2021,PF85W0VE0X,1800,69
D10132,1,06/08/2021,PF81W17H4P,69,0
D10132,2,06/09/2021,PF91XSSQ01,109,"3141"
D10132,2,06/13/2021,PFD849IL74,190,"2951"
D10132,2,06/16/2021,PFG18GPREV,130,"2821"
D10132,2,06/17/2021,PFH29UTV0I,120,"2701"
D10132,2,06/18/2021,PFI2B7JWZS,100,"2601"
D10132,2,06/18/2021,PFI3B7LMGL,40,"2561"
D10132,2,06/19/2021,PFJ3CITOJV,100,"2461"
D10132,2,06/19/2021,PFJ9CIVZ2B,30,"2431"
D10132,2,06/26/2021,PFQ8M3QMLY,100,"2331"
D10132,2,06/29/2021,PFT8Q7P12M,327,"2004"
D10132,2,06/30/2021,PFU3ROQ3VH,300,"1704"
D10132,2,07/02/2021,PG23TIMJMD,340,"1364"
D10132,2,07/03/2021,PG32USILA0,250,"1114"
D10132,2,07/03/2021,PG39USK8BR,250,864
D10132,2,07/06/2021,PG69ZVJTDH,864,0
D10132,3,07/08/2021,PG85473PU1,100,"3150"
D10132,3,07/08/2021,PG81475JB5,9,"3141"
D10132,3,07/09/2021,PG935PUPFX,218,"2923"
D10132,3,07/16/2021,PGG4EZ126Q,218,"2705"
D10132,3,07/20/2021,PGK0L7ADVI,100,"2605"
D10132,3,07/22/2021,PGM1O2B4M3,300,"2305"
D10132,3,07/27/2021,PGR9UROPAN,327,"1978"
D10132,3,07/28/2021,PGS2WO7OUK,327,"1651"
D10132,3,07/31/2021,PGV7ZYUTWH,218,"1433"
D10132,3,08/01/2021,PH103C3SMC,300,"1133"
D10132,3,08/03/2021,PH264XOULO,323,810
D10132,3,08/03/2021,PH385DHB9S,810,0
D10132,4,08/09/2021,PH92F7A668,109,"3291"
D10132,4,08/10/2021,PHA1GMAEAJ,109,"3182"
D10132,4,08/15/2021,PHF5NLD87X,130,"3052"
D10132,4,08/19/2021,PHJ2SA5Y28,100,"2952"
D10132,4,08/19/2021,PHJ6SA7NQ2,100,"2852"
D10132,4,08/23/2021,PHN2YXB9VY,200,"2652"
D10132,4,09/02/2021,PI25E4VBCX,2502,150
D10132,4,09/02/2021,PI21E6JAWP,100,50
D10132,4,09/02/2021,PI29E6QWIN,50,0
D10132,5,02/09/2022,QB98WNWJW0,100,"3150"
D10132,5,02/09/2022,QB90WO0KCM,10,"3140"
D10132,5,02/10/2022,QBA6YHTV8M,100,"3040"
D10132,5,02/10/2022,QBA1YHXT3F,10,"3030"
D10132,5,02/14/2022,QBE75MVZ4F,100,"2930"
D10132,5,02/14/2022,QBE35MZPZB,50,"2880"
D10132,5,02/14/2022,QBE75T6XD1,100,"2780"
D10132,5,02/18/2022,QBI2CSVP7O,40,"2740"
D10132,5,02/20/2022,QBK8HDT51S,100,"2640"
D10132,5,02/21/2022,QBL3J5PMN9,100,"2540"
D10132,5,02/23/2022,QBN0LDI440,100,"2440"
D10132,5,02/26/2022,QBQ3QU9EGX,100,"2340"
D10132,5,03/02/2022,QC28ZSBOI2,100,"2240"
D10132,5,03/05/2022,QC585KUI78,100,"2140"
D10132,5,03/05/2022,QC545KWS04,30,"2110"
D10132,5,03/07/2022,QC78AEKUA4,100,"2010"
D10132,5,03/07/2022,QC72AFS324,100,"1910"
D10132,5,03/08/2022,QC85CEW8SB,500,"1410"
D10132,5,03/08/2022,QC85CFEUFJ,1410,0
D10132,6,03/10/2022,QCA7G2ADGP,100,"3150"
D10132,6,03/10/2022,QCA3G2GS3X,30,"3120"
D10132,6,03/10/2022,QCA8GQEDFE,100,"3020"
D10132,6,03/12/2022,QCC3K4FX65,100,"2920"
D10132,6,03/12/2022,QCC5K4OB1P,20,"2900"
D10132,6,03/14/2022,QCE5OBHJXL,220,"2680"
D10132,6,03/15/2022,QCF1PNE21V,200,"2480"
D10132,6,03/15/2022,QCF8PUZSAK,20,"2460"
D10132,6,03/19/2022,QCJ0WZB8OU,100,"2360"
D10132,6,03/19/2022,QCJ8WZIWFG,100,"2260"
D10132,6,03/19/2022,QCJ1WZNCC7,20,"2240"
D10132,6,03/22/2022,QCM93JJWVF,100,"2140"
D10132,6,03/22/2022,QCM03JT5I6,100,"2040"
D10132,6,03/23/2022,QCN55DK9ZD,100,"1940"
D10132,6,03/23/2022,QCN05DNPCM,30,"1910"
D10132,6,03/24/2022,QCO27WZTDG,100,"1810"
D10132,6,03/24/2022,QCO47X7DNQ,20,"1790"
D10132,6,03/25/2022,QCP59N4FDL,10,"1780"
D10132,6,03/26/2022,QCQ4BSLV7Q,100,"1680"
D10132,6,03/28/2022,QCS9F1D0UZ,100,"1580"
D10132,6,03/28/2022,QCS7F1GD1B,50,"1530"
D10132,6,03/31/2022,QCV7KQ9S2H,100,"1430"
D10132,6,03/31/2022,QCV8KRFJRU,20,"1410"
D10132,6,03/31/2022,QCV4LB84GY,100,"1310"
D10132,6,04/01/2022,QD15O1B1H1,100,"1210"
D10132,6,04/01/2022,QD12O1BV9Q,100,"1110"
D10132,6,04/03/2022,QD32RXXDQ0_D2,850,260
D10132,6,04/05/2022,QD58U6VQT6,260,0
D10132,7,04/06/2022,QD62XZZ0WW,95,"3060"
D10132,7,04/09/2022,QD9553ROQP,100,"2960"
D10132,7,04/09/2022,QD9653UL0W,20,"2940"
D10132,7,04/13/2022,QDD6BWO0F4,100,"2840"
D10132,7,04/13/2022,QDD9BWQKL9,100,"2740"
D10132,7,04/16/2022,QDG3GWU7X5,100,"2640"
D10132,7,04/16/2022,QDG4HE7S0I,100,"2540"
D10132,7,04/19/2022,QDJ5NJF3LT,100,"2440"
D10132,7,04/19/2022,QDJ9NJG5O7,50,"2390"
D10132,7,04/21/2022,QDL3QGP7G3,100,"2290"
D10132,7,04/22/2022,QDM0RHADLC,100,"2190"
D10132,7,04/24/2022,QDO0VSMWQQ,100,"2090"
D10132,7,04/24/2022,QDO9W0Z7HX,50,"2040"
D10132,7,04/25/2022,QDP0Y47BZO,300,"1740"
D10132,7,04/26/2022,QDQ716W99P,250,"1490"
D10132,7,04/27/2022,QDR220E66O,90,"1400"
D10132,7,04/27/2022,QDR32B2SVJ,100,"1300"
D10132,7,04/27/2022,QDR92BH3JH,100,"1200"
D10132,7,04/27/2022,QDR62XD3TQ,100,"1100"
D10132,7,04/28/2022,QDS04F2HYS,1000,100
D10132,7,04/28/2022,QDS34CWIAR,100,0
D10132,9,05/28/2022,QES0S3ZRWA,100,"3710"
D10132,9,05/28/2022,QES1S42JZ3,30,"3680"
D10132,9,05/31/2022,QEV6WPHK48,100,"3580"
D10132,9,06/01/2022,QF11ZX2BK5,70,"3510"
D10132,9,06/02/2022,QF292UGWOZ,100,"3410"
D10132,9,06/06/2022,QF62AWYU92,100,"3310"
D10132,9,06/07/2022,QF75CY587J,100,"3210"
D10132,9,06/08/2022,QF84EZC1CK,100,"3110"
D10132,9,06/09/2022,QF90FMHZA6,50,"3060"
D10132,9,06/09/2022,QF94GVHX02,100,"2960"
D10132,9,06/09/2022,QF94GVNBNA,50,"2910"
D10132,9,06/11/2022,QFB4L4CAYI,100,"2810"
D10132,9,06/11/2022,QFB0L4COUY,50,"2760"
D10132,9,06/12/2022,QFC6MV7GI2,100,"2660"
D10132,9,06/12/2022,QFC6MV9SG0,50,"2610"
D10132,9,06/14/2022,QFE4PQZLAC,100,"2510"
D10132,9,06/14/2022,QFE4PR46FW,100,"2410"
D10132,9,06/16/2022,QFD0TDZLXE,100,"2310"
D10132,9,06/16/2022,QFG2TE2KP2,100,"2210"
D10132,9,06/18/2022,QFI9YVCV33,100,"2110"
D10132,9,06/19/2022,QFJ5ZGZK59,100,"2010"
D10132,9,06/20/2022,QFK6224JFE,100,"1910"
D10132,9,06/20/2022,QFK737J3J1,100,"1810"
D10132,9,06/21/2022,QFL644873U,1810,0
D10132,8,05/01/2022,QE14ALSZGY,100,"3800"
D10132,8,05/04/2022,QE41F9Y6JD,100,"3700"
D10132,8,05/05/2022,QE55HZL6Q5,100,"3600"
D10132,8,05/05/2022,QE52HZR4AY,100,"3500"
D10132,8,05/05/2022,QE54I82YTS,60,"3440"
D10132,8,05/06/2022,QE62INW4Z0,60,"3380"
D10132,8,05/07/2022,QE73LLBRFX,100,"3280"
D10132,8,05/12/2022,QEC5V7TAVH,100,"3180"
D10132,8,05/13/2022,QED3XIKQCJ,100,"3080"
D10132,8,05/13/2022,QED1XIO05B,100,"2980"
D10132,8,05/17/2022,QEH35GKV0B,100,"2880"
D10132,8,05/17/2022,QEH45GOEIW,100,"2780"
D10132,8,05/17/2022,QEH96VRRWV,100,"2680"
D10132,8,05/20/2022,QEK4CLMJGE,100,"2580"
D10132,8,05/20/2022,QEK1CLNX2P,100,"2480"
D10132,8,05/23/2022,QEN9I9JUWL,100,"2380"
D10132,8,05/23/2022,QEN2I9LM8O,90,"2290"
D10132,8,05/24/2022,QEO9IWWJQH,100,"2190"
D10132,8,05/25/2022,QEP6M408UC,100,"2090"
D10132,8,05/25/2022,QEP2M43RUQ,100,"1990"
D10132,8,05/26/2022,QEQ3MTKWAP,1990,0
D10132,10,06/30/2022,QFU3NAQN8X,100,"5100"
D10132,10,06/30/2022,QFU0NASSBU,100,"5000"
D10132,10,07/01/2022,QG16PIBH0A,100,"4900"
D10132,10,07/01/2022,QG16PICO4I,100,"4800"
D10132,10,07/02/2022,QG22RNPGJW,100,"4700"
D10132,10,07/03/2022,QG37SW1VEV,100,"4600"
D10132,10,07/07/2022,QG791O22R3,100,"4500"
D10132,10,07/07/2022,QG761TZG7I,100,"4400"
D10132,10,07/08/2022,QG813N6QC1,100,"4300"
D10132,10,07/08/2022,QG833NIW75,100,"4200"
D10132,10,07/12/2022,QGC5BRPH3R,100,"4100"
D10132,10,07/12/2022,QGC3BRSI2R,100,"4000"
D10132,10,07/13/2022,QGD5FE2NVP,100,"3900"
D10132,10,07/13/2022,QGD7FE3NDT,100,"3800"
D10132,10,07/14/2022,QGE3FW9HQJ,100,"3700"
D10132,10,07/16/2022,QGG3LFFJHL,200,"3500"
D10132,10,07/18/2022,QGI7ONI8V3,100,"3400"
D10132,10,07/18/2022,QGI4P9LO4G,400,"3000"
D10132,10,07/18/2022,QGI4NS50VM,300,"2700"
D10132,10,07/19/2022,QGJ0PV2E5I,2700,0
D10132,11,07/27/2022,QGR77DV6HX,100,"5340"
D10132,11,07/27/2022,QGR27E07ZY,100,"5240"
D10132,11,08/01/2022,QH19HYP2UB,200,"5040"
D10132,11,08/03/2022,QH32LRT8TI,100,"4940"
D10132,11,08/03/2022,QH33LSB1BB,100,"4840"
D10132,11,08/04/2022,QH41OCLS2T,100,"4740"
D10132,11,08/04/2022,QH41OCNAE3,100,"4640"
D10132,11,08/10/2022,QHA510OBVN,100,"4540"
D10132,11,08/11/2022,QHB22TDI0U,50,"4490"
D10132,11,08/12/2022,QHC040PGSM,100,"4390"
D10132,11,08/13/2022,QHD14QFL5F,100,"4290"
D10132,11,08/14/2022,QHE177BC63,100,"4190"
D10132,11,08/14/2022,QHE077EKHK,100,"4090"
D10132,11,08/18/2022,QHI8E66PN4,2000,"2090"
D10132,11,08/18/2022,QHI6E7LBJ4,2090,0
D10132,12,08/24/2022,QHO0PN6ATM,100,"5100"
D10132,12,08/24/2022,QHO2PN9C9E,70,"5030"
D10132,12,08/27/2022,QHR7W5173T,100,"4930"
D10132,12,08/30/2022,QHU93P8JE5,100,"4830"
D10132,12,08/30/2022,QHU03PB1WS,70,"4760"
D10132,12,08/31/2022,QHV55U8BJH,100,"4660"
D10132,12,09/01/2022,QI18626DW4,100,"4560"
D10132,12,09/01/2022,QI187YKEXK,60,"4500"
D10132,12,09/03/2022,QI36A80PFI,100,"4400"
D10132,12,09/03/2022,QI31CB6LGZ,100,"4300"
D10132,12,09/05/2022,QI68GGX0HQ,100,"4200"
D10132,12,09/06/2022,QI61HNXCJR,100,"4100"
D10132,12,09/07/2022,QI77KMFBKT,90,"4010"
D10132,12,09/08/2022,QI80MMB1WC,100,"3910"
D10132,12,09/08/2022,QI85MMF5LZ,100,"3810"
D10132,12,09/09/2022,QI99OUW1T3,100,"3710"
D10132,12,09/09/2022,QI91OWKJIX,100,"3610"
D10132,12,09/10/2022,QIA8QZS09K,100,"3510"
D10132,12,09/10/2022,QIA3QZVR4P,100,"3410"
D10132,12,09/12/2022,QIC6V4VGA4,100,"3310"
D10132,12,09/13/2022,QID8VU1RW2,100,"3210"
D10132,12,09/13/2022,QID7VZ7LYT,60,"3150"
D10132,12,09/13/2022,QID5WBB6C3,100,"3050"
D10132,12,09/14/2022,QIE3Z90PLN,100,"2950"
D10132,12,09/14/2022,QIE2Z93Q9K,100,"2850"
D10132,12,09/14/2022,QIE7Z97H45,50,"2800"
D10132,12,09/15/2022,QIF72HCA9R,400,"2400"
D10132,12,09/15/2022,QIF12HEW4R,100,"2300"
D10132,12,09/16/2022,QIG72U7DAF,2300,0
D10132,13,10/04/2022,QJ457BLSZX,100,"5340"
D10132,13,10/04/2022,QJ477BRE6R,100,"5240"
D10132,13,10/06/2022,QJ66DVOBES,100,"5140"
D10132,13,10/07/2022,QJ79F24F6R,60,"5080"
D10132,13,10/08/2022,QJ84J1CC3M,200,"4880"
D10132,13,10/09/2022,QJ92L2LUEE,100,"4780"
D10132,13,10/11/2022,QJB3NNLXYJ,100,"4680"
D10132,13,10/11/2022,QJB4OGH6BK,60,"4620"
D10132,13,10/11/2022,QJB5POBB7R,100,"4520"
D10132,13,10/11/2022,QJB0PODW06,100,"4420"
D10132,13,10/12/2022,QJC9RWJNNF,500,"3920"
D10132,13,10/15/2022,QJF2YVED0A,500,"3420"
D10132,13,10/16/2022,QJG9247CBX,700,"2720"
D10132,13,10/17/2022,QJH849U1S6,100,"2620"
D10132,13,10/17/2022,QJH349OSHL,100,"2520"
D10132,13,10/18/2022,QJH349OSHL_D2,500,"2020"
D10132,13,10/19/2022,QJJ9849ZYT,2020,0
D10132,14,10/27/2022,QJR5OVMA0X,200,"5000"
D10132,14,11/01/2022,QK1930DIZ5,100,"4900"
D10132,14,11/01/2022,QK1330H1D9,50,"4850"
D10132,14,11/02/2022,QK285D39OO,100,"4750"
D10132,14,11/03/2022,QK377X0BS3,100,"4650"
D10132,14,11/03/2022,QK387X1LKQ,100,"4550"
D10132,14,11/04/2022,QK49AD6CCV,100,"4450"
D10132,14,11/04/2022,QK47AD9BLX,100,"4350"
D10132,14,11/05/2022,QK55CSCO0J,100,"4250"
D10132,14,11/05/2022,QK57CSNGZD,100,"4150"
D10132,14,11/08/2022,QK83JVIABJ,200,"3950"
D10132,14,11/09/2022,QK98M8Y50Y,200,"3750"
D10132,14,11/10/2022,QKA5OO0W1J,100,"3650"
D10132,14,11/10/2022,QKA2OO26AG,30,"3620"
D10132,14,11/13/2022,QKD9UNAKE7,250,"3370"
D10132,14,11/13/2022,QKD7VLCJF9,100,"3270"
D10132,14,11/15/2022,QKF0155W7A,270,"3000"
D10132,14,11/16/2022,QKG33FNMUP,200,"2800"
D10132,14,11/17/2022,QKH94I8E87,2800,0
D10132,15,12/01/2022,QL151QP0KD,100,"5100"
D10132,15,12/01/2022,QL1542YY6F,100,"5000"
D10132,15,12/01/2022,QL14430WXM,50,"4950"
D10132,15,12/05/2022,QL56H6VS4K,100,"4850"
D10132,15,12/06/2022,QL62K8B8Z0,100,"4750"
D10132,15,12/08/2022,QL81Q394ZJ,100,"4650"
D10132,15,12/08/2022,QL88Q0329I,100,"4550"
D10132,15,12/09/2022,QL95QC4VB1,100,"4450"
D10132,15,12/09/2022,QL97R8LSHL,50,"4400"
D10132,15,12/09/2022,QL92SZWKV6,200,"4200"
D10132,15,12/10/2022,QLA8UYSJ9S,100,"4100"
D10132,15,12/11/2022,QLB4W1RD4C_D2,200,"3900"
D10132,15,12/11/2022,QLB4YA8BNS,200,"3700"
D10132,15,12/13/2022,QLD12N26WV,100,"3600"
D10132,15,12/13/2022,QLD62N945S,100,"3500"
D10132,15,12/14/2022,QLE573Z72L,900,"2600"
D10132,15,12/15/2022,QLF38P3DUJ,2600,0
D10132,16,12/25/2022,QLP41MJGJW,200,"5000"
D10132,16,12/27/2022,QLR85ZCWL8,100,"4900"
D10132,16,12/27/2022,QLR65ZELXI,50,"4850"
D10132,16,12/28/2022,QLS27XZKC0,100,"4750"
D10132,16,12/28/2022,QLS388J2QF,100,"4650"
D10132,16,12/29/2022,QLT1AP13O3,100,"4550"
D10132,16,12/29/2022,QLT9AP6HLF,100,"4450"
D10132,16,01/03/2023,RA38LV52SG,100,"4350"
D10132,16,01/03/2023,RA33M4W9UB,100,"4250"
D10132,16,01/03/2023,RA31MS6R71,150,"4100"
D10132,16,01/04/2023,RA40P5HI46,300,"3800"
D10132,16,01/06/2023,RA67S0D87B,200,"3600"
D10132,16,01/06/2023,RA65U8SAVX,100,"3500"
D10132,16,01/06/2023,RA65U9403J,100,"3400"
D10132,16,01/07/2023,RA74WUPHZA,100,"3300"
D10132,16,01/09/2023,RA94ZQEES2,100,"3200"
D10132,16,01/09/2023,RA92ZR7YKY,100,"3100"
D10132,16,01/10/2023,RAA82MUUIG,100,"3000"
D10132,16,01/10/2023,RAA42N3150,100,"2900"
D10132,16,01/11/2023,RAB25NY974,100,"2800"
D10132,16,01/11/2023,RAB95O47ZJ,100,"2700"
D10132,16,01/11/2023,RAB35UYZYZ,100,"2600"
D10132,16,01/12/2023,RAC49V7U98,500,"2100"
D10132,16,01/13/2023,RAD5AQXAP1,2100,0
D10132,17,01/19/2023,RAJ7R4HTKF,100,"5100"
D10132,17,01/19/2023,RAJ5R4JOAV,50,"5050"
D10132,17,01/21/2023,RAL1TUGKUL,200,"4850"
D10132,17,01/26/2023,RAP56BTUKT,100,"4750"
D10132,17,01/25/2023,RAP779R0OZ,100,"4650"
D10132,17,01/28/2023,RAS1F0KHGD,200,"4450"
D10132,17,02/03/2023,RB34SBIVO2,100,"4350"
D10132,17,02/03/2023,RB33TAERK3,100,"4250"
D10132,17,02/04/2023,RB47X7IGUD,100,"4150"
D10132,17,02/06/2023,RB693BEOJ3,200,"3950"
D10132,17,02/07/2023,RB7962J2OV,100,"3850"
D10132,17,02/08/2023,RB868LH4T2,300,"3550"
D10132,17,02/10/2023,RBA7C4F3LR,300,"3250"
D10132,17,02/10/2023,RBA9E28FJ1,200,"3050"
D10132,17,02/11/2023,RBB2ESQEC8,3050,0
D10132,18,02/20/2023,RBK0307NR0,100,"5340"
D10132,18,02/20/2023,RBK83UBN2O,100,"5240"
D10132,18,02/22/2023,RBM49ZLMSE,200,"5040"
D10132,18,03/03/2023,RC30Y27QOC,200,"4840"
D10132,18,03/08/2023,RC88AZ9PKO,300,"4540"
D10132,18,03/08/2023,RC84CPE0YE,200,"4340"
D10132,18,03/13/2023,RCD3Q1UTUR,1000,"3340"
D10132,18,03/14/2023,RCE1RAZD15,3580,240
D10132,19,03/20/2023,RCK49VSJOI,100,"5340"
D10132,19,03/24/2023,RCO6II84S0,100,"5240"
D10132,19,03/27/2023,RCR2RA0JK6,100,"5140"
D10132,19,03/29/2023,RCT5XCOB73,100,"5040"
D10132,19,04/11/2023,RDB2W04OJS,100,"4940"
D10132,19,04/11/2023,RDB0W114VG,100,"4840"
D10132,19,04/13/2023,RDD64IUDJW,400,"4440"
D10132,19,04/15/2023,RDF88T961U,4440,0
D10132,20,05/09/2023,RE964ZBDHQ,200,"5640"
D10132,20,05/13/2023,RED5HQQ7JP,200,"5440"
D10132,20,05/18/2023,REI1VIX5Q3,200,"5240"
D10132,20,06/01/2023,RF13ZFX339,300,"4940"
D10132,20,06/05/2023,RF59A6U4HR,650,"4290"
D10132,20,06/07/2023,RF77GLZVDL,700,"3590"
D10132,20,06/07/2023,RF76H0RKF2,3400,190
D10132,20,06/07/2023,RF75H1727V,90,100
D10132,20,06/07/2023,RF78H1FZ2S,100,0
D10132,21,06/09/2023,RF91O06C4F,100,"5100"
D10132,21,06/13/2023,RFD4ZCCGN6,100,"5000"
D10132,21,06/17/2023,RFH7BM6J3V,100,"4900"
D10132,21,06/19/2023,RFJ3GFHV6X,150,"4750"
D10132,21,06/22/2023,RFM0PVCL74,100,"4650"
D10132,21,06/26/2023,RFQ71XKOF9,100,"4550"
D10132,21,06/30/2023,RFU4E3EBLQ,100,"4450"
D10132,21,07/05/2023,RG59SZAYG1,500,"3950"
D10132,21,07/06/2023,RG68TUOI0C,3950,0
D10132,22,07/19/2023,RGJ0XQCQWG,200,"5000"
D10132,22,07/20/2023,RGK11S00R5,100,"4900"
D10132,22,07/20/2023,RGK91SJW3V,50,"4850"
D10132,22,07/26/2023,RGQ9IJS0JP,200,"4650"
D10132,22,07/28/2023,RGS1OCRYIL,150,"4500"
D10132,22,08/03/2023,RH36738YFY,500,"4000"
D10132,22,08/05/2023,RH56AURHZM,3000,"1000"
D10132,22,08/04/2023,RH45A6TVX1,1000,0
D10132,23,8/15/2023,RHF783ENOP,100,"5100"
D10132,23,8/14/2023,RHE051IN80,200,"4900"
D10132,23,8/12/2023 0:00:00,RHC1YE6T2V,200,"4700"
D10132,23,8/19/2023,RHJ6K41MHM,200,"4500"
D10133,1,06/04/2021,PF47QBJMYZ,"1350","5450"
D10133,1,06/05/2021,PF59S28CI1,300,"5150"
D10133,1,06/10/2021,PFA0Z1SCZE,"1000","4150"
D10133,1,06/28/2021,PFS0OE31OO,"4150",0
D10134,1,05/29/2021,PET8I8HRU8,500,"12500"
D10134,1,05/31/2021,PEV7L7VRUB,500,"12000"
D10134,1,06/01/2021,PF10MNFN0M,500,"11500"
D10134,1,06/02/2021,PF24N9J904,500,"11000"
D10134,1,06/03/2021,PF31PFM3MJ,500,"10500"
D10134,1,06/05/2021,PF55S4MJ7Z,"1000","9500"
D10134,1,06/07/2021,PF70V2OMPG,500,"9000"
D10134,1,06/08/2021,PF84WFS89C,500,"8500"
D10134,1,06/09/2021,PF92XOJLNC,500,"8000"
D10134,1,06/10/2021,PFA2Z48MSU,500,"7500"
D10134,1,06/11/2021,PFB31KEOSV,500,"7000"
D10134,1,06/14/2021,PFE15FNTR7,900,"6100"
D10134,1,06/15/2021,PFF970NI01,500,"5600"
D10134,1,06/17/2021,PFH69MIPBQ,1000,"4600"
D10134,1,06/23/2021,PFN9GQ4YQ3,4600,0
D10134,2,06/24/2021,PFO1J81I55,435,"12565"
D10134,2,06/25/2021,PFP3KNXEWL,435,"12130"
D10134,2,06/26/2021,PFQ9M3Z4JB,435,"11695"
D10134,2,07/01/2021,PG18T63NBQ,2200,"9495"
D10134,2,07/07/2021,PG722QT3TS,1000,"8495"
D10134,2,07/13/2021,PGD0ALIQ9Q,"2000","6495"
D10134,2,07/18/2021,PGI4IAUN5S,3300,"3195"
D10134,2,07/20/2021,PGK5KS4P9J,700,"2495"
D10134,2,07/22/2021,PGL6MC8J14,1800,695
D10134,2,07/22/2021,PGM2NPMTMG,695,0
D10134,3,08/06/2021,PH69AGYHP7,"3000","12600"
D10134,3,08/12/2021,PHC4JDVSUI,"1500","11100"
D10134,3,08/13/2021,PHD8KNJICG,"1500","9600"
D10134,3,08/14/2021,PHE5M1HTKV,1600,"8000"
D10134,3,08/16/2021,PHG1NS749F,1300,"6700"
D10134,3,08/18/2021,PHI3RB7GGB,"2500","4200"
D10134,3,08/20/2021,PHK8UPXQGI,1000,"3200"
D10134,3,08/21/2021,PHL3VVEO0X,3200,0
D10134,4,09/16/2021,PIG4ZKW5TS,"5000","10600"
D10134,4,09/20/2021,PIK75K2U7X,"4500","6100"
D10135,1,06/05/2021,PF58R8ZQ9S,"1300","5200"
D10135,1,06/06/2021,PF68TLXFVE,490,"4710"
D10135,1,06/14/2021,PFE04D9RXY,"1000","3710"
D10135,1,06/19/2021,PFJ1B90JRZ,600,"3110"
D10135,1,06/21/2021,PFL7EKN7GH,3110,0
D10135,2,07/06/2021,PG6810BUEW,500,"6300"
D10135,2,07/17/2021,PGH6FXDW1W,"4000","2300"
D10135,2,07/23/2021,PGN3OMAICH,"2000",300
D10135,2,07/23/2021,PGN2OMHDO2,200,100
D10135,2,07/23/2021,PGN1ONUCCP,100,0
D10135,3,09/28/2021,PIS3IAQMTX,764,"7136"
D10135,3,10/07/2021,PJ78WETOKO,"1000","6136"
D10135,3,11/08/2021,PK83DGFSHJ,468,"5668"
D10135,3,11/27/2021,PKR09K47WI,100,"5568"
D10135,3,11/27/2021,PKR19K79J7,100,"5468"
D10135,3,11/27/2021,PKR39KDIV7,61,"5407"
D10135,3,11/27/2021,PKR39VTKLX,100,"5307"
D10135,3,12/26/2021,PLQ4PI2LV2,100,"5207"
D10136,1,06/04/2021,PF44QII7VO,"1650","4850"
D10136,1,06/13/2021,PFD5462XKP,"1325","3525"
D10136,1,06/13/2021,PFD84689RO,100,"3425"
D10136,1,06/14/2021,PFE25OUF3A,200,"3225"
D10136,1,06/19/2021,PFJ0CD86LA,1000,"2225"
D10136,1,06/20/2021,PFK0DNU1JE,2270,45
D10136,2,07/05/2021,PG56XNQFUE,625,"5875"
D10136,2,07/09/2021,PG984UW48A,"4000","1875"
D10136,2,07/09/2021,PG964V35HG,"1875",0
D10136,3,07/29/2021,PGT8XVE92Y,"3000","6100"
D10136,3,07/31/2021,PGV413Q86K,"3100","3000"
D10136,3,08/02/2021,PH244JT8XQ,"3000",0
D10136,4,08/17/2021,PHH7PBAAY7,400,"10660"
D10136,4,08/19/2021,PHJ4T7XCHQ,500,"10160"
D10136,4,08/20/2021,PHK8UP661U,300,"9860"
D10136,4,08/26/2021,PHQ53JNT79,500,"9360"
D10136,4,10/02/2021,PJ28PF0HWE,500,"8860"
D10136,4,10/05/2021,PJ57U1DEQ3,500,"8360"
D10136,4,10/18/2021,PJI0ELN4D0,500,"7860"
D10137,1,05/30/2021,PEU7JEL49Z,350,"5500"
D10137,1,05/31/2021,PEV5KMURKV,400,"5100"
D10137,1,06/01/2021,PF15MGQRZJ,400,"4700"
D10137,1,06/02/2021,PF20NW8L56,400,"4300"
D10137,1,06/03/2021,PF33P8R0Q7,400,"3900"
D10137,1,06/04/2021,PF43QT5MBF,400,"3500"
D10137,1,06/05/2021,PF53SABG9T,400,"3100"
D10137,1,06/07/2021,PF76V1W55M,400,"2700"
D10137,1,06/09/2021,PF92XS2338,"1000","1700"
D10137,1,06/11/2021,PFB31D99RJ,400,"1300"
D10137,1,06/12/2021,PFC12QOFX1,500,800
D10137,1,06/13/2021,PFD249081K,700,100
D10137,1,06/14/2021,PFE65H340C,100,0
D10137,2,06/20/2021,PFK1DS7XMN,500,"5100"
D10137,2,06/21/2021,PFL4F5RCX2,500,"4600"
D10137,2,06/22/2021,PFM4GCJ3YA,500,"4100"
D10137,2,06/27/2021,PFR8MNVWSW,4100,0
D10138,1,06/07/2021,PF77TTR4VR,"3250","8250"
D10138,1,06/14/2021,PFE14M9ROP,"8250",0
D10138,2,06/21/2021,PFL1EG19RT,"6500","17500"
D10138,2,06/28/2021,PFS1NNMID7,"6500","11000"
D10138,2,07/02/2021,PG29TOC793,"11000",0
D10138,3,07/12/2021,PGC58QCT3H,"8500","22250"
D10138,3,07/19/2021,PGJ1IPUZ7L,"6000","16250"
D10138,3,07/23/2021,PGN3OG5KIZ,"7000","9250"
D10138,3,07/23/2021,PGN1OSLXOV,9250,0
D10138,4,08/02/2021,PH213OJXRF,"6000","39500"
D10138,4,08/16/2021,PHG2NX0J7K,"5000","34500"
D10138,4,08/20/2021,PHK6U0H9BE,"31600","2900"
D10138,4,08/20/2021,PHK0U1QYDQ,2800,100
D10138,4,08/20/2021,PHK4U2AFIY,100,0
D10138,5,09/08/2021,PI83MFI175,"2000","53300"
D10138,5,09/10/2021,PIA9PH2NPH,"4000","49300"
D10138,5,09/17/2021,PIH02BSC3E,"4000","45300"
D10138,5,09/19/2021,PIJ25A5B9W,3000,"42300"
D10138,5,09/30/2021,PIU2L5H2T8,2000,"40300"
D10138,5,10/04/2021,PJ45R7KTE3,4000,"36300"
D10138,5,10/06/2021,PJ64V23R3I,1200,"35100"
D10138,5,10/11/2021,PJB83BKHDY,6000,"29100"
D10138,5,10/14/2021,PJE87XDKJ6,500,"28600"
D10138,5,10/18/2021,PJI7EBU0MP,3000,"25600"
D10138,5,10/24/2021,PJO6OPPPRK,3150,"22450"
D10138,5,11/01/2021,PK111DE0IF,2000,"20450"
D10138,5,11/09/2021,PK97EP8J5B,500,"19950"
D10138,5,11/09/2021,PK98FEHPZM,1000,"18950"
D10138,5,11/10/2021,PKA0GHVTJS,1100,"17850"
D10138,5,11/11/2021,PKB2IP6VLQ,770,"17080"
D10138,5,11/12/2021,PKC6K8UK12,1400,"15680"
D10138,5,11/15/2021,PKF8PI28Q4,1050,"14630"
D10138,5,11/17/2021,PKH9S23H77,1000,"13630"
D10138,5,11/18/2021,PKI0U41C0S,1230,"12400"
D10138,5,11/20/2021,PKK6WCR6KE,1150,"11250"
D10138,5,11/23/2021,PKN43TUNY0,1050,"10200"
D10138,5,11/24/2021,PKO34RJXVJ,2150,"8050"
D10138,5,11/25/2021,PKP95VNP4V,1100,"6950"
D10138,5,11/26/2021,PKQ87Y0CB4,1450,"5500"
D10138,5,11/29/2021,PKT8CF1BMC,3100,"2400"
D10138,5,11/29/2021,PKT0CMR356,2400,0
D10138,6,12/11/2021,PLB7XWPMA5,"5200","6300"
D10138,6,12/13/2021,PLD923YO5B,"3500","2800"
D10138,6,12/13/2021,PLD72KPR49,"2800",0
D10138,7,12/31/2021,PLV6XKEA4K,"12000",0
D10138,8,01/22/2022,QAM6Y2LKCW,"1500","11500"
D10138,8,01/24/2022,QAO22B5AOK,"2700","8800"
D10138,8,01/24/2022,QAO62GMTW0,"2000","6800"
D10138,8,01/25/2022,QAP543R7G3,850,"5950"
D10138,8,01/26/2022,QAQ85UBBVA,900,"5050"
D10138,8,01/26/2022,QAQ37DEG21,5050,0
D10138,9,02/11/2022,QBB8YRMVUO,"3500","15700"
D10138,9,02/21/2022,QBL9I0LIMP,"8000","7700"
D10138,9,02/22/2022,QBM2JTW1G0,"7550",150
D10138,9,02/22/2022,QBM5JZ5TDT,150,0
D10138,10,03/12/2022,QCC0LAIAPG,"1000","19400"
D10138,10,03/22/2022,QCM94NHILB,650,"18750"
D10140,1,06/09/2021,PF93XIBMZ9,"1625","4875"
D10140,1,06/17/2021,PFH18UGB3X,"4875",0
D10140,2,06/29/2021,PFT2Q5OWKK,"1625","4875"
D10140,2,07/01/2021,PG19SMNGH3,"2600","2275"
D10140,2,07/02/2021,PG21TGHJ87,"2275",0
D10140,3,07/14/2021,PGE6C8Q1CW,"2600","7800"
D10140,3,07/15/2021,PGF0DRIOR6,"5000","2800"
D10140,3,07/16/2021,PGG9ED3T1T,"2800",0
D10140,4,08/12/2021,PHC2IFTTK6,"10400",0
D10140,5,09/08/2021,PI89MNESR5,"10400",0
D10140,6,10/06/2021,PJ68UBIZ9K,"10400",0
D10140,7,11/03/2021,PK3950MCFZ,"2440","9240"
D10140,7,11/05/2021,PK558ADXY7,470,"8770"
D10140,7,11/14/2021,PKE1MQXSIT,"1500","7270"
D10140,7,11/28/2021,PKS7BNV4BR,2000,"5270"
D10140,7,12/19/2021,PLJ7DMQNSZ,450,"4820"
D10140,7,12/26/2021,PLQ7Q1CZKN,450,"4370"
D10140,7,01/01/2022,QAK0VSIN2I,500,"3870"
D10141,1,06/10/2021,PFA7Z8YZ4B,"1600","4800"
D10141,1,06/25/2021,PFP0JF5UBK,"1500","3300"
D10141,1,06/18/2021,PFI2AECPPG,"1400","1900"
D10141,1,06/29/2021,PFT1P9NSVF,"1900",0
D10141,2,07/07/2021,PG791QQD3P,575,"5775"
D10141,2,07/19/2021,PGJ0J2VU08,"2100","3675"
D10141,2,07/21/2021,PGL1LF2E8B,"1600","2075"
D10141,2,07/23/2021,PGN0PG3XQW,2075,0
D10141,3,08/02/2021,PH283PK21W,"1500","5000"
D10141,3,08/09/2021,PH92E7FK92,"1600","3400"
D10141,3,08/16/2021,PHG2NX5SNU,"1250","2150"
D10141,3,08/21/2021,PHL2V6DPY8,2150,0
D10141,4,08/30/2021,PHU39NQ86V,"1600","4600"
D10141,4,09/06/2021,PI66JUHIU2,"1000","3600"
D10141,4,09/11/2021,PIB1R54RL7,"3600",0
D10141,5,09/22/2021,PIM98OLMTZ,"1650","4850"
D10141,5,09/28/2021,PIS6HXZJSE,"1200","3650"
D10141,5,10/05/2021,PJ52SUO9ME,"1200","2450"
D10141,5,10/09/2021,PJ98ZF9O8C,2450,0
D10141,6,10/19/2021,PJJ7FP2BE5,"1150","5350"
D10141,6,10/28/2021,PJS3UYYC6R,"1600","3750"
D10141,6,11/02/2021,PK273F6VI9,"1050","2700"
D10141,6,11/06/2021,PK66A4EYVS,2700,0
D10142,1,06/10/2021,PFA2Z85RYS,"2900","12900"
D10142,1,06/11/2021,PFB51K53K1,400,"12500"
D10142,1,06/17/2021,PFH89UWY7G,"3200","9300"
D10142,1,07/06/2021,PG64Z9YIJ4,"1950","7350"
D10142,1,07/28/2021,PGS7WH5OA9,200,"7150"
D10142,1,09/02/2021,PI22DZ27OQ,4950,"2200"
D10142,1,09/02/2021,Penalty waived,"2200",0
D10143,1,06/14/2021,PFE34OLOMN,"1625","5175"
D10143,1,06/30/2021,PFU6QG2SEU,"1007","4168"
D10143,1,06/30/2021,PFU5R1VGR3,"1335","2833"
D10143,1,03/07/2021,PG35V6YTS7,600,"2233"
D10143,1,03/07/2021,PG34V8BQGM,400,"1833"
D10144,1,06/09/2021,PF92XKXAT2,100,"4280"
D10144,1,06/09/2021,PF93XL17J7,30,"4250"
D10144,1,06/10/2021,PFA2YXICLY,100,"4150"
D10144,1,06/10/2021,PFA1YXLY7H,30,"4120"
D10144,1,06/11/2021,PFB01JTDSK,100,"4020"
D10144,1,06/11/2021,PFB51JYGSH,30,"3990"
D10144,1,06/12/2021,PFC92XRTPX,100,"3890"
D10144,1,06/12/2021,PFC62XTG38,30,"3860"
D10144,1,06/13/2021,PFD73V6M5P,100,"3760"
D10144,1,06/13/2021,PFD03V8RO2,30,"3730"
D10144,1,06/14/2021,PFE95IGF5P,100,"3630"
D10144,1,06/14/2021,PFE05JHTBO,30,"3600"
D10144,1,06/15/2021,PFF46ZWKZ6,100,"3500"
D10144,1,06/15/2021,PFF26ZYGFQ,30,"3470"
D10144,1,06/16/2021,PFG384YMZZ,100,"3370"
D10144,1,06/16/2021,PFG985IR0B,30,"3340"
D10144,1,06/18/2021,PFI7A64N4F,100,"3240"
D10144,1,06/18/2021,PFI5A65QIZ,30,"3210"
D10144,1,06/19/2021,PFJ8C1WC42,100,"3110"
D10144,1,06/20/2021,PFK1DP0EBX,100,"3010"
D10144,1,06/20/2021,PFK9DP4C1T,90,"2920"
D10144,1,06/20/2021,PFK9DOYC9R,100,"2820"
D10144,1,07/01/2021,PG15T6OUXX,100,"2720"
D10144,1,07/02/2021,PG23ULUYZN,100,"2620"
D10144,1,07/02/2021,PG25ULXR0T,30,"2590"
D10144,1,07/10/2021,PGA7601P2N,100,"2490"
D10144,1,07/10/2021,PGA0607HVY,100,"2390"
D10144,1,07/12/2021,PGC98R2ZJN,100,"2290"
D10144,1,07/28/2021,PGS7WODVA7,100,"2190"
D10144,1,08/04/2021,PH487VXYXU,100,"2090"
D10144,1,08/06/2021,PH63AV5TQR,100,"1990"
D10144,1,08/12/2021,PHC9IQZGIB,100,"1890"
D10144,1,08/16/2021,PHG7P1ZOAH,100,"1790"
D10144,1,08/31/2021,PHV5ABRPOD,100,"1690"
D10144,1,09/09/2021,PI96O50VSI,100,"1590"
D10144,1,09/17/2021,PIH31BQV8B,50,"1540"
D10144,1,09/28/2021,PIS9HUQ2YP,50,"1490"
D10144,1,10/06/2021,PJ62UGGYOC,50,"1440"
D10144,1,10/18/2021,PJI0EKGXU2,20,"1420"
D10145,1,06/18/2021,PFI4A3OCW8,"2000","4500"
D10145,1,06/25/2021,PFP9KMYWGZ,500,"4000"
D10145,1,06/28/2021,PFS1OTV2RX,100,"3900"
D10145,1,06/28/2021,PFS3OTWUXZ,400,"3500"
D10145,1,07/01/2021,PG10T5ERE6,700,"2800"
D10145,1,07/02/2021,PG24UNP1ZK,400,"2400"
D10145,1,07/04/2021,PG41XFLNJF,750,"1650"
D10145,1,07/06/2021,PG681CLTJ6,450,"1200"
D10145,1,07/08/2021,PG843J29TM,500,700
D10145,1,07/08/2021,PG863KFYWC,600,100
D10145,1,07/08/2021,PG803LADZ8,100,0
D10145,2,07/19/2021,PGJ8JTYK88,550,"6250"
D10145,2,07/21/2021,PGL8MJTYQS,400,"5850"
D10145,2,07/23/2021,PGN1PH5VOT,300,"5550"
D10145,2,08/01/2021,PH153C2B9D,800,"4750"
D10145,2,08/03/2021,PH306CP804,500,"4250"
D10145,2,08/06/2021,PH66ATWS34,3700,550
D10145,2,08/07/2021,PH76BD8C7U,550,0
D10145,3,08/19/2021,PHJ8S95ISU,"1625","5175"
D10145,3,08/31/2021,PHV1BPA32P,300,"4875"
D10145,3,09/05/2021,PI51J6O40X,"4575",300
D10145,3,09/10/2021,PIA6QDR7YE,300,0
D10146,1,06/14/2021,PFE44ORKQI,500,"13100"
D10146,1,06/15/2021,PFF65W3ZJC,900,"12200"
D10146,1,06/25/2021,PFP3K5NINT,500,"11700"
D10146,1,06/28/2021,PFS1NO7JPX,500,"11200"
D10146,1,07/05/2021,PG52XSSRJC,500,"10700"
D10146,1,07/08/2021,PG80437Q50,400,"10300"
D10146,1,07/12/2021,PGC59D7X53,500,"9800"
D10146,1,07/14/2021,PGE4BYGQ4I,500,"9300"
D10146,1,07/19/2021,PGJ8IKBU8G,500,"8800"
D10146,1,07/31/2021,PGV01DPIQM,100,"8700"
D10146,1,07/31/2021,PGV11DS7ED,50,"8650"
D10146,1,07/31/2021,PGV91DV88N,100,"8550"
D10146,1,08/15/2021,PHF2MLV67K,100,"8450"
D10146,1,09/24/2021,PIO2BSN9IS,200,"8250"
D10146,1,10/08/2021,PJ89XX19G7,100,"8150"
D10146,1,10/14/2021,PJE08G0H5Y,100,"8050"
D10146,1,10/18/2021,PJI6EQ35F8,200,"7850"
D10146,1,10/23/2021,PJN4M4GKWK,200,"7650"
D10146,1,11/05/2021,PK5988RQOL,200,"7450"
D10146,1,11/08/2021,PK86DWE41M,200,"7250"
D10146,1,11/20/2021,PKK2WJ4FHA,200,"7050"
D10146,1,11/26/2021,PKQ27PGWDO,200,"6850"
D10146,1,12/14/2021,PLE44QHXGS,200,"6650"
D10146,1,12/23/2021,,200,"6450"
D10146,1,01/03/2022,QA362UH0NO,200,"6250"
D10146,1,01/11/2022,QAB9FXO5J3,200,"6050"
D10146,1,01/14/2022,QAE0LJGOAA,200,"5850"
D10146,1,01/17/2022,QAH3QU5IBN,400,"5450"
D10146,1,01/20/2022,QAK5UTAVKZ,200,"5250"
D10146,1,01/28/2022,QAS6A62PAI,200,"5050"
D10146,1,02/05/2022,QB55OCDV0Z,200,"4850"
D10146,1,02/11/2022,QBC71JV989_D2,200,"4650"
D10146,1,02/28/2022,QBS4VJARMK,200,"4450"
D10146,1,03/07/2022,QC799WSNGB,200,"4250"
D10146,1,03/25/2022,QCP192LTBJ,200,"4050"
D10146,1,07/19/2022,QGJ3PW5XYT,200,"3850"
D10146,1,08/22/2022,QHM9LHAC09,200,"3650"
D10147,1,06/16/2021,PFG17MORYR,50,"6450"
D10147,1,06/16/2021,PFG37MLN7D,100,"6350"
D10147,1,06/16/2021,PFG17MORYR_D2,100,"6250"
D10147,1,06/17/2021,PFH594FIDV,50,"6200"
D10147,1,06/17/2021,PFH494ARZY,100,"6100"
D10147,1,06/17/2021,PFH2948T6Q,100,"6000"
D10147,1,06/18/2021,PFI8AEE96U,50,"5950"
D10147,1,06/18/2021,PFI7AEBIXL,100,"5850"
D10147,1,06/18/2021,PFI0AE8LLG,100,"5750"
D10147,1,06/21/2021,PFL9EJ0669,100,"5650"
D10147,1,06/21/2021,PFL7EJ9749,100,"5550"
D10147,1,06/21/2021,PFL3EJDRCX,50,"5500"
D10147,1,06/22/2021,PFM3G16QRR,100,"5400"
D10147,1,06/22/2021,PFM7G1B379,100,"5300"
D10147,1,06/22/2021,PFM7G1EZ83,50,"5250"
D10147,1,06/23/2021,PFN4HC8QLA,100,"5150"
D10147,1,06/23/2021,PFN0HCC3CO,100,"5050"
D10147,1,06/23/2021,PFN6HCFRNW,50,"5000"
D10147,1,06/24/2021,PFO6ILZE4E,100,"4900"
D10147,1,06/24/2021,PFO3IM1NPJ,100,"4800"
D10147,1,06/24/2021,PFO7IM7JGF,50,"4750"
D10147,1,06/25/2021,PFP7K3F2WP,100,"4650"
D10147,1,06/25/2021,PFP2K3I4AC,100,"4550"
D10147,1,06/25/2021,PFP6K3M2YU,50,"4500"
D10147,1,06/26/2021,PFQ4LNYPOC,100,"4400"
D10147,1,06/26/2021,PFQ5LO1DAL,100,"4300"
D10147,1,06/26/2021,PFQ4LO4OWE,50,"4250"
D10147,1,06/28/2021,PFS2NXLZIM,100,"4150"
D10147,1,06/28/2021,PFS3NXOCLF,100,"4050"
D10147,1,06/28/2021,PFS8NXR0XW,50,"4000"
D10147,1,06/30/2021,PFU3R9TQK7,100,"3900"
D10147,1,06/30/2021,PFU2R9XI1E,50,"3850"
D10147,1,06/30/2021,PFU0RA6NGI,100,"3750"
D10147,1,06/29/2021,PFT2PJKNTG,100,"3650"
D10147,1,06/29/2021,PFT0PJOHDM,100,"3550"
D10147,1,06/29/2021,PFT8PJTWBM,50,"3500"
D10147,1,07/01/2021,PG17S863Z7,100,"3400"
D10147,1,07/01/2021,PG14S88YW4,100,"3300"
D10147,1,07/01/2021,PG11S8HUQH,50,"3250"
D10147,1,07/02/2021,PG29U0WFOX,100,"3150"
D10147,1,07/02/2021,PG21U0YYZN,50,"3100"
D10147,1,07/02/2021,PG28U11HUY,100,"3000"
D10147,1,07/05/2021,PG59YD8TYL,100,"2900"
D10147,1,07/05/2021,PG56YDDMRW,100,"2800"
D10147,1,07/05/2021,PG56YDGJEA,50,"2750"
D10147,1,07/07/2021,PG792423AN,100,"2650"
D10147,1,07/07/2021,PG75244D25,50,"2600"
D10147,1,07/07/2021,PG76246M3Y,100,"2500"
D10147,1,07/08/2021,PG843VWFOE,100,"2400"
D10147,1,07/08/2021,PG843W02B6,50,"2350"
D10147,1,07/08/2021,PG843W4ACS,100,"2250"
D10147,1,07/10/2021,PGA260B3YI,2250,0
D10147,2,07/13/2021,PGD69X5T32,100,"6400"
D10147,2,07/13/2021,PGD89XLWNA,100,"6300"
D10147,2,07/13/2021,PGD09XP5T4,50,"6250"
D10147,2,07/13/2021,PGD0AZA2X0,100,"6150"
D10147,2,07/14/2021,PGE4BQO5GW,100,"6050"
D10147,2,07/14/2021,PGE5BQQHXH,100,"5950"
D10147,2,07/15/2021,PGF0DB86VQ,100,"5850"
D10147,2,07/15/2021,PGF3DBDXCB,100,"5750"
D10147,2,07/15/2021,PGF2DBH6EG,50,"5700"
D10147,2,07/16/2021,PGG1EWW9U9,100,"5600"
D10147,2,07/16/2021,PGG5EWZ4O1,100,"5500"
D10147,2,07/16/2021,PGG7EX7NEL,20,"5480"
D10147,2,07/17/2021,PGH3GH0HMV,450,"5030"
D10147,2,07/18/2021,PGI7IA5B5N,100,"4930"
D10147,2,07/18/2021,PGI9IA86I9,100,"4830"
D10147,2,07/18/2021,PGI6IAG2QY,50,"4780"
D10147,2,07/19/2021,PGJ5J9296P,100,"4680"
D10147,2,07/19/2021,PGJ2J95UIQ,100,"4580"
D10147,2,07/19/2021,PGJ9J99DFT,50,"4530"
D10147,2,07/20/2021,PGK5KN4PNF,100,"4430"
D10147,2,07/20/2021,PGK5KN785H,50,"4380"
D10147,2,07/20/2021,PGK5KNAOX5,100,"4280"
D10147,2,07/21/2021,PGL6LLANWY,100,"4180"
D10147,2,07/21/2021,PGL7LLE015,100,"4080"
D10147,2,07/21/2021,PGL0LLGE4Y,50,"4030"
D10147,2,07/22/2021,PGM5NNDGIR,100,"3930"
D10147,2,07/22/2021,PGM7NNH5XV,100,"3830"
D10147,2,07/22/2021,PGM6NNPXE8,50,"3780"
D10147,2,07/26/2021,PGQ9SN0YEZ,500,"3280"
D10147,2,07/27/2021,PGR8UQDTMS,100,"3180"
D10147,2,07/27/2021,PGR8UQHS4S,100,"3080"
D10147,2,07/27/2021,PGR2UQJLRY,50,"3030"
D10147,2,07/28/2021,PGS9VYNJ5R,100,"2930"
D10147,2,07/28/2021,PGS6VYP6V4,50,"2880"
D10147,2,07/28/2021,PGS6VYRC6G,100,"2780"
D10147,2,07/29/2021,PGT1XDQ5XL,100,"2680"
D10147,2,07/29/2021,PGT0XDSB0K,100,"2580"
D10147,2,07/29/2021,PGT3XDVGOL,50,"2530"
D10147,2,08/01/2021,PH1039DLM2,300,"2230"
D10147,2,08/02/2021,PH204EO9DG,220,"2010"
D10147,2,08/03/2021,PH325CFCMQ,2020,10
D10147,3,08/04/2021,PH4175W90D,100,"7700"
D10147,3,08/04/2021,PH4375YU89,100,"7600"
D10147,3,08/04/2021,PH457675ZF,100,"7500"
D10147,3,08/05/2021,PH528QH8MQ,100,"7400"
D10147,3,08/05/2021,PH538QKS79,100,"7300"
D10147,3,08/05/2021,PH598QOY1B,100,"7200"
D10147,3,08/06/2021,PH60A5CJJU,100,"7100"
D10147,3,08/06/2021,PH62A5FTJY,100,"7000"
D10147,3,08/06/2021,PH62A5J2II,100,"6900"
D10147,3,08/09/2021,PH97DT5FAZ,100,"6800"
D10147,3,08/09/2021,PH93DT7Y3H,100,"6700"
D10147,3,08/09/2021,PH91DTAFI1,100,"6600"
D10147,3,08/10/2021,PHA7FUS0DL,100,"6500"
D10147,3,08/10/2021,PHA9FV72VX,100,"6400"
D10147,3,08/10/2021,PHA0FVBCTM,100,"6300"
D10147,3,08/11/2021,PHB2HEELHO,100,"6200"
D10147,3,08/11/2021,PHB4HEH78G,100,"6100"
D10147,3,08/11/2021,PHB6HEKKNW,100,"6000"
D10147,3,08/12/2021,PHC6IUUDBY,100,"5900"
D10147,3,08/12/2021,PHC5IUXWCF,100,"5800"
D10147,3,08/12/2021,PHC9IV6SCJ,100,"5700"
D10147,3,08/13/2021,PHD7K733VD,100,"5600"
D10147,3,08/13/2021,PHD6K75VSK,100,"5500"
D10147,3,08/13/2021,PHD5K7A6V1,100,"5400"
D10147,3,08/14/2021,PHE3L4TF3L,100,"5300"
D10147,3,08/14/2021,PHE9L4XX4T,100,"5200"
D10147,3,08/14/2021,PHE4L50MFQ,100,"5100"
D10147,3,08/15/2021,PHF8NIDIWE,100,"5000"
D10147,3,08/15/2021,PHF5NILUKD,100,"4900"
D10147,3,08/15/2021,PHF2NIOFOI,100,"4800"
D10147,3,08/16/2021,PHG6OBJEGC,100,"4700"
D10147,3,08/16/2021,PHG9OBLYDB,100,"4600"
D10147,3,08/16/2021,PHG1OBOHJB,100,"4500"
D10147,3,08/17/2021,PHH9PRR0RN,100,"4400"
D10147,3,08/17/2021,PHH2PRU7YY,100,"4300"
D10147,3,08/17/2021,PHH1PRWV33,100,"4200"
D10147,3,08/18/2021,PHI2QYVKLK,100,"4100"
D10147,3,08/18/2021,PHI0QYY94I,100,"4000"
D10147,3,08/18/2021,PHI3QZ0Z89,100,"3900"
D10147,3,08/19/2021,PHJ4T1NYUW,100,"3800"
D10147,3,08/19/2021,PHJ5T2VOA9,100,"3700"
D10147,3,08/19/2021,PHJ6T2ZX1Q,100,"3600"
D10147,3,08/20/2021,PHK2U8QBNY,100,"3500"
D10147,3,08/20/2021,PHK3U8Z4V5,100,"3400"
D10147,3,08/20/2021,PHK9U9ZHF3,100,"3300"
D10147,3,08/22/2021,PHM3X5FADR,100,"3200"
D10147,3,08/22/2021,PHM0X5MKZK,100,"3100"
D10147,3,08/22/2021,PHM1X5YBXF,100,"3000"
D10147,3,08/23/2021,PHN8XZVSP6,100,"2900"
D10147,3,08/23/2021,PHN5Y000XX,100,"2800"
D10147,3,08/23/2021,PHN1Y07NGL,100,"2700"
D10147,3,08/24/2021,PHO1ZQ4ENT,100,"2600"
D10147,3,08/24/2021,PHO3ZQ7E0V,100,"2500"
D10147,3,08/24/2021,PHO5ZQB7VZ,100,"2400"
D10147,3,08/25/2021,PHP62K231S,100,"2300"
D10147,3,08/25/2021,PHP62K97TE,100,"2200"
D10147,3,08/25/2021,PHP82KDD7S,100,"2100"
D10147,3,08/26/2021,PHQ231S4VA,2100,0
D10147,4,08/28/2021,PHS86NX53S,260,"7540"
D10147,4,08/27/2021,PHR74Y6CHJ,260,"7280"
D10147,4,08/29/2021,PHT985AYS9,100,"7180"
D10147,4,08/29/2021,PHT085GY52,100,"7080"
D10147,4,08/29/2021,PHT385P7V7,100,"6980"
D10147,4,08/30/2021,PHU39L4T91,100,"6880"
D10147,4,08/30/2021,PHU89L7NSU,100,"6780"
D10147,4,08/30/2021,PHU39LC5ER,60,"6720"
D10147,4,08/31/2021,PHV0B3WYKA,100,"6620"
D10147,4,08/31/2021,PHV9B3ZFGT,100,"6520"
D10147,4,08/31/2021,PHV9B42B0L,60,"6460"
D10147,4,09/01/2021,PI10CQUBN8,100,"6360"
D10147,4,09/01/2021,PI10CQZI18,100,"6260"
D10147,4,09/01/2021,PI16CR8YW8,60,"6200"
D10147,4,09/02/2021,PI21EEYMBL,100,"6100"
D10147,4,09/02/2021,PI20EF77JS,100,"6000"
D10147,4,09/02/2021,PI26EFB0OW,60,"5940"
D10147,4,09/03/2021,PI30FIQ2JU,100,"5840"
D10147,4,09/03/2021,PI33FISSNL,60,"5780"
D10147,4,09/03/2021,PI34FIW572,100,"5680"
D10147,4,09/04/2021,PI47H5BC1V,100,"5580"
D10147,4,09/04/2021,PI49H5FED5,100,"5480"
D10147,4,09/04/2021,PI43H5IJX1,60,"5420"
D10147,4,09/05/2021,PI50IZ0H46,100,"5320"
D10147,4,09/05/2021,PI53IZ71V1,100,"5220"
D10147,4,09/05/2021,PI55IZB3FN,60,"5160"
D10147,4,09/06/2021,PI69K9AXW5,100,"5060"
D10147,4,09/06/2021,PI64K9F0KA,60,"5000"
D10147,4,09/06/2021,PI67K9MSNF,100,"4900"
D10147,4,09/07/2021,PI79LMKYJ3,100,"4800"
D10147,4,09/07/2021,PI73LMO2QD,60,"4740"
D10147,4,09/07/2021,PI78LMRNN2,100,"4640"
D10147,4,09/08/2021,PI88N0LF18,100,"4540"
D10147,4,09/08/2021,PI85N0O2AL,60,"4480"
D10147,4,09/08/2021,PI85N14JB7,100,"4380"
D10147,4,09/11/2021,PIB1RT7RS3,100,"4280"
D10147,4,09/11/2021,PIB7RTCN83,100,"4180"
D10147,4,09/11/2021,PIB0RTFW1Q,60,"4120"
D10147,4,09/13/2021,PID2UOETF0,100,"4020"
D10147,4,09/13/2021,PID6UOGDYY,60,"3960"
D10147,4,09/13/2021,PID2UOIAFA,100,"3860"
D10147,4,09/14/2021,PIE1W6PA67,100,"3760"
D10147,4,09/14/2021,PIE8W6V2UM,100,"3660"
D10147,4,09/14/2021,PIE0W6XVRG,60,"3600"
D10147,4,09/15/2021,PIF0XGIDGO,100,"3500"
D10147,4,09/15/2021,PIF3XGMY03,100,"3400"
D10147,4,09/15/2021,PIF2XGQFSO,60,"3340"
D10147,4,09/16/2021,PIG2Z1GIPW,100,"3240"
D10147,4,09/16/2021,PIG4Z1JX0Q,60,"3180"
D10147,4,09/16/2021,PIG0Z1OYT2,100,"3080"
D10147,4,09/17/2021,PIH61N5NP4,100,"2980"
D10147,4,09/17/2021,PIH91NA5Z5,100,"2880"
D10147,4,09/17/2021,PIH01NHRIY,60,"2820"
D10147,4,09/18/2021,PII83AIP7U,100,"2720"
D10147,4,09/18/2021,PII43AN472,100,"2620"
D10147,4,09/20/2021,PIK964KBHB,100,"2520"
D10147,4,09/20/2021,PIK764QCZT,100,"2420"
D10147,4,09/20/2021,PIK164TZA7,60,"2360"
D10147,4,09/21/2021,PIL57MI2UV,100,"2260"
D10147,4,09/21/2021,PIL57MYPE3,100,"2160"
D10147,4,09/21/2021,PIL77N3IG5,60,"2100"
D10147,4,09/22/2021,PIM78JS7JV,2100,0
D10147,5,09/23/2021,PIN4AOVWSE,305,"8795"
D10147,5,09/24/2021,PIO3C9Y5C1,305,"8490"
D10147,5,09/25/2021,PIP6DOH1I8,305,"8185"
D10147,5,09/27/2021,PIR6G837TI,305,"7880"
D10147,5,09/28/2021,PIS6I71M94,305,"7575"
D10147,5,09/29/2021,PIT4JLZKA4,305,"7270"
D10147,5,09/30/2021,PIU3LJ7EQL,305,"6965"
D10147,5,10/01/2021,PJ15MRYSMH,305,"6660"
D10147,5,10/02/2021,PJ27OPL59N,305,"6355"
D10147,5,10/03/2021,PJ33Q8EF5F,305,"6050"
D10147,5,10/04/2021,PJ40RN2TCC,305,"5745"
D10147,5,10/05/2021,PJ56TKUX1S,305,"5440"
D10147,5,10/07/2021,PJ73WUP083,100,"5340"
D10147,5,10/07/2021,PJ73WUSIX7,100,"5240"
D10147,5,10/07/2021,PJ76WUZALI,100,"5140"
D10147,5,10/07/2021,PJ71WVE635,5,"5135"
D10147,5,10/08/2021,PJ82YWCONM,305,"4830"
D10147,5,10/09/2021,PJ97ZRFFMX,305,"4525"
D10147,5,10/12/2021,PJC34U7VKL,305,"4220"
D10147,5,10/10/2021,PJA62FN91Q,305,"3915"
D10147,5,10/14/2021,PJE58Y5KGH,305,"3610"
D10147,5,10/15/2021,PJF4ADQKX2,305,"3305"
D10147,5,10/16/2021,PJG5BGHE4N,305,"3000"
D10147,5,10/17/2021,PJH5D3OYD3,305,"2695"
D10147,5,10/18/2021,PJI0F2O1Z8,305,"2390"
D10147,5,10/19/2021,PJJ6GIK18S,305,"2085"
D10147,5,10/20/2021,PJK8I30QW4,300,"1785"
D10147,5,10/21/2021,PJL8J2CZXM,1785,0
D10147,6,10/28/2021,PJS0UZVD6A,"2275","6825"
D10147,6,11/04/2021,PK417CICC5,"2275","4550"
D10147,6,11/12/2021,PKC1K70NI3,"4550",0
D10147,7,11/21/2021,PKL7ZB7XKV,"2275","6825"
D10147,7,11/28/2021,PKS2BVOQM8,"2275","4550"
D10147,7,12/10/2021,PLA4WSF5OA,"4550",0
D10147,8,01/06/2022,QA61817HBR,"7800",0
D10147,9,01/10/2022,QAA4FKAWQG,500,"8600"
D10147,9,02/03/2022,QB33K9GJVX,"8600",0
D10148,1,06/24/2021,PFO2J3SDPE,"1625","5175"
D10148,1,07/04/2021,PG49WX3UPB,100,"5075"
D10148,1,07/04/2021,PG49WX99BZ,100,"4975"
D10148,1,,,,"4975"
D10148,1,,,,"4975"
D10148,1,,,,"4975"
D10148,1,07/04/2021,PG49WXBOT5,100,"4875"
D10148,1,07/04/2021,PG47WXE17P,100,"4775"
D10148,1,07/05/2021,PG57YCRK3L,100,"4675"
D10148,1,07/05/2021,PG53YCVM9F,100,"4575"
D10148,1,07/05/2021,PG53YCZWU5,100,"4475"
D10148,1,07/05/2021,PG55YD447N,100,"4375"
D10148,1,07/06/2021,PG68131SHS,825,"3550"
D10148,1,07/13/2021,PGD2B9CGAY,100,"3450"
D10148,1,07/13/2021,PGD0B9F87A,100,"3350"
D10148,1,07/15/2021,PGF4DLLC6Q,100,"3250"
D10148,1,07/15/2021,PGF0DLOD1S,100,"3150"
D10148,1,07/15/2021,PGF0DLTN6S,100,"3050"
D10148,1,07/16/2021,PGG8EUUHRK,100,"2950"
D10148,1,07/16/2021,PGG8EV0ELS,100,"2850"
D10148,1,07/16/2021,PGG2EV49O0,100,"2750"
D10148,1,07/20/2021,PGK1KIO67B,100,"2650"
D10148,1,07/20/2021,PGK2KIQLLG,100,"2550"
D10148,1,07/20/2021,PGK9KIX5SZ,100,"2450"
D10148,1,07/21/2021,PGL0MHGCMG,2150,300
D10148,1,07/22/2021,PGM7O1OOTP,100,200
D10148,1,07/22/2021,PGM0O1QOOG,100,100
D10148,1,07/22/2021,PGM1O1SB2P,100,0
D10148,2,11/29/2022,QKT0WFTUF4,"1625","5175"
D10148,2,12/06/2022,QL64JK89ZS,"1625","3550"
D10148,2,12/18/2022,QLI6GPLOP0,"1625","1925"
D10148,2,12/21/2022,QLL8PGXYSM,1625,300
D10148,2,12/22/2022,QLM9QQWZFZ,100,200
D10148,2,12/22/2022,QLM1QR122X,100,100
D10148,2,12/22/2022,QLM0QR86Y4,100,0
D10148,3,01/08/2023,RA83YOZY4H,"1625","4875"
D10148,3,01/12/2023,RAC88VRJJY,"3250","1625"
D10148,3,01/19/2023,RAJ7Q9RN9X,"1625",0
D10148,5,02/19/2023,RBJ125XGOB,"1625","5675"
D10148,5,03/03/2023,RC33XP7M65,"1100","4575"
D10148,5,03/05/2023,RC504DYZK4,525,"4050"
D10148,5,03/07/2023,RC77A22OTZ,1625,"2425"
D10148,5,03/10/2023,RCA8IBDDYE,1625,800
D10148,5,03/17/2023,RCH321WQIT,800,0
D10148,6,04/28/2023,RDS48BTLQ4,500,"6800"
D10148,6,05/26/2023,REQ1H9JQ3H,70,"6730"
D10148,6,05/29/2023,RET4Q3I1U6,350,"6380"
D10148,6,06/29/2023,RFT28DYW7S,200,"6180"
D10148,6,07/03/2023,RG33K9GQBV,200,"5980"
D10149,1,06/24/2021,PFO3IVZDGZ,"1625","5175"
D10149,1,07/02/2021,PG25UOF9JN,500,"4675"
D10149,1,07/04/2021,PG40XH84O4,999,"3676"
D10149,1,07/11/2021,PGB381U1Z3,640,"3036"
D10149,1,07/17/2021,PGH8G7HMMY,500,"2536"
D10149,1,07/20/2021,PGK4K2KYYY,490,"2046"
D10149,1,07/21/2021,PGL2MJTS1I,100,"1946"
D10149,1,07/21/2021,PGL5MJVQCF,100,"1846"
D10149,1,07/21/2021,PGL1MJXMFP,100,"1746"
D10149,1,07/22/2021,PGM4MXFQYY,100,"1646"
D10149,1,07/22/2021,PGM8MXZRYW,100,"1546"
D10149,1,07/22/2021,PGM4MY3PIC,100,"1446"
D10149,1,07/22/2021,PGM9MYFT8V,100,"1346"
D10149,1,07/22/2021,PGM8N1A1D0,100,"1246"
D10149,1,07/22/2021,PGM5N1CRPR,100,"1146"
D10149,1,07/23/2021,PGN5ODZKIP,100,"1046"
D10149,1,07/23/2021,PGN5PHN0UP,500,546
D10149,1,07/25/2021,PGP2S59FGO,500,46
D10149,1,07/28/2021,PGS0VV4LXA,36,10
D10149,1,07/28/2021,PGS1WHKMFZ,10,0
D10150,1,07/01/2021,PG15SFF9TJ,"2275","6825"
D10150,1,07/08/2021,PG803H26CA,"2275","4550"
D10150,1,07/15/2021,PGF9D0RADV,"2275","2275"
D10150,1,07/21/2021,PGL9M4E0NL,"2275",0
D10150,2,07/29/2021,PGT8XAKPY6,100,"7880"
D10150,2,07/31/2021,PGV017A7LO,"2275","5605"
D10150,2,08/04/2021,PH436SWYMV,"4550","1055"
D10150,2,08/04/2021,PH4878AU76,1055,0
D10150,3,08/20/2021,PHK8TU8MR2,"6500","6500"
D10150,3,08/24/2021,PHO5ZAJRZ9,"3250","3250"
D10150,3,09/01/2021,PI14BSY89Y,"3250",0
D10150,4,09/09/2021,PI95OI04XL,"3250","9750"
D10150,4,09/16/2021,PIH5ZXAQHJ,"3250","6500"
D10150,4,10/01/2021,PJ14M66CDK,"6050",450
D10150,4,10/01/2021,PJ14MB1SOS,450,0
D10150,5,10/26/2021,PJQ7QUTX3L,"16510",0
D10150,6,11/20/2021,PKK9WJD72L,"19050",0
D10150,7,12/18/2021,PLI7B6QCEN,"26000",0
D10150,8,01/15/2022,QAF1MWZUC5,"26000",0
D10150,9,02/12/2022,QBC61Y9XSQ,"26000",0
D10150,10,03/11/2022,QCB8HSA1XE,"26000",0
D10150,11,04/09/2022,QD923HDGIU,"19500",0
D10150,12,05/05/2022,QE54HB5PT2,"19400",0
D10150,13,05/30/2022,QEU1UAB2LR,"25600",0
D10150,14,06/27/2022,QFR5G7T41N,"26000",0
D10150,15,07/20/2022,QGK9RH3SVX,"24800",0
D10150,16,08/18/2022,,"26000",0
D10150,17,09/16/2022,QIG03A9YDQ,"26000",0
D10150,18,10/15/2022,QJF7XEXS0T,"26000",0
D10150,19,11/14/2022,QKE2W0KPZ0,"34000",0
D10150,20,12/13/2022,QLD233QKQO,"26000",0
D10150,21,1/11/2023,RAB75AEAIF,"26000",0
D10150,22,2/8/2023,RB94AA47BM,"26000",0
D10150,23,3/7/2023,RC728ZSOH0,"25400",0
D10150,24,4/5/2023,RD50FN8ITW,"26000",0
D10150,25,5/31/2023,REV1UN68DB,"36500",0
D10151,1,07/01/2021,PG19S6OD6R,"1625","4875"
D10151,1,07/02/2021,PG22ULNRC4,225,"4650"
D10151,1,07/03/2021,PG34VP9ISS,100,"4550"
D10151,1,07/03/2021,PG32VPLQ68,100,"4450"
D10151,1,07/03/2021,PG31VPTHLD,25,"4425"
D10151,1,07/04/2021,PG45XBI0TJ,100,"4325"
D10151,1,07/04/2021,PG47XBPP3P,100,"4225"
D10151,1,07/04/2021,PG49XBW48B,25,"4200"
D10151,1,07/05/2021,PG54YWOXDI,100,"4100"
D10151,1,07/05/2021,PG59YWSGZ9,100,"4000"
D10151,1,07/05/2021,PG55YWV8PP,25,"3975"
D10151,1,07/07/2021,PG752OPKLD,100,"3875"
D10151,1,07/07/2021,PG702OT8KC,100,"3775"
D10151,1,07/07/2021,PG732OWXD9,25,"3750"
D10151,1,07/08/2021,PG8940J2GD,100,"3650"
D10151,1,07/08/2021,PG8140OO6X,100,"3550"
D10151,1,07/08/2021,PG8540UW6X,25,"3525"
D10151,1,07/10/2021,PGA672XJO6,100,"3425"
D10151,1,07/10/2021,PGA3730EIL,100,"3325"
D10151,1,07/10/2021,PGA2733716,25,"3300"
D10151,1,07/11/2021,PGB68G0L8I,100,"3200"
D10151,1,07/11/2021,PGB38G1LVB,100,"3100"
D10151,1,07/11/2021,PGB58G7G2V,25,"3075"
D10151,1,07/12/2021,PGC59RW34F,25,"3050"
D10151,1,07/12/2021,PGC09RZ4LY,100,"2950"
D10151,1,07/12/2021,PGC69S29O4,100,"2850"
D10151,1,07/13/2021,PGD4B8MIH8,100,"2750"
D10151,1,07/13/2021,PGD4B8OARY,100,"2650"
D10151,1,07/13/2021,PGD1B8PY3F,25,"2625"
D10151,1,07/14/2021,PGE5CJL15H,25,"2600"
D10151,1,07/14/2021,PGE1CJOC77,100,"2500"
D10151,1,07/14/2021,PGE4CJTC48,100,"2400"
D10151,1,07/15/2021,PGF5E5D99P,25,"2375"
D10151,1,07/15/2021,PGF3E5EW3P,100,"2275"
D10151,1,07/15/2021,PGF9E5GS5L,100,"2175"
D10151,1,07/16/2021,PGG1FHRTQR,25,"2150"
D10151,1,07/16/2021,PGG0FHX31Q,100,"2050"
D10151,1,07/16/2021,PGG6FI11IS,100,"1950"
D10151,1,07/17/2021,PGH4H15XNU,25,"1925"
D10151,1,07/17/2021,PGH5H1DIIX,100,"1825"
D10151,1,07/17/2021,PGH3H1HU7L,100,"1725"
D10151,1,07/18/2021,PGI6ICWGNK,25,"1700"
D10151,1,07/18/2021,PGI0ICZ26W,100,"1600"
D10151,1,07/18/2021,PGI8ID4E0O,100,"1500"
D10151,1,07/19/2021,PGJ6JRXZLG,25,"1475"
D10151,1,07/19/2021,PGJ3JS03YJ,100,"1375"
D10151,1,07/19/2021,PGJ3JS1T9R,100,"1275"
D10151,1,07/20/2021,PGK2L0C4K0,25,"1250"
D10151,1,07/20/2021,PGK6L0FL9K,100,"1150"
D10151,1,07/20/2021,PGK6L0JVEG,100,"1050"
D10151,1,07/21/2021,PGL3MG8K25,25,"1025"
D10151,1,07/21/2021,PGL3MGCCLF,100,925
D10151,1,07/21/2021,PGL7MGG7O7,100,825
D10151,1,07/22/2021,PGM6NGFJNK,700,125
D10151,1,07/06/2021,PGK6L0FL9K_D2,125,0
D10151,2,07/24/2021,PGO0QSLAKU,100,"6400"
D10151,2,07/24/2021,PGO6QSPMFK,100,"6300"
D10151,2,07/24/2021,PGO9QSVL0N,100,"6200"
D10151,2,07/24/2021,PGO2QSYZ6I,100,"6100"
D10151,2,07/24/2021,PGO4QT1S28,100,"6000"
D10151,2,07/27/2021,PGR1V4YNLN,100,"5900"
D10151,2,07/27/2021,PGR5V51SY1,100,"5800"
D10151,2,07/27/2021,PGR5V54BLN,100,"5700"
D10151,2,07/27/2021,PGR9V57OVL,100,"5600"
D10151,2,07/27/2021,PGR2V5BB5O,100,"5500"
D10151,2,07/29/2021,PGT6XX37OG,25,"5475"
D10151,2,07/29/2021,PGT0XX64FO,100,"5375"
D10151,2,07/29/2021,PGT1XX9015,100,"5275"
D10151,2,07/29/2021,PGT2XXBXJI,100,"5175"
D10151,2,07/29/2021,PGT2XXFIOY,100,"5075"
D10151,2,07/29/2021,PGT7XXIH6F,100,"4975"
D10151,2,07/29/2021,PGT1XXLB5X,100,"4875"
D10151,2,08/03/2021,PH3666BNS2,100,"4775"
D10151,2,08/03/2021,PH3866EQ88,100,"4675"
D10151,2,08/03/2021,PH3366KPGP,100,"4575"
D10151,2,08/03/2021,PH3366PZWT,100,"4475"
D10151,2,08/03/2021,PH3466U3OA,100,"4375"
D10151,2,08/05/2021,PH5484B60K,100,"4275"
D10151,2,08/05/2021,PH5784DNQN,100,"4175"
D10151,2,08/05/2021,PH5884G4GA,100,"4075"
D10151,2,08/05/2021,PH5584I2DF,100,"3975"
D10151,2,08/05/2021,PH5784KHS5,100,"3875"
D10151,2,08/08/2021,PH81DGM69Z,100,"3775"
D10151,2,08/08/2021,PH80DGTEXK,100,"3675"
D10151,2,08/08/2021,PH85DGXFRL,100,"3575"
D10151,2,08/08/2021,PH87DH1EMP,100,"3475"
D10151,2,08/08/2021,PH85DH6HOX,100,"3375"
D10151,2,08/13/2021,PHD1KQOJAH,100,"3275"
D10151,2,08/13/2021,PHD3KQRWKX,100,"3175"
D10151,2,08/13/2021,PHD5KQUOYL,100,"3075"
D10151,2,08/13/2021,PHD0KQY53C,100,"2975"
D10151,2,08/13/2021,PHD1KR14YZ,100,"2875"
D10151,2,08/17/2021,PHH1QCJ4MX,100,"2775"
D10151,2,08/17/2021,PHH0QCNFRW,100,"2675"
D10151,2,08/17/2021,PHH8QCQ5FE,100,"2575"
D10151,2,08/17/2021,PHH2QCT6HW,100,"2475"
D10151,2,08/17/2021,PHH4QCWJQE,100,"2375"
D10151,2,08/18/2021,PHI4RV10RI,100,"2275"
D10151,2,08/18/2021,PHI7RV2TL7,100,"2175"
D10151,2,08/18/2021,PHI9RV4H5P,100,"2075"
D10151,2,08/18/2021,PHI0RV72WG,100,"1975"
D10151,2,08/18/2021,PHI5RVA3CR,100,"1875"
D10151,2,08/19/2021,PHJ0T07NQU,1875,0
D10151,3,08/23/2021,PHN5YU84CH,100,"9000"
D10151,3,08/23/2021,PHN1YUAI9Z,100,"8900"
D10151,3,08/23/2021,PHN4YUDSUO,100,"8800"
D10151,3,08/23/2021,PHN3YUGW5V,100,"8700"
D10151,3,08/23/2021,PHN0YUL71W,100,"8600"
D10151,3,08/23/2021,PHN2YUNN20,100,"8500"
D10151,3,08/23/2021,PHN2YURJPW,100,"8400"
D10151,3,08/23/2021,PHN1YUVHDL,100,"8300"
D10151,3,08/27/2021,PHR95PGQFR,100,"8200"
D10151,3,08/27/2021,PHR55PL4GT,100,"8100"
D10151,3,08/27/2021,PHR05PSOEO,100,"8000"
D10151,3,08/27/2021,PHR25PY6L6,100,"7900"
D10151,3,08/28/2021,PHS85ZAFQW,100,"7800"
D10151,3,08/30/2021,PHU48XE392,700,"7100"
D10151,3,09/01/2021,PI10BXJYG2,600,"6500"
D10151,3,09/02/2021,PI21DHKJBB,100,"6400"
D10151,3,09/02/2021,PI22DHM9X8,100,"6300"
D10151,3,09/02/2021,PI26DHOCSC,100,"6200"
D10151,3,09/02/2021,PI29DHQKLR,100,"6100"
D10151,3,09/02/2021,PI20DHSA66,100,"6000"
D10151,3,09/02/2021,PI29EN1FA1,100,"5900"
D10151,3,09/02/2021,PI22EN5P6O,100,"5800"
D10151,3,09/02/2021,PI24EN821G,100,"5700"
D10151,3,09/02/2021,PI26ENAJ0U,100,"5600"
D10151,3,09/04/2021,PI45GN0HS1,500,"5100"
D10151,3,09/05/2021,PI56J2CV7K,500,"4600"
D10151,3,09/08/2021,PI83NP0IMZ,100,"4500"
D10151,3,09/08/2021,PI80NP31D0,100,"4400"
D10151,3,09/08/2021,PI88NP5GCM,100,"4300"
D10151,3,09/08/2021,PI82NP8V6Y,100,"4200"
D10151,3,09/08/2021,PI80NPC2SA,100,"4100"
D10151,3,09/10/2021,PIA0QMSD7O,100,"4000"
D10151,3,09/10/2021,PIA2QMUZC2,100,"3900"
D10151,3,09/10/2021,PIA6QN3Q5S,100,"3800"
D10151,3,09/10/2021,PIA7QN74VB,100,"3700"
D10151,3,09/10/2021,PIA8QNDVFK,100,"3600"
D10151,3,09/14/2021,PIE5VFKI0V,100,"3500"
D10151,3,09/14/2021,PIE5VFLXPP,100,"3400"
D10151,3,09/14/2021,PIE2VFNN3W,100,"3300"
D10151,3,09/14/2021,PIE8VFP7XW,100,"3200"
D10151,3,09/14/2021,PIE1VFQVRV,100,"3100"
D10151,3,09/16/2021,PIG3ZR84TP,3000,100
D10151,3,09/17/2021,PIH71JXSO7,100,0
D10151,4,09/22/2021,PIM98L6AL3,100,"9000"
D10151,4,09/22/2021,PIM68L84WS,100,"8900"
D10151,4,09/22/2021,PIM08LBRGM,100,"8800"
D10151,4,09/22/2021,PIM68LE4KE,100,"8700"
D10151,4,09/22/2021,PIM48LG3CE,100,"8600"
D10151,4,09/22/2021,PIM48LLPEK,50,"8550"
D10151,4,09/27/2021,PIR4H1QBYK,100,"8450"
D10151,4,09/27/2021,PIR7H1UMY3,100,"8350"
D10151,4,09/27/2021,PIR3H1Y8UN,100,"8250"
D10151,4,09/27/2021,PIR1H21JOX,100,"8150"
D10151,4,09/30/2021,PIU1LRZQPH,100,"8050"
D10151,4,09/30/2021,PIU9LS4T7P,100,"7950"
D10151,4,09/30/2021,PIU5LSDZI5,100,"7850"
D10151,4,10/04/2021,PJ49RL0L8R,500,"7350"
D10151,4,10/07/2021,PJ70X9IGM2,700,"6650"
D10151,4,10/11/2021,PJB63Y6HBK,1500,"5150"
D10151,4,10/15/2021,PJF8ADH9RM,5150,0
D10151,5,10/18/2021,PJI2FINJH0,300,"8800"
D10151,5,10/18/2021,PJI6FISHV2,200,"8600"
D10151,5,10/31/2021,PJV1ZYX2ON,100,"8500"
D10151,5,10/31/2021,PJV4ZZ0WUM,1400,"7100"
D10151,5,11/06/2021,PK61A0L3Q1,1400,"5700"
D10151,5,11/06/2021,PK62A09CDI,100,"5600"
D10151,5,11/08/2021,PK82E42SB8,500,"5100"
D10151,5,11/12/2021,PKC5K4QQ95,5100,0
D10151,6,11/28/2021,PKS7C013PV,50,"11010"
D10151,6,11/28/2021,PKS4C0C6N6,100,"10910"
D10151,6,11/28/2021,PKS9C10G5P,100,"10810"
D10151,6,11/28/2021,PKS9C15RHH,100,"10710"
D10151,6,12/15/2021,PLF95HTP3F,500,"10210"
D10151,6,02/07/2022,QB72RXLPZ6,3000,"7210"
D10151,6,03/05/2022,QC536E7Y5H,3000,"4210"
D10151,6,04/08/2022,QD8517GKF1,4210,0
D10152,1,,,,
D10153,1,07/02/2021,PG23U4TH0D,"1625","4775"
D10153,1,07/09/2021,PG945O7HDS,"1625","3150"
D10153,1,07/16/2021,PGG6FOCQWC,"1625","1525"
D10153,1,07/21/2021,PGL0LF7CQ4,"1525",0
D10153,2,07/29/2021,PGT0Y2PMJS,"1625","4375"
D10153,2,08/05/2021,PH529CBCUS,"1625","2750"
D10153,2,08/08/2021,PH81DPTGP3,"2750",0
D10153,3,08/18/2021,PHI5RV5SXB,"1000","6800"
D10153,3,08/28/2021,PHS67CNJQO,950,"5850"
D10153,3,09/03/2021,PI38EU7OI0,"1500","4350"
D10153,3,09/06/2021,PI64JJ6X4I,4350,0
D10153,4,09/13/2021,PID5V8SEI1,"1000","6900"
D10153,4,10/04/2021,PJ42SH31X0,"1000","5900"
D10153,4,10/06/2021,PJ60UO5VNM,"1006","4894"
D10153,4,10/10/2021,PJA63261UY,1000,"3894"
D10153,4,10/13/2021,PJD37SKNWD,800,"3094"
D10153,4,10/17/2021,PJH0DZKDJU,500,"2594"
D10153,4,10/19/2021,PJJ8H4P020,300,"2294"
D10153,4,10/19/2023,PJO2OSR8PA,300,"1994"
D10153,4,10/26/2021,PJQ6R374BO,477,"1517"
D10153,4,10/26/2021,PJQ6R3AIXK,23,"1494"
D10153,4,10/31/2021,PJV41459XC,500,994
D10153,4,11/07/2021,PK72CV4AFA,500,494
D10153,4,11/12/2021,PKC7JIQPGX,100,394
D10153,4,11/15/2021,PKF4O9HA5O,100,294
D10153,4,11/19/2021,PKJ2UPWVUY,100,194
D10153,4,11/29/2021,PKT0CNQQQM,195,1
D10154,1,06/29/2021,PFT3P4AQ03,"7840",0
D10154,2,07/06/2021,PG65Z7VKST,"2275","5565"
D10154,2,07/07/2021,PG781QNGCA,"5565",0
D10154,3,07/15/2021,PGF7DKI9C5,"2275","5915"
D10154,3,07/22/2021,PGM2MUTYUW,"5915",0
D10154,4,07/28/2021,PGS1VGSVNH,"7840",0
D10154,5,08/04/2021,PH446NTGEG,"8960",0
D10154,6,08/16/2021,PHG1OGJ485,"9120",0
D10154,7,08/27/2021,PHR14SBGXJ,"11300",0
D10155,1,07/21/2021,PGL7LFNAEJ,"12600",0
D10155,2,08/17/2021,PHH3PKNW4J,"12800",0
D10155,3,09/11/2021,PIB3RHS8HL,"12600","2520"
D10155,3,09/11/2021,PIB1RIHLU3,"2520",0
D10155,4,10/13/2021,PJD8756EYC,"12800",0
D10155,5,11/11/2021,PKB6I8S3NQ,"15600",0
D10155,6,12/07/2021,PL70R6N27U,"15240",0
D10155,7,01/04/2022,QA414FK7XH,"15480",0
D10155,8,02/02/2022,QB27J4J2SZ,"15600",0
D10155,9,03/02/2022,QC25Z277O5,"15600",0
D10155,10,06/16/2022,QFG2U0TQYS,200,"25080"
D10155,10,06/20/2022,QFK92X90PP,100,"24980"
D10155,10,06/20/2022,QFK12XDZFN,100,"24880"
D10155,10,06/20/2022,QFK32XLP9D,100,"24780"
D10155,10,06/21/2022,QFL04VUGPY,100,"24680"
D10155,10,06/23/2022,QFN88H09LI,100,"24580"
D10155,10,06/23/2022,QFN28H4OWM,100,"24480"
D10155,10,06/28/2022,QFS5I89DHZ,100,"24380"
D10155,10,06/28/2022,QFS6I8EQNC,100,"24280"
D10155,10,07/01/2022,QG11NQVTYD,100,"24180"
D10155,10,07/01/2022,QG13NR05IZ,100,"24080"
D10155,10,07/05/2022,QG55W2C7KR,100,"23980"
D10155,10,07/05/2022,QG55W283LT,100,"23880"
D10155,10,07/08/2022,QG833G01HL,100,"23780"
D10155,10,07/08/2022,QG823GDQJA,100,"23680"
D10156,1,06/30/2021,PFU4R7PN1G,23,"5877"
D10156,1,07/06/2021,PG6618TUSK,"1000","4877"
D10156,1,07/07/2021,PG722P26NY,625,"4252"
D10156,1,07/14/2021,PGE5CKKGNT,"1000","3252"
D10156,1,07/14/2021,PGE3COE6T3,605,"2647"
D10156,1,07/17/2021,PGH5G31BB3,2647,0
D10156,2,07/22/2021,PGM1NYT1TZ,"1000","5300"
D10156,2,07/24/2021,PGO3QS1JXL,625,"4675"
D10156,2,08/01/2021,PH18308CJQ,"1000","3675"
D10156,2,08/01/2021,PH1339W3L5,625,"3050"
D10156,2,08/07/2021,PH71CAKS29,1600,"1450"
D10156,2,08/10/2021,PHA4G4AVJE,1250,200
D10156,2,08/10/2021,PHA2GIKW9C,200,0
D10156,3,08/18/2021,PHI6RVMDX0,"1830","7270"
D10156,3,08/19/2021,PHJ3T80Q3R,445,"6825"
D10156,3,08/25/2021,PHP92TBNWR,600,"6225"
D10156,3,08/27/2021,PHR95SLC99,1370,"4855"
D10156,3,09/01/2021,PI15D76H0H,500,"4355"
D10156,3,09/04/2021,PI49HC5P23,1075,"3280"
D10156,3,09/05/2021,PI53IO6SBL,700,"2580"
D10156,3,09/07/2021,PI73M9MU4V,1525,"1055"
D10156,3,09/08/2021,PI80MJFJN2,500,555
D10156,3,09/08/2021,PI89MP7TR9,275,280
D10156,3,09/08/2021,PI86MUKKZE,280,0
D10156,4,09/16/2021,PIG5YKBDL1,"1000","8100"
D10156,4,09/26/2021,PIQ7FJXB8V,500,"7600"
D10156,4,09/29/2021,PIT1JE7OWP,"2000","5600"
D10156,4,09/30/2021,PIU2M0CG2K,1000,"4600"
D10156,4,10/01/2021,PJ11ND032Z,1000,"3600"
D10156,4,10/03/2021,PJ36Q3DBPI,1325,"2275"
D10156,4,10/03/2021,PJ32QPF4B6,1000,"1275"
D10156,4,10/04/2021,PJ44RJPS96,1000,275
D10156,4,10/04/2021,PJ44RPFY76,275,0
D10156,5,10/23/2021,PJN3NAMAJ9,"1015","8085"
D10156,5,10/24/2021,PJO1OAICPH,850,"7235"
D10156,5,10/28/2021,PJS1UE0R5P,"3000","4235"
D10156,5,10/31/2021,PJV0Z91UGY,500,"3735"
D10156,5,10/31/2021,PJV914IPQP,1250,"2485"
D10156,5,11/01/2021,PK171KW80B,2475,10
D10156,5,11/01/2021,PK151NBCP3,10,0
D10156,6,11/29/2021,PKT4CQM94G,"9100",0
D10156,7,12/13/2021,PLD63PH0RO,800,"8300"
D10156,7,12/14/2021,PLE95CIR2F,500,"7800"
D10156,7,12/27/2021,PLR5QANWZ9,"6500","1300"
D10156,7,12/27/2021,PLR6RMHW1W,1300,0
D10156,8,01/20/2022,QAK1UYMSBL,"6000","3520"
D10156,8,01/23/2022,QAN5277P0T,325,"3195"
D10156,8,01/28/2022,QAS6AWYWUI,"1900","1295"
D10156,8,01/29/2022,QAT4CFO2EC,875,420
D10156,8,01/31/2022,QAV9ET9L15,420,0
D10156,9,02/19/2022,QBJ4EFKOLA,"2500","5300"
D10156,9,02/20/2022,QBK3H71PXP,800,"4500"
D10156,9,02/26/2022,QBQ1RWRF19,500,"4000"
D10156,9,02/27/2022,QBR3UCC4VJ,1000,"3000"
D10156,9,02/28/2022,QBS7UPM39D,2000,"1000"
D10156,9,02/28/2022,QBS6UWS2ZY,1000,0
D10156,10,02/10/2022,QCA0HAJMQ6,"1050","8050"
D10156,10,03/13/2022,QCD2LVGFWM,"1225","6825"
D10156,10,03/27/2022,QCR7DGD9SD,"4000","2825"
D10156,10,03/28/2022,QCS5EGX60L,2000,825
D10156,10,03/28/2022,QCS0EMCB2E,825,0
D10156,11,04/05/2022,QD52VS36C2,500,"8500"
D10156,11,04/23/2022,QDN1U2FCED,"8500",0
D10156,12,05/20/2022,QEK2AYOEZA,"2100","7000"
D10156,12,05/20/2022,QEK5B6MR4Z,"7000",0
D10156,13,06/16/2022,QFG1TQ27PR,"4500","5020"
D10156,13,06/16/2022,QFG1UNV5W5,500,"4520"
D10156,13,06/20/2022,QFK12BMT25,100,"4420"
D10156,13,06/20/2022,QFK12BQYUN,100,"4320"
D10156,13,06/20/2022,QFK02BUKKW,100,"4220"
D10156,13,06/23/2022,QFN98CFSAB,4220,0
D10156,14,07/15/2022,QGF3J3LRNF,"2200","3000"
D10156,14,07/20/2022,QGK5RRWVYJ,"1780","1220"
D10156,14,07/20/2022,QGK6T3WWBO,700,520
D10156,14,07/21/2022,QGL7UTBEUX,520,0
D10156,15,08/09/2022,QH99Y9CEPP,150,"4850"
D10156,15,08/10/2022,QHA2Z6K3W6,150,"4700"
D10156,15,08/11/2022,QHB82MXUWO,150,"4550"
D10156,15,08/12/2022,QHC841NJVU,150,"4400"
D10156,15,08/24/2022,QHO7QWFLRB,150,"4250"
D10156,15,08/27/2022,QHR4VJ1SMI,1300,"2950"
D10156,15,08/30/2022,QHU23P13LO,2950,0
D10156,16,10/14/2022,QJE1UHFFNB,"3000","3500"
D10156,16,10/14/2022,QJE7UHCUXF,50,"3450"
D10156,16,10/17/2022,QJH42SBEEA,"3450",0
D10156,17,11/07/2022,QK78GABEG6,"3000","4800"
D10156,17,11/08/2022,QK83JWX9YB,800,"4000"
D10156,17,11/09/2022,QK92MBT6CM,500,"3500"
D10156,17,11/11/2022,QKB1R184YH,500,"3000"
D10156,17,11/11/2022,QKB6R15WME,1,"2999"
D10156,17,11/14/2022,QKE7X01MG5,2999,0
D10156,18,12/01/2022,QL151CQQ3H,"5000","2140"
D10156,18,12/01/2022,QL182QGAN6,"2140",0
D10156,19,12/30/2022,QLU9BEPU81,"6500",0
D10156,20,02/16/2023,RBG6RC01MO,"2700","3800"
D10156,20,02/19/2023,RBJ2163IPY,"1500","2300"
D10156,20,02/20/2023,RBK437GKCQ,"2300",0
D10156,21,03/01/2023,RC18QM13F6,350,"6950"
D10157,1,07/10/2021,PGA275NFPW,"1700","6200"
D10157,1,07/19/2021,PGJ6J5WK1E,400,"5800"
D10157,1,07/21/2021,PGL8MIFUMQ,"1000","4800"
D10157,1,07/29/2021,PGT7WZN50R,300,"4500"
D10157,1,07/30/2021,PGU1Z3ZZ3F,300,"4200"
D10157,1,07/31/2021,PGV9ZVAOW7,500,"3700"
D10157,1,09/04/2021,PI41GOTLJR,1000,"2700"
D10157,1,09/13/2021,PID5VAAV67,1000,"1700"
D10157,1,09/24/2021,PIO1BHFLQ1,500,"1200"
D10157,1,10/21/2021,PJL4JOOSJK,100,"1100"
D10157,1,10/21/2021,PENALTY WAIVED,1100,0
D10158,1,07/12/2021,PGC491JKUA,"1000","12600"
D10158,1,07/13/2021,PGD3A17B31,"1500","11100"
D10158,1,07/13/2021,PGD2A39IDE,750,"10350"
D10158,1,07/18/2021,PGI7HON3O1,"1150","9200"
D10158,1,07/18/2021,PGI6IE2B9M,2100,"7100"
D10158,1,07/25/2021,PGP2RDJSGY,1000,"6100"
D10158,1,07/26/2021,PGQ4TCBETO,950,"5150"
D10158,1,08/02/2021,PH273KHPX9,4500,650
D10158,1,08/03/2021,PH365AWCRU,50,600
D10159,1,07/12/2021,PGC29JIPCE,"1625","6275"
D10159,1,09/04/2021,PI48HCG4ZY,100,"6175"
D10159,1,09/04/2021,PI45HCLJSD,100,"6075"
D10159,1,09/06/2021,PI63KO6OEZ,100,"5975"
D10159,1,09/18/2021,PII02OZI6A,100,"5875"
D10159,1,09/18/2021,PII62P2T3K,100,"5775"
D10159,1,09/23/2021,PIN8A8PZUU,100,"5675"
D10159,1,09/28/2021,PIS3ICMTWP,100,"5575"
D10159,1,09/28/2021,PIS1IDF5X7,100,"5475"
D10159,1,10/16/2021,PJG8BN4OKG,100,"5375"
D10159,1,10/16/2021,PJG5BN82P1,100,"5275"
D10159,1,10/21/2021,PJL4IWAHPM,100,"5175"
D10159,1,10/21/2021,PJL6J7KEW4,100,"5075"
D10159,1,02/03/2022,QB38L0FPYI,60,"5015"
D10159,1,03/03/2022,QC3527XOJ5,100,"4915"
D10159,1,03/03/2022,QC382811KQ,100,"4815"
D10159,1,03/14/2022,QCE6OGJIYK,100,"4715"
D10159,1,03/14/2022,QCE5OGQW7Z,100,"4615"
D10159,1,08/20/2022,QHK7IP05QX,307,"4308"
D10159,1,08/24/2022,QHO6QDBEE8,207,"4101"
D10159,1,11/04/2022,QK49A9A86B,100,"4001"
D10160,1,07/13/2021,PGD1ADGTKX,"1625","4875"
D10160,1,07/20/2021,PGK2KIUNM4,"1625","3250"
D10160,1,07/26/2021,PGR9UGOEYL,"1625","1625"
D10160,1,08/02/2021,PH29451K4P,"1625",0
D10160,2,08/13/2021,PHD8JQ7OZ2,"1625","4875"
D10160,2,08/20/2021,PHK6U118RO,"1625","3250"
D10160,2,08/27/2021,PHR95DIWH9,"2500",750
D10160,2,08/31/2021,PHV8B7U8XO,750,0
D10160,3,09/09/2021,PI96OTMZKQ,"1625","4875"
D10160,3,09/16/2021,PIG3Z9US6Z,"1625","3250"
D10160,3,09/24/2021,PIO5BTYJKR,"1625","1625"
D10160,3,09/30/2021,PIU1LI6SSZ,1625,0
D10160,4,10/11/2021,PJB84ECO6I,"1950","5850"
D10160,4,10/18/2021,PJI4F3EXKY,"1950","3900"
D10160,4,10/29/2021,PJT1V9CJP5,"2000","1900"
D10160,4,11/01/2021,PK111HNNYX,1900,0
D10160,5,11/09/2021,PK98FTMLII,"1800","6000"
D10160,5,11/15/2021,PKF0OXTJNW,"2000","4000"
D10160,5,11/25/2021,PKP16U5GA9,"1450","2550"
D10160,5,11/29/2021,PKT7DRJSB9,2550,0
D10160,6,12/18/2021,PLI4CDVYPY,"1000","7160"
D10160,6,12/22/2021,PLM7I6K1O3,"1000","6160"
D10160,6,12/28/2021,PLS2SSK966,"1000","5160"
D10160,6,01/03/2022,QA332FWR8T,4800,360
D10160,6,01/04/2022,QA535TJ5BJ,360,0
D10160,7,01/13/2022,QAD3K0GB0L,"1950","5550"
D10160,7,01/20/2022,QAK8VC0XPW,"1950","3600"
D10160,7,01/27/2022,QAR994HVZX,"1950","1650"
D10160,7,01/29/2022,QAT9BM0SML,1650,0
D10160,8,02/26/2022,QBQ9R4262X,"7800",0
D10160,9,03/29/2022,QCT8G34XGQ,"7000","1160"
D10160,9,03/31/2022,QCV0K54TLQ,"1160",0
D10161,1,07/07/2021,PG792JXIYD,100,"3980"
D10161,1,07/07/2021,PG782K4CYG,100,"3880"
D10161,1,07/08/2021,PG87445XV5,70,"3810"
D10161,1,07/09/2021,PG905QEEAG,100,"3710"
D10161,1,07/09/2021,PG955QFFLD,100,"3610"
D10161,1,07/10/2021,PGA875XQMK,100,"3510"
D10161,1,07/11/2021,PGB58FYJQD,100,"3410"
D10161,1,07/12/2021,PGC69UNZL8,90,"3320"
D10161,1,07/14/2021,PGE9BBPSFT,100,"3220"
D10161,1,07/14/2021,PGE2BBPXT8,100,"3120"
D10161,1,07/14/2021,PGE9BT49QZ,15,"3105"
D10161,1,07/14/2021,PGE6CQ2VA0,130,"2975"
D10161,1,07/17/2021,PGH7H3F8NL,100,"2875"
D10161,1,07/17/2021,PGH5H3KXI9,100,"2775"
D10161,1,07/19/2021,PGJ4JSPMKA,200,"2575"
D10161,1,07/23/2021,PGN7PEFNWX,100,"2475"
D10161,1,07/23/2021,PGN8PEIO7U,50,"2425"
D10161,1,07/24/2021,PGO0R0XB36,100,"2325"
D10161,1,07/24/2021,PGO8R0XLRA,100,"2225"
D10161,1,07/25/2021,PGP8SAWGSY,100,"2125"
D10161,1,07/25/2021,PGP5SAXKQD,30,"2095"
D10161,1,07/26/2021,PGQ6TQBCN0,100,"1995"
D10161,1,07/26/2021,PGQ6TQDYIQ,40,"1955"
D10161,1,07/29/2021,PGT8WSZEY0,100,"1855"
D10161,1,07/29/2021,PGT5WT187D,100,"1755"
D10161,1,07/30/2021,PGU4ZJYMS6,100,"1655"
D10161,1,07/30/2021,PGU2ZK01UG,80,"1575"
D10161,1,07/31/2021,PGV021MOSI,100,"1475"
D10161,1,07/31/2021,PGV321OMLN,100,"1375"
D10161,1,07/31/2021,PGV721QMSX,20,"1355"
D10161,1,08/01/2021,PH193FGRM1,100,"1255"
D10161,1,08/01/2021,PH163FHF88,100,"1155"
D10161,1,08/02/2021,PH284VTGAS,50,"1105"
D10161,1,08/04/2021,PH437URUB3,100,"1005"
D10161,1,08/04/2021,PH457UTOMN,30,975
D10161,1,08/05/2021,PH5097CLOW,100,875
D10161,1,08/05/2021,PH5297IQ9S,40,835
D10161,1,08/06/2021,PH63ARA5A1,100,735
D10161,1,08/07/2021,PH70CA0VBQ,100,635
D10161,1,08/08/2021,PH80CEKTVY,150,485
D10161,1,08/09/2021,PHA2F9B2S2,100,385
D10161,1,08/09/2021,PHA1F9BN21,50,335
D10161,1,08/10/2021,PHA9GMG3TD,100,235
D10161,1,,,50,185
D10161,1,08/11/2021,PHB6I0ZC8I,100,85
D10161,1,08/11/2021,PHB1I10HZF,85,0
D10162,1,07/14/2021,PGE4CO85GE,"3250","9050"
D10162,1,07/22/2021,PGM4NBPZT6,"5000","4050"
D10162,1,07/29/2021,PGT6XYREQM,"4050",0
D10162,2,08/08/2021,PH82DQKX8C,"11250",0
D10162,3,09/16/2021,PIG0Z16YR2,"20400",0
D10162,4,10/13/2021,PJD47MBEOQ,"19500",0
D10162,5,12/06/2021,PL63Q0TRXN,"20500","1400"
D10162,5,12/10/2021,PLA0X9N406,"1400",0
D10162,6,01/18/2022,QAI7SQAOG3,"4000","17900"
D10162,6,02/03/2022,QB33KANXXJ,"3500","14400"
D10162,6,02/04/2022,QB43M1U0J1,"1500","12900"
D10162,6,02/09/2022,QB96W2PXWW,1500,"11400"
D10162,6,02/18/2022,QBI8DEPIDK,11400,0
D10162,7,03/14/2022,QCE6O6LHSA,"8960",0
D10162,8,03/30/2022,QCU0I1OLVU,"1200","14400"
D10162,8,04/06/2022,QD62WU4L0K,"4000","10400"
D10162,8,04/09/2022,QD903GA1WI,8200,"2200"
D10162,8,04/11/2022,QDB474XDG6,2200,0
D10162,9,05/05/2022,QE56IKPKA8,"4500","11000"
D10162,9,05/06/2022,QE61KBO7Y5,"3200","7800"
D10162,9,05/07/2022,QE79L02QDH,7800,0
D10162,10,06/02/2022,QF2022FK6U,"15600",0
D10162,11,06/29/2022,QFT4K2IF8G,"15600",0
D10162,12,07/26/2022,QGQ04XX0XW,"19500",0
D10162,13,08/23/2022,QHN2ND4S6I,"19500",0
D10162,14,09/20/2022,QIK4BBCUQ,"1960","17540"
D10162,14,09/20/2022,QIK2BDD7M6,"1960","15580"
D10162,14,09/20/2022,QIK2BDSISE,15580,0
D10162,15,10/19/2022,QJJ36ZL0C9,"20400",0
D10162,16,11/16/2022,QKG224EUS4,"19500",0
D10162,17,12/16/2022,QLG9BDFTVP,"20400",0
D10163,1,07/10/2021,PGA95QSQL3,100,"6300"
D10163,1,07/10/2021,PGA85QTE7M,100,"6200"
D10163,1,07/10/2021,PGA65QU0D2,17,"6183"
D10163,1,07/10/2021,PGA37763CN,100,"6083"
D10163,1,07/11/2021,PGB7776V0B,100,"5983"
D10163,1,07/11/2021,PGB2777KEC,17,"5966"
D10163,1,07/11/2021,PGB28ES6Z6,100,"5866"
D10163,1,07/11/2021,PGB28EZ1RM,100,"5766"
D10163,1,07/12/2021,PGC59UUL41,100,"5666"
D10163,1,07/12/2021,PGC39UXFXX,100,"5566"
D10163,1,07/12/2021,PGC59UYDJ5,34,"5532"
D10163,1,07/13/2021,PGD2BAO4SA,100,"5432"
D10163,1,07/13/2021,PGD0BAQH60,100,"5332"
D10163,1,07/13/2021,PGD6BARMDS,17,"5315"
D10163,1,07/15/2021,PGF0CQWAD2,100,"5215"
D10163,1,07/15/2021,PGF6CQY8A6,100,"5115"
D10163,1,07/15/2021,PGF1E62ZIV,100,"5015"
D10163,1,07/15/2021,PGF3E6HOJD,100,"4915"
D10163,1,07/15/2021,PGF3E6K9OZ,17,"4898"
D10163,1,07/16/2021,PGG4FLRYE8,100,"4798"
D10163,1,07/16/2021,PGG5FLVN69,100,"4698"
D10163,1,07/16/2021,PGG9FM0JA3,34,"4664"
D10163,1,07/17/2021,PGI6H6HE7A,100,"4564"
D10163,1,07/17/2021,PGI2H6JJ42,100,"4464"
D10163,1,07/17/2021,PGI2H6K10S,17,"4447"
D10163,1,07/18/2021,PGI6IF1F1Q,100,"4347"
D10163,1,07/18/2021,PGI2IF3H4A,100,"4247"
D10163,1,07/18/2021,PGI2IF4R4E,17,"4230"
D10163,1,07/19/2021,PGJ9JUTMDL,100,"4130"
D10163,1,07/19/2021,PGJ7JUULQ1,100,"4030"
D10163,1,07/20/2021,PGK5JUVJN3,50,"3980"
D10163,1,07/20/2021,PGK8L7ECNQ,100,"3880"
D10163,1,07/20/2021,PGK4L7G0T6,100,"3780"
D10163,1,07/20/2021,PGK5L7HKMN,17,"3763"
D10163,1,07/22/2021,PGM4MNM50C,100,"3663"
D10163,1,07/22/2021,PGM8MNNLP4,100,"3563"
D10163,1,07/22/2021,PGM9MNNVY1,17,"3546"
D10163,1,07/23/2021,PGN5O3JD51,100,"3446"
D10163,1,07/23/2021,PGN6O3KB4E,100,"3346"
D10163,1,07/23/2021,PGN7O3KNVL,17,"3329"
D10163,1,07/23/2021,PGN8PKOGK8,100,"3229"
D10163,1,07/23/2021,PGN6PKP4MA,100,"3129"
D10163,1,07/23/2021,PGN2PKPOQW,17,"3112"
D10163,1,07/24/2021,PGO5R0ZIMX,100,"3012"
D10163,1,07/24/2021,PGO5R108OF,100,"2912"
D10163,1,07/24/2021,PGO0R11AKG,17,"2895"
D10163,1,07/26/2021,PGQ2SCBH4K,100,"2795"
D10163,1,07/26/2021,PGQ2SCBHNQ,100,"2695"
D10163,1,07/26/2021,PGQ8SCBTNA,17,"2678"
D10163,1,07/27/2021,PGR0TTILDA,100,"2578"
D10163,1,07/27/2021,PGR6TTIXXO,100,"2478"
D10163,1,07/27/2021,PGR6TTJ39M,17,"2461"
D10163,1,07/27/2021,PGR6V9QR1M,100,"2361"
D10163,1,07/27/2021,PGR7V9RPH3,100,"2261"
D10163,1,07/27/2021,PGR1V9TCOB,17,"2244"
D10163,1,07/29/2021,PGT7WPP073,217,"2027"
D10163,1,07/30/2021,PGU6Y49QR6,100,"1927"
D10163,1,07/30/2021,PGU4Y4AT7U,100,"1827"
D10163,1,07/30/2021,PGU4Y4BPO6,17,"1810"
D10163,1,07/31/2021,PGV0ZN1AC4,100,"1710"
D10163,1,07/31/2021,PGV1ZN2OPH,100,"1610"
D10163,1,07/31/2021,PGV3ZN3I9Z,100,"1510"
D10163,1,07/31/2021,PGV4ZN56AK,100,"1410"
D10163,1,07/31/2021,PGV7ZN6O1X,34,"1376"
D10163,1,08/01/2021,PH143G3RDM,100,"1276"
D10163,1,08/01/2021,PH163G466G,100,"1176"
D10163,1,08/01/2021,PH143G4KT2,17,"1159"
D10163,1,08/03/2021,PH364XVOFO,217,942
D10163,1,08/03/2021,PH456FQHYR,217,725
D10163,1,08/04/2021,PH597X4RD5,100,625
D10163,1,08/05/2021,PH5286DIY8,100,525
D10163,1,08/05/2021,PH5286UO9K,100,425
D10163,1,08/05/2021,PH599EFZIN,425,0
D10163,2,08/10/2021,PHA7GNCO57,100,"6400"
D10163,2,08/10/2021,PHA7GNDN9X,100,"6300"
D10163,2,08/10/2021,PHA7GNEFAT,100,"6200"
D10163,2,08/10/2021,PHA6GNFVP6,100,"6100"
D10163,2,08/10/2021,PHA4GNGNK6,34,"6066"
D10163,2,08/12/2021,PHC3I2HQ19,100,"5966"
D10163,2,08/12/2021,PHC3I2IH8Z,100,"5866"
D10163,2,08/12/2021,PHC2I2IZZO,100,"5766"
D10163,2,08/12/2021,PHC4I2JFVE,100,"5666"
D10163,2,08/12/2021,PHC2I2K200,34,"5632"
D10163,2,08/12/2021,PHC2JGBWUE,100,"5532"
D10163,2,08/12/2021,PHC2JGE9WM,100,"5432"
D10163,2,08/12/2021,PHC7JGFKOD,100,"5332"
D10163,2,08/12/2021,PHC3JGH6NR,100,"5232"
D10163,2,08/12/2021,PHC3JGI13L,34,"5198"
D10163,2,08/13/2021,PHD5KX149N,100,"5098"
D10163,2,08/13/2021,PHD4KX28PQ,100,"4998"
D10163,2,08/13/2021,PHD8KX4NNK,100,"4898"
D10163,2,08/13/2021,PHD7KX58BP,34,"4864"
D10163,2,08/16/2021,PHG4P4QJU0,110,"4754"
D10163,2,08/16/2021,PHG1P4RT6Z,107,"4647"
D10163,2,08/18/2021,PHI6QJ971O,217,"4430"
D10163,2,08/19/2021,PHJ3TB66O7,234,"4196"
D10163,2,08/22/2021,PHM8XDFNIQ,217,"3979"
D10163,2,08/23/2021,PHN6YQSU9Y,217,"3762"
D10163,2,08/24/2021,PHO81DQM2Y,651,"3111"
D10163,2,08/31/2021,PHV8BAK8EU,311,"2800"
D10163,2,09/01/2021,PI12BRU49G,100,"2700"
D10163,2,09/01/2021,PI15BRUBKL,200,"2500"
D10163,2,09/02/2021,PI21DGV1QT,500,"2000"
D10163,2,09/05/2021,PI53J860LJ,1150,850
D10163,2,09/05/2021,PI58J88LS4,35,815
D10163,2,09/06/2021,PI64JWAAEO,815,0
D10163,3,09/08/2021,PI87MCG7GT,100,"9000"
D10163,3,09/08/2021,PI82MCQI2W,100,"8900"
D10163,3,09/08/2021,PI87MCRL6J,100,"8800"
D10163,3,09/09/2021,PI96PBII72,500,"8300"
D10163,3,09/23/2021,PIN8B8ZBNK,650,"7650"
D10163,3,09/26/2021,PIQ1FPBU9L,100,"7550"
D10163,3,09/26/2021,PIQ0FQ31XW,100,"7450"
D10163,3,09/26/2021,PIQ8FQ437I,100,"7350"
D10163,3,09/26/2021,PIQ9FQ4W75,50,"7300"
D10163,3,09/28/2021,PIS5IR75JJ,100,"7200"
D10163,3,09/28/2021,PIS2IR8MD4,100,"7100"
D10163,3,09/28/2021,PIS2IRAEKI,100,"7000"
D10163,3,09/28/2021,PIS2IRCUGE,100,"6900"
D10163,3,09/28/2021,PIS6IRE0UC,8,"6892"
D10163,3,09/29/2021,PIT5KDVM77,100,"6792"
D10163,3,09/29/2021,PIT4KDXB98,100,"6692"
D10163,3,09/29/2021,PIT3KE6CXN,100,"6592"
D10163,3,09/29/2021,PIT7KE7RO5,8,"6584"
D10163,3,10/01/2021,PJ10NQ4LM4,100,"6484"
D10163,3,10/01/2021,PJ18NQ9ICU,100,"6384"
D10163,3,10/01/2021,PJ15NQAVN7,64,"6320"
D10163,3,10/03/2021,PJ35PJJDXB,2400,"3920"
D10163,3,10/05/2021,PJ55SRABB3,720,"3200"
D10163,3,10/05/2021,PJ58TLN33O,800,"2400"
D10163,3,10/05/2021,PJ55U49TCV,100,"2300"
D10163,3,10/05/2021,PJ59U4AXNJ,100,"2200"
D10163,3,10/05/2021,PJ53U4C9Q7,100,"2100"
D10163,3,10/05/2021,PJ57U4DK0P,100,"2000"
D10163,3,10/05/2021,PJ57U4EPRH,100,"1900"
D10163,3,10/05/2021,PJ52U4FX32,100,"1800"
D10163,3,10/05/2021,PJ51U4I39R,100,"1700"
D10163,3,10/05/2021,PJ51U4O4RR,1700,0
D10163,4,10/06/2021,PJ69VOX8R1,100,"9420"
D10163,4,10/07/2021,PJ79XBBBQ7,100,"9320"
D10163,4,10/07/2021,PJ71XBDF95,100,"9220"
D10163,4,10/07/2021,PJ74XBFOOC,100,"9120"
D10163,4,10/07/2021,PJ78XBHYWG,100,"9020"
D10163,4,10/07/2021,PJ78XBOJ9M,100,"8920"
D10163,4,10/07/2021,PJ79XBRHVF,8,"8912"
D10163,4,10/08/2021,PJ83YYWMM9,100,"8812"
D10163,4,10/08/2021,PJ80YYZVBU,100,"8712"
D10163,4,10/08/2021,PJ81YZ2RLH,100,"8612"
D10163,4,10/09/2021,PJ951MU255,100,"8512"
D10163,4,10/09/2021,PJ971MW219,100,"8412"
D10163,4,10/09/2021,PJ981MXNAE,100,"8312"
D10163,4,10/09/2021,PJ961N3YF0,8,"8304"
D10163,4,10/12/2021,PJC269M88Y,912,"7392"
D10163,4,10/14/2021,PJE78NC2HP,100,"7292"
D10163,4,10/14/2021,PJE08NH9IA,100,"7192"
D10163,4,10/14/2021,PJE58NOD3J,100,"7092"
D10163,4,10/14/2021,PJE08NSUVA,4,"7088"
D10163,4,10/16/2021,PJG6BWMZOC,100,"6988"
D10163,4,10/16/2021,PJG2BWVWII,100,"6888"
D10163,4,10/16/2021,PJG8BX07RU,100,"6788"
D10163,4,10/16/2021,PJG8BX61HA,4,"6784"
D10163,4,10/28/2021,PJS6V4SONG,500,"6284"
D10163,4,11/04/2021,PK446E67WY,440,"5844"
D10163,4,11/04/2021,PK437CJOS3,421,"5423"
D10163,4,11/04/2021,PK447VZOFM,1000,"4423"
D10163,4,11/04/2021,PK427W59FO,1000,"3423"
D10163,4,11/05/2021,PK528E1RLG,100,"3323"
D10163,4,11/05/2021,PK508E59VS,100,"3223"
D10163,4,11/05/2021,PK528E1RLG_D2,100,"3123"
D10163,4,11/05/2021,PK508E59VS_D2,100,"3023"
D10163,4,11/05/2021,PK509MMM8C,100,"2923"
D10163,4,11/06/2021,PK689RIEIM,100,"2823"
D10163,4,11/06/2021,PK689RLVDM,100,"2723"
D10163,4,11/06/2021,PK609RPPO0,100,"2623"
D10163,4,11/06/2021,PK609RSSEE,100,"2523"
D10163,4,11/06/2021,PK689TBWXO,2521,2
D10163,4,11/06/2021,PK649W1IGS,2,0
D10163,5,11/08/2021,PK80D3YKAK,100,"6700"
D10163,5,11/08/2021,PK84D430UE,100,"6600"
D10163,5,11/08/2021,PK85D462TB,17,"6583"
D10163,5,11/08/2021,PK82D49J0M,100,"6483"
D10163,5,11/08/2021,PK83D4CA27,100,"6383"
D10163,5,11/08/2021,PK87D4JQSH,17,"6366"
D10163,5,11/12/2021,PKC7JHPSNZ,100,"6266"
D10163,5,11/12/2021,PKC4JHVGTW,100,"6166"
D10163,5,11/12/2021,PKC9JHYXJ7,100,"6066"
D10163,5,11/12/2021,PKC7JI7DAF,100,"5966"
D10163,5,11/12/2021,PKC7JICWLF,100,"5866"
D10163,5,11/12/2021,PKC2JIHF9E,100,"5766"
D10163,5,11/12/2021,PKC5JILPVB,21,"5745"
D10163,5,11/12/2021,PKC5K6QND7,30,"5715"
D10163,5,11/19/2021,PKJ8US0F50,100,"5615"
D10163,5,11/19/2021,PKJ7US9YJ7,100,"5515"
D10163,5,11/19/2021,PKJ3USF375,17,"5498"
D10163,5,11/26/2021,PKQ77FN485,100,"5398"
D10163,5,11/26/2021,PKQ57FQFH5,17,"5381"
D10163,5,11/26/2021,PKQ67FFMC0,100,"5281"
D10163,5,12/01/2021,PL17GMRCXH,100,"5181"
D10163,5,12/01/2021,PL18GMWQ5W,100,"5081"
D10163,5,12/01/2021,PL14GN1DI8,17,"5064"
D10163,5,12/06/2021,PL68ORG9J8,4400,664
D10163,5,12/06/2021,PL69OSE7TH,80,584
D10163,5,12/06/2021,PL60OXHX94,67,517
D10163,5,12/04/2021,PL41LKJYCP,100,417
D10163,5,12/04/2021,PL47LM8LFP,100,317
D10163,5,12/04/2021,PL40LMH30C,17,300
D10163,5,12/07/2021,PL73QLLNY3,100,200
D10163,5,12/07/2021,PL70QLROPW,100,100
D10163,5,12/07/2021,PL74QLVO7U,100,0
D10164,1,07/17/2021,PGH3FRG89N,"2275","7245"
D10164,1,07/27/2021,PGR3V8AL85,"2275","4970"
D10164,1,08/06/2021,PH66AATFBG,500,"4470"
D10164,1,08/07/2021,PH78AYZVAS,"1000","3470"
D10164,1,08/09/2021,PH96DT7KES,1000,"2470"
D10164,1,08/10/2021,PHA0FCGP7U,500,"1970"
D10164,1,08/15/2021,PHF1NOAALN,1000,970
D10164,1,08/16/2021,PHG7P32OTT,400,570
D10164,1,08/25/2021,PHP029G3GE,150,420
D10164,1,08/25/2021,PENALTIES W/OFF,420,0
D10165,1,07/17/2021,PGH8H3T8ME,"1500","4800"
D10165,1,07/20/2021,PGK6JYSP5K,125,"4675"
D10165,1,07/28/2021,PGS6W3X02Q,750,"3925"
D10165,1,07/28/2021,PGS5W40YTB,20,"3905"
D10165,1,07/30/2021,PGU3YC8FJZ,550,"3355"
D10165,1,08/01/2021,PH133ERA1N,1920,"1435"
D10165,1,08/03/2021,PH3850NIQG,1385,50
D10165,1,08/03/2021,PH395AC5K7,50,0
D10165,2,08/09/2021,PH98E06ABW,"1625","4875"
D10165,2,08/21/2021,PHL5V69CCF,"2000","2875"
D10165,2,08/29/2021,PHT38K16PX,"2300",575
D10165,2,08/31/2021,LOAN CLEARED,575,0
D10165,3,09/28/2021,PIS5HFC8MV,"4000","2500"
D10165,3,09/28/2021,PIS6HKQC6U,"2500",0
D10166,1,07/13/2021,PGD1ANHDJT,120,"2480"
D10166,1,07/14/2021,PGE9C4AGPR,100,"2380"
D10166,1,07/27/2021,PGR4UVGY44,100,"2280"
D10166,1,07/27/2021,PGR9UVJHBV,30,"2250"
D10166,1,07/31/2021,PGV31F3I0B,100,"2150"
D10166,1,08/03/2021,PH395QG093,100,"2050"
D10166,1,08/10/2021,PHA1FF2E4V,2050,0
D10167,1,07/22/2021,PGM3O3BDNT,"1625","4875"
D10167,1,08/10/2021,PHA3G3TGC7,"3250","1625"
D10167,1,08/12/2021,PHC6I9XK8I,"1625",0
D10167,2,09/16/2021,PIG8YTNT30,500,"6300"
D10167,2,09/17/2021,PIH01ATFBE,"6000",300
D10167,2,09/17/2021,PIH71IX0QT,300,0
D10168,1,08/17/2021,PHH5PQNH4F,"13000",0
D10168,2,09/15/2021,PIF2XSTG6U,"13000",0
D10168,3,10/16/2021,PJG5B84Z7F,"19500",0
D10168,4,11/15/2021,PKF0OEXLOE,"20400",0
D10168,5,12/15/2021,PLF45ZOCBM,"19500",0
D10168,6,01/14/2022,QAE0LEXU34,"19500",0
D10168,7,02/12/2022,QBC92G88WD,"26000",0
D10168,8,03/10/2022,QCA3GJJTZF,"25500",0
D10168,9,04/08/2022,QD871YAVKB,"26000",0
D10168,10,05/06/2022,QE64JMXDXE,"26000",0
D10168,11,06/04/2022,QF485PFL02,"8000","19200"
D10168,11,06/05/2022,QF557JTWAN,"18000","1200"
D10168,11,06/06/2022,QF649VXZ5G,"1200",0
D10168,12,07/05/2022,QG52WX0MTQ,"26000",0
D10168,13,08/05/2022,QH54P4K5Y6,"27200",0
D10168,14,09/05/2022,QI58EX8FQM,"26000","1200"
D10168,14,09/05/2022,QI59F014OZ,"1200",0
D10168,15,10/05/2022,QJ52AFMAOG,"27200",0
D10168,16,11/05/2022,QK53BHCIA5,"27200",0
D10168,17,12/05/2022,QL59F2XBNP,"27200",0
D10168,18,01/05/2023,RA53QH42JP,"27200",0
D10168,19,02/04/2023,RB41VIWDHP,"27200",0
D10168,20,02/20/2023,RBK73XQ8PH,"23400",0
D10168,21,03/20/2023,RCK68E80SS,"25800",0
D10168,22,04/11/2023,RDB7X1M3DZ,"30750",0
D10168,23,05/12/2023,REC3D0OSZN,"34000",0
D10168,24,06/06/2023,RF69CTK9UJ,"31500",0
D10168,25,07/06/2023,RG69TX9EGN,"32500",0
D10168,26,08/05/2023,RH59BCQ3C5,"39000",0
D10169,1,07/26/2021,PGQ3TAH4QR,100,"6700"
D10169,1,07/26/2021,PGQ1TALZVF,100,"6600"
D10169,1,07/26/2021,PGQ6TAQY2K,100,"6500"
D10169,1,07/26/2021,PGQ3TAYKOL,100,"6400"
D10169,1,07/26/2021,PGQ2TB33PQ,100,"6300"
D10169,1,07/26/2021,PGQ8TF438O,625,"5675"
D10169,1,07/28/2021,PGS0VDMAWM,100,"5575"
D10169,1,07/28/2021,PGS9VDOH5T,100,"5475"
D10169,1,07/28/2021,PGS2VDRCXG,100,"5375"
D10169,1,07/26/2021,PGQ7TDKYPB,100,"5275"
D10169,1,07/26/2021,PGQ9TDPJHB,100,"5175"
D10169,1,07/26/2021,PGQ6TDUH5M,100,"5075"
D10169,1,07/26/2021,PGQ8TDZ6XC,100,"4975"
D10169,1,07/26/2021,PGQ1TE3Q59,100,"4875"
D10169,1,07/29/2021,PGT9X21JEZ,100,"4775"
D10169,1,07/29/2021,PGT6X27QN0,100,"4675"
D10169,1,07/29/2021,PGT7X2BK47,100,"4575"
D10169,1,07/30/2021,PGU1Y9P1XJ,100,"4475"
D10169,1,07/30/2021,PGU2Y9VM92,100,"4375"
D10169,1,07/30/2021,PGU2Y9YMDA,100,"4275"
D10169,1,07/30/2021,PGU0YA1AP0,100,"4175"
D10169,1,07/30/2021,PGU9YA7ET5,50,"4125"
D10169,1,08/02/2021,PH273MQUOH,100,"4025"
D10169,1,08/02/2021,PH293MYGGN,100,"3925"
D10169,1,08/02/2021,PH263N1SH4,100,"3825"
D10169,1,08/03/2021,PH38562S9I,100,"3725"
D10169,1,08/03/2021,PH31567RV5,100,"3625"
D10169,1,08/03/2021,PH3556CRUZ,75,"3550"
D10169,1,08/11/2021,PHB2GSM77M,100,"3450"
D10169,1,08/11/2021,PHB3GSOC3P,100,"3350"
D10169,1,08/11/2021,PHB1GTDZD5,100,"3250"
D10169,1,08/11/2021,PHB9GTGJQD,100,"3150"
D10169,1,08/12/2021,PHC5I5E0JJ,100,"3050"
D10169,1,08/12/2021,PHC2I5FGEY,100,"2950"
D10169,1,08/12/2021,PHC9I5H1UD,100,"2850"
D10169,1,08/13/2021,PHD6JK7VZO,100,"2750"
D10169,1,08/13/2021,PHD5JKB22L,100,"2650"
D10169,1,08/13/2021,PHD1JKE0WV,100,"2550"
D10169,1,08/14/2021,PHE5LKBVUR,100,"2450"
D10169,1,08/14/2021,PHE7LKELU1,100,"2350"
D10169,1,08/14/2021,PHE4LKH7EA,100,"2250"
D10169,1,08/15/2021,PHF6NCIG0M,100,"2150"
D10169,1,08/15/2021,PHF5NCLS1Z,100,"2050"
D10169,1,08/15/2021,PHF4NCQPZI,100,"1950"
D10169,1,08/16/2021,PHG1NYH7K5,100,"1850"
D10169,1,08/16/2021,PHG5OVCJCR,1050,800
D10169,1,08/18/2021,PHI3QNT8XT,500,300
D10169,1,08/18/2021,PENALTIES W/OFF,300,0
D10170,1,07/22/2021,PGM0NHP9ZQ,100,"6400"
D10170,1,07/22/2021,PGM3NI0WVJ,100,"6300"
D10170,1,07/22/2021,PGM9NI9SGZ,17,"6283"
D10170,1,07/23/2021,PGN9P0L9XV,100,"6183"
D10170,1,07/23/2021,PGN1P0QU73,100,"6083"
D10170,1,07/23/2021,PGN7P0W49R,17,"6066"
D10170,1,07/24/2021,PGO0QFCVYC,434,"5632"
D10170,1,07/26/2021,PGQ8TGO4X2,217,"5415"
D10170,1,07/27/2021,PGR7V0MFAT,217,"5198"
D10170,1,07/29/2021,PGT7Y29LDX,434,"4764"
D10170,1,08/01/2021,PH1828PBDO,434,"4330"
D10170,1,08/02/2021,PH244XFBVA,868,"3462"
D10170,1,08/07/2021,PH78C5EC6E,651,"2811"
D10170,1,08/11/2021,PHB9I14ZK1,868,"1943"
D10170,1,08/15/2021,PHF3NEAXAX,868,"1075"
D10170,1,08/19/2021,PHJ0T082CY,1078,3
D10171,1,07/28/2021,PGS7VYJ4IV,"1700","4800"
D10171,1,08/05/2021,PH507Z39II,700,"4100"
D10171,1,08/07/2021,PH72CAKR4E,900,"3200"
D10171,1,08/16/2021,PHG0OKY50C,"3200",0
D10171,2,08/30/2021,PHU68U0VDO,630,"6670"
D10171,2,09/01/2021,PI12D4YJF2,750,"5920"
D10171,2,09/13/2021,PID5V5DXJJ,"1300","4620"
D10171,2,09/20/2021,PIK15D5CP1,500,"4120"
D10171,2,09/22/2021,PIM18SH15H,130,"3990"
D10171,2,09/28/2021,PIS6IB64JI,1530,"2460"
D10171,2,09/29/2021,PIT1JQFCXL,2460,0
D10172,1,07/31/2021,PGV4123S8C,100,"5100"
D10172,1,08/03/2021,PH3058ELF2,200,"4900"
D10172,1,08/06/2021,PH689KYNAM,200,"4700"
D10172,1,08/09/2021,PH90DWI6J2,500,"4200"
D10172,1,08/12/2021,PHC4J9ASL2,1500,"2700"
D10172,1,08/14/2021,PHE4L2RBIU,300,"2400"
D10172,1,08/16/2021,PHG4OFMHV0,1400,"1000"
D10172,1,08/17/2021,PHH4P8W4J6,400,600
D10172,1,08/17/2021,PHH5PH2QCN,100,500
D10172,1,08/17/2021,PHH1PH9YWJ,20,480
D10172,1,08/17/2021,PHH3PHYMKZ,480,0
D10172,2,08/26/2021,PHQ64BKBRI,150,"4850"
D10172,2,09/08/2021,PI89MH583J,"2000","2850"
D10172,2,09/09/2021,PI97O0LRFF,"1500","1350"
D10172,2,09/09/2021,PI90P5QT1E,1350,0
D10172,3,10/14/2021,PJE48AB2D0,980,"4220"
D10172,3,10/16/2021,PJG4BC8Q6Q,"2000","2220"
D10172,3,10/18/2021,PJI2E44PC8,"2000",220
D10172,3,10/18/2021,PJI1EDLSFZ,220,0
D10172,4,11/11/2021,PKB8III37E,"4000","1080"
D10172,4,11/12/2021,PKC9JNFJDF,"1080",0
D10172,5,12/07/2021,PL74RTW2BS,"2000","3120"
D10172,5,12/08/2021,PL81SVTIOV,"3120",0
D10172,6,01/05/2022,QA536JZOT5,"5200",0
D10172,7,02/04/2022,QB42MNTGRU,"5600",160
D10172,8,03/04/2022,QC4644T9AK,"5200",0
D10172,9,04/05/2022,QD53UQHIR5,"1000","5320"
D10172,9,04/07/2022,QD77Y5RQNR,800,"4520"
D10172,9,04/14/2022,QDE2DLV3VI,800,"3720"
D10172,9,04/19/2022,QDJ3MA4IFJ,750,"2970"
D10172,9,04/20/2022,QDN7TKYXVP,300,"2670"
D10172,9,05/16/2022,QEG63RHJA0,500,"2170"
D10172,9,06/09/2022,QF96F44YMM,1050,"1120"
D10172,9,07/19/2022,QGJ7QB1S1Z,450,670
D10172,9,08/30/2022,QHU629OVAU,300,370
D10172,9,09/06/2022,QI68H5Q1Q8,200,170
D10172,9,09/09/2022,QI92NO1H5C,170,0
D10173,1,07/24/2021,PGO8QSANBA,500,"6300"
D10173,1,07/27/2021,PGR5UWXLOZ,500,"5800"
D10173,1,07/29/2021,PGT3X36QCD,625,"5175"
D10173,1,08/05/2021,PH548UHFGI,500,"4675"
D10173,1,08/08/2021,PH81DNHEBD,370,"4305"
D10173,1,08/10/2021,PHA8GHBSCO,450,"3855"
D10173,1,08/14/2021,PHE3LIE5P5,900,"2955"
D10173,1,08/20/2021,PHK5U1YZ4B,1000,"1955"
D10173,1,08/21/2021,PHL1W3I4OP,700,"1255"
D10173,1,08/24/2021,PHO1ZDHPX3,700,555
D10173,1,08/25/2021,PHP61VPJ46,200,355
D10173,1,08/25/2021,PHP31X53R9,100,255
D10173,1,08/25/2021,PHP71X76TL,100,155
D10173,1,08/25/2021,PHP01YIEXK,100,55
D10173,1,08/25/2021,PHP91YLHAB,55,0
D10174,1,07/29/2021,PGT2Y2QZGY,"3250","9750"
D10174,1,08/06/2021,PH68AVGSGC,"3250","6500"
D10174,1,08/13/2021,PHD3KW1KCX,"2250","4250"
D10174,1,08/19/2021,PHJ8SU5TKQ,250,"4000"
D10174,1,08/19/2021,PHJ7SUOYYH,4000,0
D10174,2,09/01/2021,PI16D93T3Y,600,"13000"
D10174,2,09/07/2021,PI70M9BERM,500,"12500"
D10174,2,09/12/2021,PIC8TPXRHM,"1000","11500"
D10174,2,09/17/2021,PIH415HS6W,11500,0
D10174,3,10/05/2021,PJ51U1PI2F,400,"13200"
D10174,3,10/06/2021,PJ77VRZKCH,350,"12850"
D10174,3,10/16/2021,PJG8BDZTFU,"1200","11650"
D10174,3,10/19/2021,PJJ3G7AKNR,11650,0
D10174,4,11/15/2022,QKF413UXD4,100,"6000"
D10174,4,11/15/2022,QKF813XYQQ,100,"5900"
D10174,4,11/23/2022,QKN0JF5TA2,300,"5600"
D10174,4,12/05/2022,QL50EQJ4WU,5600,0
D10174,5,01/03/2023,RA38LJQAMA,"6500",0
D10174,6,01/30/2023,RAU5HR03DF,"6450",0
D10174,7,02/28/2023,RBS6NDL1SK,"6500",300
D10174,7,02/28/2023,RBS6NUOVLM,300,0
D10174,8,03/20/2023,RCK39SQGHH,"1700","4750"
D10174,8,03/21/2023,RCL5CJKM4N,400,"4350"
D10174,8,03/27/2023,RCR4Q87POY,"4350",0
D10174,9,08/07/2023,RH70I81TL8,100,"7800"
D10175,1,07/30/2021,PGU6ZGJMLI,"1025","5475"
D10175,1,07/31/2021,PGV122QTJN,600,"4875"
D10175,1,08/06/2021,PH62AUNZBS,800,"4075"
D10175,1,08/14/2021,PHE3KX65L3,925,"3150"
D10175,1,08/15/2021,PHF6NK8BYU,100,"3050"
D10175,1,08/18/2021,PHI3RWWE6R,200,"2850"
D10175,1,08/20/2021,PHK6U1EE9I,2850,0
D10175,2,09/03/2021,PI39GAU9JF,750,"5750"
D10175,2,09/05/2021,PI53J94655,200,"5550"
D10175,2,09/07/2021,PI74M2E7YU,400,"5150"
D10175,2,09/08/2021,PI85NUVND5,1000,"4150"
D10175,2,09/12/2021,PIC1TK7PBT,800,"3350"
D10175,2,09/14/2021,PIE3WIWK2T,700,"2650"
D10175,2,09/17/2021,PIH11C888T,2650,0
D10175,3,10/05/2021,PJ57U01PYR,750,"7150"
D10175,3,10/11/2021,PJB34K1FUX,530,"6620"
D10175,3,10/17/2021,PJH3E1WNAD,850,"5770"
D10175,3,10/21/2021,PJL5IZ6YBL,600,"5170"
D10175,3,10/29/2021,PJT1VDMQU9,500,"4670"
D10175,3,11/01/2021,PK131P3SB5,400,"4270"
D10175,3,11/16/2021,PKG3PP2X8Z,450,"3820"
D10176,1,08/04/2021,PH426OWFAA,"2300","7220"
D10176,1,08/19/2021,PHJ0SOPJN6,700,"6520"
D10176,1,08/19/2021,PHJ2SQ8PH8,300,"6220"
D10176,1,08/24/2021,PHO9ZNQ0ZP,"1100","5120"
D10176,1,08/24/2021,PHO1ZSE3SX,100,"5020"
D10176,1,08/24/2021,PHO6ZSHOJS,100,"4920"
D10176,1,08/24/2021,PHO3ZSATI3,100,"4820"
D10176,1,08/27/2021,PHR85B95BC,1000,"3820"
D10176,1,08/27/2021,PHR95DTEBH,1000,"2820"
D10176,1,08/28/2021,PHS46XM1GQ,100,"2720"
D10176,1,08/28/2021,PHS46XSFBQ,100,"2620"
D10177,1,07/31/2021,PGV51HXAZ9,"1950","5850"
D10177,1,08/09/2021,PH98F13X6U,"1950","3900"
D10177,1,08/16/2021,PHG0OYGBPK,"1100","2800"
D10177,1,08/20/2021,PHK8U1ZS22,"2800",0
D10177,2,09/19/2021,PIJ84BDXWU,200,"9280"
D10177,2,09/22/2021,PIM18XTV7X,100,"9180"
D10177,2,09/22/2021,PIM38XXPQN,100,"9080"
D10177,2,09/24/2021,PIO2C1D9TS,200,"8880"
D10177,2,09/27/2021,PIR4G22KA4,200,"8680"
D10177,2,09/27/2021,PIR5GBK837,470,"8210"
D10177,2,09/29/2021,PIT3JO8ZGB,100,"8110"
D10177,2,10/01/2021,PJ17MPJ7QN,500,"7610"
D10177,2,10/06/2021,PJ63UIFG6D,200,"7410"
D10177,2,10/08/2021,PJ89Y1LDCD,200,"7210"
D10177,2,11/15/2021,PKF6OBC1DU,500,"6710"
D10177,2,11/26/2021,PKQ8819Y10,200,"6510"
D10177,2,11/30/2021,PKU3E9EIMB,200,"6310"
D10178,1,08/02/2021,PH224X4EUM,"1625","4225"
D10178,1,08/10/2021,PHA6FB9HLI,"1625","2600"
D10178,1,08/10/2021,PHA2G5Q8MK,"2600",0
D10178,2,08/18/2021,PHI6R3ADOE,"1625","4625"
D10178,2,08/25/2021,PHP62R2AOQ,"1625","3000"
D10178,2,08/31/2021,PHV9AQ2HTZ,"3000",0
D10178,3,09/08/2021,PI86NR82LK,"1625","4525"
D10178,3,09/21/2021,PIL87MO17W,"4525",0
D10178,4,10/25/2021,PJP0P9PXJO,300,"7600"
D10178,4,10/26/2021,PJQ4QJIT7U,498,"7102"
D10178,4,10/28/2021,PJS2TUGEI0,500,"6602"
D10178,4,11/04/2021,PK476ZC19T,100,"6502"
D10178,4,11/04/2021,PK457HXQ8T,100,"6402"
D10178,4,11/04/2021,PK467I9HGE,100,"6302"
D10178,4,11/04/2021,PK486ZKX9A,90,"6212"
D10178,4,11/11/2021,PKC1JDFIWJ,520,"5692"
D10178,4,11/16/2021,PKG6PW5YBY,100,"5592"
D10178,4,11/16/2021,PKG7PWAIA7,100,"5492"
D10178,4,11/17/2021,PKH4RAMXBG,100,"5392"
D10178,4,11/17/2021,PKH9RAQ00V,70,"5322"
D10178,4,11/18/2021,PKI3SXPTJT,100,"5222"
D10178,4,11/18/2021,PKI3SXSHHP,100,"5122"
D10178,4,11/20/2021,PKK9WEA51R,100,"5022"
D10178,4,11/19/2021,PKJ6W5RSYU,100,"4922"
D10178,4,11/19/2021,PKJ8W5PVXM,100,"4822"
D10178,4,11/28/2021,PKT8CFS6C0,100,"4722"
D10178,4,11/28/2021,PKT3CFVG4P,100,"4622"
D10178,4,11/28/2021,PKT7CG17WT,97,"4525"
D10178,4,12/18/2021,PLH2APRECY,100,"4425"
D10178,4,12/18/2021,PLH8APT2KM,100,"4325"
D10178,4,12/18/2021,PLI6AXMFBA,100,"4225"
D10178,4,12/20/2021,PLK6E6K9JI,100,"4125"
D10178,4,12/20/2021,PLK3E6M3IP,100,"4025"
D10178,4,01/04/2022,QA565S1FKM,500,"3525"
D10178,4,01/08/2022,QA86AYPPN4,400,"3125"
D10178,4,01/11/2022,QAB4FYVM20,100,"3025"
D10178,4,01/11/2022,QAB4FYYQSW,100,"2925"
D10179,1,08/20/2021,PHK4TMZ7I8,"12600",0
D10179,2,09/14/2021,PIE9WHC1MF,"14600","2000"
D10179,3,09/15/2021,PIE9WHC1MF_D2,"2000","17350"
D10179,3,10/13/2021,PJD36PADZT,"15000","2350"
D10179,3,10/13/2021,PJD86PRIES,"2350",0
D10179,4,11/10/2021,PKA5GHEFMB,"19350",0
D10179,5,12/08/2021,PL89T82S3T,"21930",0
D10179,6,01/06/2022,QA6287HWJ4,"26000",0
D10179,7,02/04/2022,QB48MJ686W,"26000",0
D10179,8,03/03/2022,QC331TPKXZ,"25600",0
D10179,9,04/04/2022,QD45SFDWXT,"34000",0
D10179,10,05/04/2022,QE4FH0UX8,"11500","22500"
D10179,10,05/05/2022,QE55GY8H5P,"22500",0
D10179,11,06/01/2022,QF18Z16DYE,"5000","29000"
D10179,11,06/03/2022,QF3144FR4R,"4000","25000"
D10179,11,06/04/2022,QF435NM1V1,"5000","20000"
D10179,11,06/06/2022,QF61ADRI8F,6000,"14000"
D10179,11,06/06/2022,QF69AEQ10X,2500,"11500"
D10179,11,06/07/2022,QF75BA7UDJ,6500,"5000"
D10179,11,06/07/2022,QF77C6XAZB,5000,0
D10179,12,07/05/2022,QG59VZUY9P,"10000","24000"
D10179,12,07/07/2022,QG792HKB2H,"10000","14000"
D10179,12,07/10/2022,QGA192PS5R,"10000","4000"
D10179,12,07/11/2022,QGB3AVCT7J,4000,0
D10179,13,08/05/2022,QH53OT1QRB,"5000","26500"
D10179,13,08/06/2022,QH61R8QXYD,"25000","1500"
D10179,13,08/06/2022,QH67RATK51,"1500",0
D10179,14,09/01/2022,QI176IX8TX,"31750",0
D10179,15,09/30/2022,QIU3XGW1NN,"32500",0
D10179,16,10/21/2022,QJL2C4FV6O,"10000","21250"
D10179,16,10/24/2022,QJO1I6E661,"21250",0
D10179,17,11/14/2022,QKE5W6TPF3,"33550",0
D10179,18,12/07/2022,QL75LTN0UR,"34100",0
D10179,19,01/06/2022,RA60SNV270,"25000","12400"
D10179,19,01/06/2022,RA60THY32A,"12400",0
D10179,20,02/07/2023,RB723YE4ZW,"37500",100
D10179,21,03/11/2023,RCB2IY00C8,"37850",450
D10179,22,04/17/2023,RDH7E92A9D,"5000","35150"
D10179,22,04/24/2023,RDO9WB0C8V,"10000","25150"
D10179,22,05/05/2023,RE57R8XBSF,"5000","20150"
D10179,22,05/05/2023,RE55RFWWNB,150,"20000"
D10179,22,05/05/2023,RE56RDDSB4,20000,0
D10180,1,08/04/2021,PH406HSMK2,"1625","4625"
D10180,1,08/11/2021,PHB4GSHYOU,"1625","3000"
D10180,1,08/19/2021,PHJ9S5RBAD,"3000",0
D10180,2,09/04/2021,PI45H3MCDX,502,"7398"
D10180,2,09/06/2021,PI64JWAAEO_D2,500,"6898"
D10180,2,09/11/2021,PIB4R53C7U,250,"6648"
D10180,2,09/13/2021,PID6ULHG1G,500,"6148"
D10180,2,09/20/2021,PIK85ZUE8Q,500,"5648"
D10180,2,09/22/2021,PIM68YKYLE,427,"5221"
D10180,2,09/24/2021,PIO7C2CG3R,100,"5121"
D10180,2,09/24/2021,PIO4C2MKLW,50,"5071"
D10180,2,09/29/2021,PIT9JKHJOP,100,"4971"
D10180,2,09/29/2021,PIT6JKJZMQ,100,"4871"
D10180,2,10/01/2021,PJ16MU2ADE,100,"4771"
D10180,2,10/01/2021,PJ10MU5EDQ,100,"4671"
D10180,2,10/05/2021,PJ55TA8OJP,100,"4571"
D10180,2,10/05/2021,PJ59TAB0U9,100,"4471"
D10180,2,10/06/2021,PJ66USJ9IW,100,"4371"
D10180,2,10/06/2021,PJ67USLMUL,100,"4271"
D10180,2,10/08/2021,PJ86XZ0FZS,100,"4171"
D10180,2,10/08/2021,PJ84Y63NRG,100,"4071"
D10180,2,10/11/2021,PJB53RZAVJ,200,"3871"
D10180,2,10/18/2021,PJI7EU9ERN,100,"3771"
D10180,2,10/27/2021,PJR8SVDVDW,966,"2805"
D10180,2,10/27/2021,PJR3SVHFI9,11,"2794"
D10180,2,11/04/2021,PK4974N3F7,500,"2294"
D10180,2,11/15/2021,PKF0ONHSAI,500,"1794"
D10180,2,11/19/2021,PKJ9V6DG5X,200,"1594"
D10180,2,11/23/2021,PKN12Y6NDX,100,"1494"
D10180,2,12/06/2021,PL62P56SDK,200,"1294"
D10181,1,07/28/2021,PGS9WK1LLJ,100,"7700"
D10181,1,07/28/2021,PGS1WK5OB9,100,"7600"
D10181,1,07/28/2021,PGS0WK8JBU,60,"7540"
D10181,1,07/29/2021,PGT0Y3XDNO,100,"7440"
D10181,1,07/29/2021,PGT2Y3XSEK,100,"7340"
D10181,1,07/29/2021,PGT2Y3YBNW,60,"7280"
D10181,1,07/30/2021,PGV9ZMMPPF,100,"7180"
D10181,1,07/30/2021,PGV8ZMMX6K,100,"7080"
D10181,1,07/30/2021,PGV3ZMN3WN,60,"7020"
D10181,1,08/01/2021,PH15236SVF,100,"6920"
D10181,1,08/01/2021,PH12237276,100,"6820"
D10181,1,08/01/2021,PH11237973,60,"6760"
D10181,1,08/01/2021,PH113FEER3,100,"6660"
D10181,1,08/01/2021,PH193FF8HL,100,"6560"
D10181,1,08/01/2021,PH123FFYPA,60,"6500"
D10181,1,08/02/2021,PH274T44Y7,260,"6240"
D10181,1,08/03/2021,PH396ERMEL,260,"5980"
D10181,1,08/04/2021,PH477WLLA1,100,"5880"
D10181,1,08/04/2021,PH467WMF4G,100,"5780"
D10181,1,08/04/2021,PH447WN9TE,60,"5720"
D10181,1,08/05/2021,PH529DLW6G,100,"5620"
D10181,1,08/05/2021,PH529DMSD2,100,"5520"
D10181,1,08/05/2021,PH559DNC3F,60,"5460"
D10181,1,08/07/2021,PH72AZPWAA,100,"5360"
D10181,1,08/07/2021,PH74AZRWGE,100,"5260"
D10181,1,08/07/2021,PH72AZTIZ0,60,"5200"
D10181,1,08/08/2021,PH82CFJI1W,100,"5100"
D10181,1,08/08/2021,PH88CFJYFS,100,"5000"
D10181,1,08/08/2021,PH88CFK80I,60,"4940"
D10181,1,08/09/2021,PH94DRH502,100,"4840"
D10181,1,08/09/2021,PH90DRH30U,100,"4740"
D10181,1,08/09/2021,PH98DRHBCI,60,"4680"
D10181,1,08/11/2021,PHB3GULG0F,100,"4580"
D10181,1,08/11/2021,PHB4GUNTTW,100,"4480"
D10181,1,08/11/2021,PHB6GUPDAM,60,"4420"
D10181,1,08/13/2021,PHD1JKLY8J,100,"4320"
D10181,1,08/13/2021,PHD7JKNIVV,100,"4220"
D10181,1,08/13/2021,PHD5JKP8HV,60,"4160"
D10181,1,08/15/2021,PHF4MHQ8O2,100,"4060"
D10181,1,08/15/2021,PHF9MHRX9B,100,"3960"
D10181,1,08/15/2021,PHF4MHTR6S,60,"3900"
D10181,1,08/17/2021,PHH1QEUCHH,100,"3800"
D10181,1,08/17/2021,PHH5QEWTLN,100,"3700"
D10181,1,08/17/2021,PHH9QEYKQJ,60,"3640"
D10181,1,08/19/2021,PHK9TCBE3Z,100,"3540"
D10181,1,08/19/2021,PHK8TCBJFC,100,"3440"
D10181,1,08/19/2021,PHK0TCBO4K,60,"3380"
D10181,1,08/21/2021,PHL5UXE7AV,100,"3280"
D10181,1,08/21/2021,PHL6UXH33A,100,"3180"
D10181,1,08/21/2021,PHL3UXIFN9,60,"3120"
D10181,1,08/23/2021,PHN0XORRZY,600,"2520"
D10181,1,08/25/2021,PHP929MACT,2520,0
D10181,2,08/26/2021,PHQ13LYE8B,100,"7700"
D10181,2,08/26/2021,PHQ63M1J2E,100,"7600"
D10181,2,08/26/2021,PHQ53M3D6N,60,"7540"
D10181,2,08/28/2021,PHS77CM6CN,260,"7280"
D10181,2,08/30/2021,PHU899KORE,260,"7020"
D10181,2,09/01/2021,PI15BS3LJX,260,"6760"
D10181,2,09/01/2021,PI12D8VTQA,260,"6500"
D10181,2,09/06/2021,PI63JCXIUB,100,"6400"
D10181,2,09/06/2021,PI66JD4DOS,100,"6300"
D10181,2,09/06/2021,PI67JD6ROX,60,"6240"
D10181,2,09/09/2021,PI95OFNY1X,60,"6180"
D10181,2,09/09/2021,PI91OFQLWN,100,"6080"
D10181,2,09/09/2021,PI94OFTG96,100,"5980"
D10181,2,09/10/2021,PIA7Q4N33X,60,"5920"
D10181,2,09/10/2021,PIA5Q4PVI1,100,"5820"
D10181,2,09/10/2021,PIA6Q4SA6W,100,"5720"
D10181,2,09/13/2021,PID0U4J354,100,"5620"
D10181,2,09/13/2021,PID4U4L93W,100,"5520"
D10181,2,09/13/2021,PID6U4N39M,60,"5460"
D10181,2,09/15/2021,PIF6X0B1CO,100,"5360"
D10181,2,09/15/2021,PIF5X0DSMT,100,"5260"
D10181,2,09/15/2021,PIF7X0FC57,60,"5200"
D10181,2,09/18/2021,PII52GYK7L,100,"5100"
D10181,2,09/18/2021,PII12GZW4H,100,"5000"
D10181,2,09/18/2021,PII72H2AQF,60,"4940"
D10181,2,09/19/2021,PIJ441AFD6,100,"4840"
D10181,2,09/19/2021,PIJ041C9KY,100,"4740"
D10181,2,09/19/2021,PIJ641F4IY,60,"4680"
D10181,2,09/21/2021,PIL06UYRQW,100,"4580"
D10181,2,09/21/2021,PIL66UZTHO,100,"4480"
D10181,2,09/21/2021,PIL56V0Z03,60,"4420"
D10181,2,09/22/2021,PIM28CJWCY,520,"3900"
D10181,2,09/23/2021,PIN2ALRTKA,3900,0
D10182,1,08/05/2021,PH568E6D5K,"1625","6275"
D10182,1,08/12/2021,PHC7IEF9NN,"1625","4650"
D10182,1,09/15/2021,PIF4X1F0JG,600,"4050"
D10182,1,09/15/2021,PIF2X6DCIU,"4000",50
D10182,1,09/15/2021,PIF5X6J5WZ,47,3
D10182,1,09/15/2021,PIF0X6NFTO,3,0
D10183,1,07/30/2021,PGU6ZHEATQ,300,"6020"
D10183,1,08/02/2021,PH283RCT9I,348,"5672"
D10183,1,08/04/2021,PH497TBCUZ,157,"5515"
D10183,1,08/05/2021,PH599ADOWB,157,"5358"
D10183,1,08/11/2021,PHA3GK55KR,230,"5128"
D10183,1,08/13/2021,PHD7KW1VOJ,319,"4809"
D10183,1,08/20/2021,PHK8TH41AM,297,"4512"
D10183,1,08/25/2021,PHQ92X02VB,324,"4188"
D10183,1,08/28/2021,PHS25YYLK8,300,"3888"
D10183,1,08/30/2021,PHU58W8BPV,500,"3388"
D10183,1,09/04/2021,PI42GTJVAC,100,"3288"
D10183,1,09/06/2021,PI69JN6DAN,100,"3188"
D10183,1,09/06/2021,PI66JNJU00,100,"3088"
D10183,1,09/06/2021,PI66JNNEJS,100,"2988"
D10183,1,09/07/2021,PI71M3BQZ9,100,"2888"
D10183,1,09/07/2021,PI73M3MF29,100,"2788"
D10183,1,09/11/2021,PIB4RBVGGS,100,"2688"
D10183,1,09/11/2021,PIB5RC3KUD,100,"2588"
D10183,1,09/15/2021,PIF6X20CZE,100,"2488"
D10183,1,09/15/2021,PIF3X26XJF,100,"2388"
D10183,1,09/24/2021,PIO3CJ6VZP,100,"2288"
D10183,1,10/08/2021,PJ82YDKDH0,1000,"1288"
D10183,1,10/08/2021,PJ84YGO0VE,100,"1188"
D10183,1,10/08/2021,PJ81YGRD9R,100,"1088"
D10184,1,08/07/2021,PH71BQXS5D,"1800","3400"
D10184,1,08/13/2021,PHD7KVNBOX,600,"2800"
D10184,1,08/15/2021,PHF5NO88W5,200,"2600"
D10184,1,08/20/2021,PHK3TPLMC9,"2600",0
D10185,1,08/08/2021,PH89DKAX3F,100,"3800"
D10185,1,08/08/2021,PH89DKE5SJ,30,"3770"
D10185,1,08/07/2021,PH72C4TI3Q,100,"3670"
D10185,1,08/07/2021,PH77C4XP99,30,"3640"
D10185,1,08/06/2021,PH62AMR062,100,"3540"
D10185,1,08/06/2021,PH61AN0NMX,30,"3510"
D10185,1,08/05/2021,PH5593R56Z,100,"3410"
D10185,1,08/05/2021,PH5793WN73,30,"3380"
D10185,1,08/04/2021,PH446X7ER2,100,"3280"
D10185,1,08/04/2021,PH426XAQ6Q,30,"3250"
D10185,1,08/09/2021,PH90F0SGFG,100,"3150"
D10185,1,08/09/2021,PH97F0ZCW3,30,"3120"
D10185,1,08/10/2021,PHA0GBC1C8,100,"3020"
D10185,1,08/10/2021,PHA6GCU9TA,20,"3000"
D10185,1,08/11/2021,PHB2I098VQ,100,"2900"
D10185,1,08/11/2021,PHB2I0BRZ6,30,"2870"
D10185,1,08/12/2021,PHC8J8P40M,100,"2770"
D10185,1,08/12/2021,PHC2J9FUZY,30,"2740"
D10185,1,08/13/2021,PHD2KTE8P6,100,"2640"
D10185,1,08/13/2021,PHD4KTHA0I,30,"2610"
D10185,1,08/14/2021,PHE2M6KZH2,100,"2510"
D10185,1,08/14/2021,PHE5M6OMZ1,30,"2480"
D10185,1,08/15/2021,PHF2NM175E,100,"2380"
D10185,1,08/15/2021,PHF7NM436J,100,"2280"
D10185,1,08/15/2021,PHF4NM5W84,60,"2220"
D10185,1,08/18/2021,PHI7QK90O3,100,"2120"
D10185,1,08/18/2021,PHI1QK9QJL,30,"2090"
D10185,1,08/19/2021,PHJ0S07LLS,100,"1990"
D10185,1,08/19/2021,PHJ6S091E4,30,"1960"
D10185,1,08/20/2021,PHK7TEDYBB,100,"1860"
D10185,1,08/20/2021,PHK7TEF2IJ,30,"1830"
D10185,1,08/21/2021,PHL0V1KAEE,100,"1730"
D10185,1,08/21/2021,PHL6V1MHZU,30,"1700"
D10185,1,08/22/2021,PHM4WZSWL6,100,"1600"
D10185,1,08/22/2021,PHM8WZVTBA,100,"1500"
D10185,1,08/22/2021,PHM8WZYVTW,30,"1470"
D10185,1,08/24/2021,PHO9Z2UJ99,100,"1370"
D10185,1,08/24/2021,PHO6Z2WIJU,60,"1310"
D10185,1,08/24/2021,PHO0ZZDOKI,100,"1210"
D10185,1,08/24/2021,PHO2ZZJC24,30,"1180"
D10185,1,08/26/2021,PHQ52XGUSV,100,"1080"
D10185,1,08/26/2021,PHQ42XIOT8,100,980
D10185,1,08/26/2021,PHQ2373TYG,100,880
D10185,1,08/27/2021,PHR35NMX5Z,100,780
D10185,1,08/27/2021,PHR15NT4GT,100,680
D10185,1,08/30/2021,PHU59WDYKH,100,580
D10185,1,08/30/2021,PHU79WJURP,100,480
D10185,1,08/30/2021,PHU89WP7V4,100,380
D10185,1,08/30/2021,PHU29WWOCI,100,280
D10185,1,08/30/2021,PHU69X24JE,100,180
D10185,1,08/30/2021,PHU59X8C7B,100,80
D10185,1,08/30/2021,PHU59XHGCN,80,0
D10185,2,09/01/2021,PI19C56RTZ,100,"3980"
D10185,2,09/01/2021,PI14C5AQP6,100,"3880"
D10185,2,09/01/2021,PI18C6R760,60,"3820"
D10185,2,09/04/2021,PI42HO0XIK,100,"3720"
D10185,2,09/09/2021,PI97O0J9ZZ,100,"3620"
D10185,2,09/09/2021,PI98O0RP52,100,"3520"
D10185,2,09/09/2021,PI90O0ZKJC,100,"3420"
D10185,2,09/09/2021,PI90O14W5Y,100,"3320"
D10185,2,09/10/2021,PIA2QGZ8ZM,400,"2920"
D10185,2,09/20/2021,PIK463QTOQ,100,"2820"
D10185,2,09/22/2021,PIM89MK5JS,100,"2720"
D10185,2,09/22/2021,PIM79MTUYD,100,"2620"
D10185,2,09/22/2021,PIM49N5N5E,100,"2520"
D10185,2,09/23/2021,PIN3AXF4BP,100,"2420"
D10185,2,09/23/2021,PIN5AXK6ID,100,"2320"
D10185,2,09/30/2021,PIU5KQDTPH,500,"1820"
D10185,2,10/01/2021,PJ16MCDKI6,100,"1720"
D10185,2,10/01/2021,PJ12MCQMBY,100,"1620"
D10185,2,10/05/2021,PJ50SOV8BS,1000,620
D10185,2,10/07/2021,PJ78W2D04M,570,50
D10185,2,10/07/2021,PJ72W2ORU2,50,0
D10185,3,10/30/2021,PJU9Y54IQR,100,"3800"
D10185,3,10/30/2021,PJU4Y5C2HO,100,"3700"
D10185,3,10/30/2021,PJU4Y5NW00,100,"3600"
D10185,3,11/02/2021,PK2630E3NI,100,"3500"
D10185,3,11/02/2021,PK2630HRTK,100,"3400"
D10185,3,11/05/2021,PK5882QY9Y,100,"3300"
D10185,3,11/05/2021,PK5282TCNI,100,"3200"
D10185,3,11/07/2021,PK70CJ90Z0,100,"3100"
D10185,3,11/07/2021,PK72CJE6AG,100,"3000"
D10185,3,11/08/2021,PK80E9FG2Y,100,"2900"
D10185,3,11/08/2021,PK88E9JT3O,40,"2860"
D10185,3,11/10/2021,PKA3HGJ4LL,100,"2760"
D10185,3,11/10/2021,PKA7HGP0EF,40,"2720"
D10185,3,11/11/2021,PKB3IWVM5P,100,"2620"
D10185,3,11/11/2021,PKB8IWZWOW,50,"2570"
D10185,3,11/12/2021,PKC0KGMNI6,100,"2470"
D10185,3,11/12/2021,PKC7KGTQXX,50,"2420"
D10185,3,11/14/2021,PKE9NPK1HX,100,"2320"
D10185,3,11/14/2021,PKE8NPQRBG,80,"2240"
D10185,3,11/15/2021,PKF7P5MRJ9,100,"2140"
D10185,3,11/15/2021,PKF1P5VGSV,50,"2090"
D10185,3,11/16/2021,PKG6QR2ZEW,100,"1990"
D10185,3,11/16/2021,PKG9QR7L2B,100,"1890"
D10185,3,11/17/2021,PKH3SDONOV,100,"1790"
D10185,3,11/18/2021,PKI0U1S5OC,100,"1690"
D10185,3,11/18/2021,PKI0U20FWQ,100,"1590"
D10185,3,11/20/2021,PKK9WBOA93,100,"1490"
D10185,3,11/20/2021,PKK3WBQH39,80,"1410"
D10185,3,11/21/2021,PKL6YRDKHA,100,"1310"
D10185,3,11/21/2021,PKL4YRGG38,100,"1210"
D10185,3,11/21/2021,PKL1YRILR9,100,"1110"
D10185,3,11/22/2021,PKM6ZT2T5G,1110,0
D10185,4,11/22/2021,PKM21UTK7K,100,"3800"
D10185,4,11/22/2021,PKM01UXGCS,30,"3770"
D10185,4,11/23/2021,PKN63RS6DY,100,"3670"
D10185,4,11/25/2021,PKP271ZXGK,100,"3570"
D10185,4,11/25/2021,PKP472601I,60,"3510"
D10185,4,11/27/2021,PKR6AHQP26,100,"3410"
D10185,4,11/27/2021,PKR4AHV2AY,70,"3340"
D10185,4,12/01/2021,PL19H44TXH,100,"3240"
D10185,4,12/04/2021,PL46MEZ49W,100,"3140"
D10185,4,12/04/2021,PL43MF3IO1,100,"3040"
D10185,4,12/06/2021,PL66Q0URYO,100,"2940"
D10185,4,12/06/2021,PL63Q0Z3VX,40,"2900"
D10185,4,12/07/2021,PL76RV9SLU,2850,50
D10185,4,12/07/2021,PL78RYLVGO,50,0
D10185,5,12/08/2021,PL85TG3H1T,100,"3980"
D10185,5,12/14/2021,PLE33YEIUJ,200,"3780"
D10185,5,12/23/2021,PLN0KIUSCC,100,"3680"
D10185,5,12/23/2021,PLN4KIYXOA,50,"3630"
D10185,5,12/25/2021,PLP0OFIM60,100,"3530"
D10185,5,12/25/2021,PLP9OFMPVR,100,"3430"
D10185,5,12/27/2021,PLR4QG2WIK,100,"3330"
D10185,5,12/27/2021,PLR6QG51TY,80,"3250"
D10185,5,12/31/2021,PLV5WUWQAF,100,"3150"
D10185,5,12/31/2021,PLV0WUZMNI,100,"3050"
D10185,5,01/02/2022,QA22ZYQBW4,100,"2950"
D10185,5,01/02/2022,QA25ZYT787,100,"2850"
D10185,5,01/06/2022,QA677KCJEP,60,"2790"
D10185,5,01/06/2022,QA638JQ9BZ,100,"2690"
D10185,5,01/09/2022,QA94DE9A5S,100,"2590"
D10185,5,01/09/2022,QA96DED0N8,100,"2490"
D10185,5,01/11/2022,QAB2FXT44W,2490,0
D10185,6,01/12/2022,QAC3HR9F0Z,100,"4640"
D10185,6,01/12/2022,QAC6HRD2IE,50,"4590"
D10185,6,01/13/2022,QAD6JTJCEI,58,"4532"
D10185,6,01/18/2022,QAI1SJJMXF,100,"4432"
D10185,6,01/18/2022,QAI9SJO28X,70,"4362"
D10185,6,01/19/2022,QAJ6U4SCXY,100,"4262"
D10185,6,01/19/2022,QAJ0U4XQDE,30,"4232"
D10185,6,01/20/2022,QAK2VC6DNW,100,"4132"
D10185,6,01/20/2022,QAK1VCAFY9,100,"4032"
D10185,6,01/23/2022,QAN61DHUXM,85,"3947"
D10185,6,01/25/2022,QAP05FH2SS,100,"3847"
D10185,6,01/25/2022,QAP75FL943,30,"3817"
D10185,6,01/31/2022,QAV5FISM2F,85,"3732"
D10185,6,02/02/2022,QB26JBB6SG,100,"3632"
D10185,6,02/02/2022,QB26JBGUY6,26,"3606"
D10185,6,02/05/2022,QB57PGVDM5,100,"3506"
D10185,6,02/05/2022,QB51PGWF9J,100,"3406"
D10185,6,02/06/2022,QB67QYO085,50,"3356"
D10185,6,02/10/2022,QBA9X6O92Z,100,"3256"
D10185,6,02/10/2022,QBA5X6R9C3,100,"3156"
D10185,6,02/22/2022,QBM2K05H8C,100,"3056"
D10185,6,02/22/2022,QBM1K07OXH,100,"2956"
D10185,6,03/07/2022,QC74ACZVRY,100,"2856"
D10185,6,03/07/2022,QC70AD2TI8,45,"2811"
D10185,6,03/10/2022,QCA1G4NXPF,100,"2711"
D10185,6,10/03/2022,QJ395S1M03,100,"2611"
D10186,1,08/11/2021,PHB4H2SLCE,"1625","6275"
D10187,1,09/07/2021,PI60K6VRP6,"2800","3700"
D10188,1,08/17/2021,PHH4PKHES0,100,"5100"
D10188,1,08/17/2021,PHH5PKJN9T,100,"5000"
D10188,1,08/17/2021,PHH2PKMIXY,100,"4900"
D10188,1,08/17/2021,PHH8PKOIQU,100,"4800"
D10188,1,08/17/2021,PHH4PKRGTC,100,"4700"
D10188,1,08/17/2021,PHH7PKTX2D,100,"4600"
D10188,1,08/17/2021,PHH1PKVL0T,100,"4500"
D10188,1,08/17/2021,PHH6PKZ7G8,100,"4400"
D10188,1,08/17/2021,PHH1PL16LR,100,"4300"
D10188,1,08/17/2021,PHH1PL4AWT,100,"4200"
D10188,1,08/17/2021,PHH3PL699X,100,"4100"
D10188,1,08/17/2021,PHH2PL8E3Q,100,"4000"
D10188,1,08/17/2021,PHH4PLB41C,100,"3900"
D10188,1,08/24/2021,PHO6ZHGG48,100,"3800"
D10188,1,08/24/2021,PHO1ZHIPO7,100,"3700"
D10188,1,08/24/2021,PHO0ZHMLS2,100,"3600"
D10188,1,08/24/2021,PHO1ZS1DC7,100,"3500"
D10188,1,08/24/2021,PHO3ZS6CHP,100,"3400"
D10188,1,08/24/2021,PHO5ZSBRGD,100,"3300"
D10188,1,08/24/2021,PHO8ZU4S06,100,"3200"
D10188,1,08/24/2021,PHO7ZUA0YN,100,"3100"
D10188,1,08/24/2021,PHO5ZUDDJ5,100,"3000"
D10188,1,08/24/2021,PHO4ZUHSQI,100,"2900"
D10188,1,08/24/2021,PHO0ZUMRJC,100,"2800"
D10188,1,08/24/2021,PHO6ZUQTD8,100,"2700"
D10188,1,08/24/2021,PHO5ZVDMOP,100,"2600"
D10188,1,08/31/2021,PHV6AVRHXI,"1300","1300"
D10188,1,09/07/2021,PI78LMY5HO,100,"1200"
D10188,1,09/07/2021,PI79LN0FUP,100,"1100"
D10188,1,09/07/2021,PI76LN4CU6,100,"1000"
D10188,1,09/07/2021,PI73LN8YC5,100,900
D10188,1,09/07/2021,PI76LNB5WO,100,800
D10188,1,09/07/2021,PI75LNDDMN,100,700
D10188,1,09/07/2021,PI77LNKBHF,100,600
D10188,1,09/07/2021,PI77LNMOXJ,100,500
D10188,1,09/07/2021,PI75LNTFFR,100,400
D10188,1,09/07/2021,PI77LPZ641,100,300
D10188,1,09/07/2021,PI79LQ1VKF,100,200
D10188,1,09/07/2021,PI76LQ4KZK,100,100
D10188,1,09/07/2021,PI71LQA4XH,100,0
D10188,2,09/16/2021,PIG8YR3OOG,100,"5100"
D10188,2,09/16/2021,PIG6YS1LCU,100,"5000"
D10188,2,09/16/2021,PIG5YS3NDT,100,"4900"
D10188,2,09/16/2021,PIG9YS6X0D,100,"4800"
D10188,2,09/16/2021,PIG2YS9SRQ,100,"4700"
D10188,2,09/16/2021,PIG3YSDC0V,100,"4600"
D10188,2,09/16/2021,PIG8YT3J0I,100,"4500"
D10188,2,09/16/2021,PIG3YT6GTJ,100,"4400"
D10188,2,09/16/2021,PIG9YTAWV3,100,"4300"
D10188,2,09/16/2021,PIG2YTCVJM,100,"4200"
D10188,2,09/16/2021,PIG4YTGCZ8,100,"4100"
D10188,2,09/16/2021,PIG7YUBMMD,100,"4000"
D10188,2,09/16/2021,PIG6YUEEXG,100,"3900"
D10188,2,09/25/2021,PIP6DEUYB4,100,"3800"
D10188,2,09/25/2021,PIP5DEXXWP,100,"3700"
D10188,2,09/25/2021,PIP6DF0F80,100,"3600"
D10188,2,09/25/2021,PIP9DF2ZZT,100,"3500"
D10188,2,09/25/2021,PIP6DF5S3C,100,"3400"
D10188,2,09/25/2021,PIP6DFAZBM,100,"3300"
D10188,2,09/25/2021,PIP8DFDN6S,100,"3200"
D10188,2,09/25/2021,PIP0DFHA1Y,100,"3100"
D10188,2,09/25/2021,PIP1DFJQ1H,100,"3000"
D10188,2,09/25/2021,PIP0DFO3CI,100,"2900"
D10188,2,09/25/2021,PIP0DFQTSY,100,"2800"
D10188,2,09/25/2021,PIP9DFTXSV,100,"2700"
D10188,2,09/25/2021,PIP1DFWM27,100,"2600"
D10188,2,10/06/2021,PJ66UJPLEM,100,"2500"
D10188,2,10/06/2021,PJ60UJRUQ8,100,"2400"
D10188,2,10/06/2021,PJ65UJV1V3,100,"2300"
D10188,2,10/06/2021,PJ66UJXS6K,100,"2200"
D10188,2,10/06/2021,PJ61UK18GV,100,"2100"
D10188,2,10/06/2021,PJ65UK4TGV,100,"2000"
D10188,2,10/06/2021,PJ65UK6Y19,100,"1900"
D10188,2,10/06/2021,PJ62UKW44M,100,"1800"
D10188,2,10/06/2021,PJ66UKZ6OQ,100,"1700"
D10188,2,10/06/2021,PJ66UL2DP0,100,"1600"
D10188,2,10/06/2021,PJ68UL5CBO,100,"1500"
D10188,2,10/06/2021,PJ66UL7O6I,100,"1400"
D10188,2,10/06/2021,PJ62ULAMXG,100,"1300"
D10188,2,10/06/2021,PJ60ULDLPK,100,"1200"
D10188,2,10/06/2021,PJ61ULFOJH,100,"1100"
D10188,2,10/06/2021,PJ62ULJX72,100,"1000"
D10188,2,10/06/2021,PJ63ULN2C5,100,900
D10188,2,10/06/2021,PJ63ULPYPN,100,800
D10188,2,10/07/2021,PJ73VWXMVJ,100,700
D10188,2,10/07/2021,PJ76VX03NG,100,600
D10188,2,10/07/2021,PJ72VX3YKG,100,500
D10188,2,10/07/2021,PJ70VXEX9K,100,400
D10188,2,10/07/2021,PJ72VXIIDY,100,300
D10188,2,10/07/2021,PJ73VXKSAV,100,200
D10188,2,10/07/2021,PJ75VXMQ6H,100,100
D10188,2,10/07/2021,PJ75VXRJ37,100,0
D10189,1,08/18/2021,PHI2RN55IO,"1625","4875"
D10189,1,08/27/2021,PHR64VA1I2,"1625","3250"
D10189,1,09/02/2021,PI28DOL6DG,"1625","1625"
D10189,1,09/07/2021,PI79L9WHO1,"1625",0
D10189,2,09/26/2021,PIQ5FP7E5T,"3000","3500"
D10189,2,10/04/2021,PJ46SIEXH6,"2000","1500"
D10189,2,10/05/2021,PJ51T6YMHD,"1500",0
D10189,3,11/01/2021,PK162VWFWE,"4300","2200"
D10189,3,11/02/2021,PK213EFWQL,"2200",0
D10189,4,11/30/2021,PL16FOQTNY,"3300","4000"
D10190,1,08/18/2021,PHI8RW3WB8,"1625","4525"
D10190,1,08/25/2021,PHP42T6QRO,185,"4340"
D10190,1,08/25/2021,PHP42TFS7S,980,"3360"
D10190,1,08/26/2021,PHQ82YZXJA,460,"2900"
D10190,1,09/01/2021,PI19DA3O6X,2900,0
D10190,2,09/10/2021,PIA3PE5NAV,"1150","5150"
D10190,2,09/16/2021,PIG9ZTR93V,"1625","3525"
D10190,2,09/27/2021,PIR2FXUF8Q,475,"3050"
D10190,2,09/27/2021,PIR6G055O6,2890,160
D10190,2,09/27/2021,PIR3G496DZ,160,0
D10190,3,10/17/2021,PJH4E0I7VE,"1450","5050"
D10190,3,10/24/2021,PJO5O4XQX5,"5000",50
D10190,3,10/25/2021,PJP1PJ73BV,50,0
D10191,1,08/19/2021,PHJ7SQ77NL,"6500","15900"
D10191,1,08/20/2021,PHK0TTDZQI,"15900",0
D10191,2,08/29/2021,PHT48R05CM,"6500","15900"
D10191,2,09/01/2021,PI18C0YEXK,"15900",0
D10191,3,09/10/2021,PIA0Q44DLM,"6500","16100"
D10191,3,09/13/2021,PID8UI92JK,"16100",0
D10191,4,09/22/2021,PIM69S70TS,"6500","16100"
D10191,4,09/27/2021,PIR8GIOORY,"16100",0
D10191,5,10/04/2021,PJ44SJEYVS,"6500","15900"
D10191,5,10/07/2021,PJ78WJBVCS,"15900",0
D10191,6,10/14/2021,PJE59DEER3,"6500","15900"
D10191,6,10/16/2021,PJG5BOE36R,"15900",0
D10191,7,10/28/2021,PJS2UDROKS,"1500","24500"
D10191,7,11/01/2021,PK1222OWVG,"1000","23500"
D10191,7,11/03/2021,PK314Z0Z3J,"1000","22500"
D10191,7,11/12/2021,PKC0JOM4JM,22500,0
D10192,1,08/21/2021,PHL7V3EJX7,"1625","4525"
D10192,1,08/27/2021,PHR95JRRS3,"1625","2900"
D10192,1,09/01/2021,PI16CDAOOS,"2900",0
D10192,2,09/24/2021,PIO6C5V1KC,"6200",50
D10192,2,09/24/2021,PIO5CGCS57,50,0
D10193,1,08/15/2021,PHF8NM7YZW,600,"9480"
D10193,1,08/17/2021,PHH6Q1XTKW,300,"9180"
D10193,1,08/18/2021,PHI9RFMKR3,5,"9175"
D10193,1,08/18/2021,PHI8ROPPHK,350,"8825"
D10193,1,08/19/2021,PHJ6T9NA28,300,"8525"
D10193,1,08/20/2021,PHK1UEYA8F,300,"8225"
D10193,1,08/21/2021,PHL9VE6FC1,500,"7725"
D10193,1,08/25/2021,PHP228R3X4,1000,"6725"
D10193,1,08/27/2021,PHR1500RSL,1000,"5725"
D10193,1,08/28/2021,PHS661TRX0,600,"5125"
D10193,1,08/30/2021,PHU3A5JW4D,300,"4825"
D10193,1,09/02/2021,PI24E9CK2M,300,"4525"
D10193,1,09/03/2021,PI34G0LPPW,500,"4025"
D10193,1,09/06/2021,PI66JOQKEI,500,"3525"
D10193,1,09/07/2021,PI71LDG2S1,3525,0
D10193,2,09/08/2021,PI88N5S6II,400,"9920"
D10193,2,09/09/2021,PI94P5I3DA,500,"9420"
D10193,2,09/14/2021,PIE8WG879G,"1500","7920"
D10193,2,09/16/2021,PIG2ZOIW8A,300,"7620"
D10193,2,09/20/2021,PIK1647BZX,2000,"5620"
D10193,2,09/24/2021,PIO1BSYV5H,1000,"4620"
D10193,2,10/01/2021,PJ18NKCO9U,400,"4220"
D10193,2,10/04/2021,PJ46RACB4C,3800,420
D10193,2,10/04/2021,PJ49RE3Q1D,420,0
D10193,3,10/12/2021,PJC35PM0R9,"1500","8900"
D10193,3,10/15/2021,PJF89JJYF2,400,"8500"
D10193,3,10/18/2021,PJI9FJVGNZ,"1500","7000"
D10193,3,10/25/2021,PJP6Q7CRMW,500,"6500"
D10193,3,10/29/2021,PJT8WHZA8G,1000,"5500"
D10193,3,11/01/2021,PK1128V48X,5500,0
D10193,4,11/18/2021,PKI9U27YB5,700,"10180"
D10193,4,11/28/2021,PKS5C489EX,"1000","9180"
D10193,4,11/29/2021,PKT7DPU55J,500,"8680"
D10193,4,12/03/2021,PL32JZ29A2,700,"7980"
D10193,4,12/15/2021,PLF55VXZU1,300,"7680"
D10193,4,12/23/2021,PLN5K7KH5B,600,"7080"
D10193,4,12/23/2021,PLN5K8Z16Z,200,"6880"
D10193,4,12/23/2021,PLN2KT5RR4,200,"6680"
D10193,4,12/26/2021,PLQ6PJMJJC,400,"6280"
D10193,4,12/28/2021,PLS0RQD6OO,350,"5930"
D10193,4,12/28/2021,PLS2T5U7UQ,400,"5530"
D10193,4,12/30/2021,PLU4VNVL9O,500,"5030"
D10193,4,01/03/2022,QA302D6INS,400,"4630"
D10193,4,01/04/2022,QA405FYORA,500,"4130"
D10193,4,01/06/2022,QA618LB6RD,200,"3930"
D10194,1,08/18/2021,PHI6RW7BVS,100,"6000"
D10194,1,08/18/2021,PHI3RWAXZ1,17,"5983"
D10194,1,08/18/2021,PHI3RWGOLX,100,"5883"
D10194,1,08/19/2021,PHJ4TBDBBE,100,"5783"
D10194,1,08/19/2021,PHJ4TBEE10,17,"5766"
D10194,1,08/19/2021,PHJ6TBFLQY,10,"5756"
D10194,1,08/20/2021,PHK3UQJSCD,100,"5656"
D10194,1,08/20/2021,PHK9UQL9KX,17,"5639"
D10194,1,08/20/2021,PHK8UQMAEQ,100,"5539"
D10194,1,08/21/2021,PHL8W7WB2O,100,"5439"
D10194,1,08/21/2021,PHL2W7XD7U,17,"5422"
D10194,1,08/21/2021,PHL1W81NON,100,"5322"
D10194,1,08/22/2021,PHM0XJRAC4,100,"5222"
D10194,1,08/22/2021,PHM4XJRH12,17,"5205"
D10194,1,08/22/2021,PHM2XJRZX0,100,"5105"
D10194,1,08/23/2021,PHN5YYI8X3,100,"5005"
D10194,1,08/23/2021,PHN2YYIR5O,17,"4988"
D10194,1,08/23/2021,PHN2YYJ6OA,100,"4888"
D10194,1,08/24/2021,PHO61DO6MU,100,"4788"
D10194,1,08/24/2021,PHO41DOHZO,100,"4688"
D10194,1,08/25/2021,PHP51PHRTL,17,"4671"
D10194,1,08/26/2021,PHQ14B9NC7,100,"4571"
D10194,1,08/26/2021,PHQ54BA703,17,"4554"
D10194,1,08/26/2021,PHQ44BBEOA,100,"4454"
D10194,1,08/27/2021,PHR95T8QJR,100,"4354"
D10194,1,08/27/2021,PHR65TAN1I,17,"4337"
D10194,1,08/27/2021,PHR75TCQ5F,100,"4237"
D10194,1,08/29/2021,PHT88RAGRK,434,"3803"
D10194,1,08/31/2021,PHV9BR26AD,100,"3703"
D10194,1,08/31/2021,PHV2BR2XMW,17,"3686"
D10194,1,08/31/2021,PHV5BR3GZX,100,"3586"
D10194,1,09/01/2021,PI17D9UF6J,100,"3486"
D10194,1,09/01/2021,PI18D9UVVE,17,"3469"
D10194,1,09/01/2021,PI10D9VD36,100,"3369"
D10194,1,09/04/2021,PI46HV6AI4,800,"2569"
D10194,1,09/06/2021,PI68JKBS96,2500,69
D10194,1,09/06/2021,PI61JKJ7QZ,69,0
D10194,2,10/01/2021,PJ14MT4K3G,550,"5750"
D10194,2,10/01/2021,PJ19NQ5Z6T,"5750",0
D10194,3,11/01/2021,PK101OBAJ0,"6800",0
D10195,1,08/18/2021,PHI5RB4HM9,100,"3800"
D10195,1,08/18/2021,PHI8RB8SEU,30,"3770"
D10195,1,08/19/2021,PHJ1SWE3XV,100,"3670"
D10195,1,08/19/2021,PHJ5SWIO3P,30,"3640"
D10195,1,08/20/2021,PHK8UB750U,100,"3540"
D10195,1,08/20/2021,PHK8UBDK04,30,"3510"
D10195,1,08/21/2021,PHL7VLNNYP,100,"3410"
D10195,1,08/21/2021,PHL2VLW7RE,30,"3380"
D10195,1,08/22/2021,PHM2X89VNS,100,"3280"
D10195,1,08/22/2021,PHM2X8F2KO,30,"3250"
D10195,1,08/23/2021,PHN7YU70QP,100,"3150"
D10195,1,08/23/2021,PHN4YUO3R6,30,"3120"
D10195,1,08/24/2021,PHO5ZYH08B,100,"3020"
D10195,1,08/24/2021,PHO1ZYL00B,30,"2990"
D10195,1,08/25/2021,PHP62PHTPS,100,"2890"
D10195,1,08/25/2021,PHP52PLGJR,30,"2860"
D10195,1,08/26/2021,PHQ84968AG,100,"2760"
D10195,1,08/26/2021,PHQ64992N4,30,"2730"
D10195,1,08/27/2021,PHR05QAQM6,100,"2630"
D10195,1,08/27/2021,PHR15QCLV1,30,"2600"
D10195,1,08/28/2021,PHS06XDJ6I,100,"2500"
D10195,1,08/28/2021,PHS06XIRGU,30,"2470"
D10195,1,08/29/2021,PHT08MW7FG,100,"2370"
D10195,1,08/29/2021,PHT48N0KD0,30,"2340"
D10195,1,08/30/2021,PHU0A5L4RS,100,"2240"
D10195,1,08/30/2021,PHU8A5OZOU,30,"2210"
D10195,1,09/01/2021,PI10CPONYW,100,"2110"
D10195,1,09/01/2021,PI19CPUDQ3,30,"2080"
D10195,1,09/02/2021,PI21E4NRS5,100,"1980"
D10195,1,09/02/2021,PI28E4RZR6,30,"1950"
D10195,1,09/03/2021,PI31G1ETGP,100,"1850"
D10195,1,09/03/2021,PI38G1SYN6,30,"1820"
D10195,1,09/04/2021,PI41H1JLGR,100,"1720"
D10195,1,09/04/2021,PI41H1OIGF,30,"1690"
D10195,1,09/05/2021,PI54IUJJ9Y,100,"1590"
D10195,1,09/05/2021,PI58IV2LS8,30,"1560"
D10195,1,09/06/2021,PI63K2IX4L,100,"1460"
D10195,1,09/06/2021,PI62K2O2Y0,30,"1430"
D10195,1,09/07/2021,PI73LT90Z9,100,"1330"
D10195,1,09/07/2021,PI73LTDCKD,30,"1300"
D10195,1,09/08/2021,PI80NPVAVA,100,"1200"
D10195,1,09/08/2021,PI84NPY7AA,30,"1170"
D10195,1,09/09/2021,PI90OSFSK0,100,"1070"
D10195,1,09/09/2021,PI93OSMFLD,30,"1040"
D10195,1,09/10/2021,PIA5QN4FC5,100,940
D10195,1,09/10/2021,PIA7QN6S4F,30,910
D10195,1,09/11/2021,PIB4S5DJL8,100,810
D10195,1,09/12/2021,PIB8S5JX6M,30,780
D10195,1,09/12/2021,PIC7TJLPSP,100,680
D10195,1,09/12/2021,PIC4TJRD7E,30,650
D10195,1,09/13/2021,PID9UVQ3RR,100,550
D10195,1,09/13/2021,PID5UWJCQL,30,520
D10195,1,08/30/2021,PHV9APJTFV,100,420
D10195,1,08/30/2021,PHV3APNU87,30,390
D10195,1,09/14/2021,PIE3W77BPL,100,290
D10195,1,09/14/2021,PIE0W7E372,30,260
D10195,1,09/15/2021,PIF1X6N6N5,30,230
D10195,1,09/15/2021,PIF6X6J2V0,100,130
D10195,1,09/15/2021,PIF0X6AXZS,30,100
D10195,1,09/15/2021,PIF9X65I1B,100,0
D10195,2,09/16/2021,PIG9ZP40MN,100,"3800"
D10195,2,09/16/2021,PIG9ZP7PVV,30,"3770"
D10195,2,09/17/2021,PIH724M3YR,100,"3670"
D10195,2,09/17/2021,PIH224S6NO,30,"3640"
D10195,2,09/18/2021,PII83BG9J0,100,"3540"
D10195,2,09/18/2021,PII83BO2YO,30,"3510"
D10195,2,09/19/2021,PIJ453PNP8,100,"3410"
D10195,2,09/19/2021,PIJ653VJAI,30,"3380"
D10195,2,09/20/2021,PIK36BESMH,100,"3280"
D10195,2,09/20/2021,PIK26BLE78,30,"3250"
D10195,2,09/21/2021,PIL5822R33,100,"3150"
D10195,2,09/21/2021,PIL8828WC6,30,"3120"
D10195,2,09/22/2021,PIM09G9VVE,100,"3020"
D10195,2,09/22/2021,PIM69GF0WE,30,"2990"
D10195,2,09/23/2021,PIN6B3T2RE,100,"2890"
D10195,2,09/23/2021,PIN2B3XN8E,30,"2860"
D10195,2,09/24/2021,PIO8CKCBWG,100,"2760"
D10195,2,09/24/2021,PIO8CKIHIS,30,"2730"
D10195,2,09/25/2921,PIP2E9JZAK,100,"2630"
D10195,2,09/25/2921,PIP1E9NN3T,30,"2600"
D10195,2,09/26/2021,PIQ9FLVEYJ,100,"2500"
D10195,2,09/26/2021,PIQ8FLYR0Q,30,"2470"
D10195,2,09/27/2021,PIR0GV7G0K,100,"2370"
D10195,2,09/27/2021,PIR5GVN0AP,30,"2340"
D10195,2,09/28/2021,PIS8IO8SXW,100,"2240"
D10195,2,09/28/2021,PIS3IOFFGP,30,"2210"
D10195,2,09/29/2021,PIT0K5FAUU,100,"2110"
D10195,2,09/29/2021,PIT2K5LY9S,30,"2080"
D10195,2,09/30/2021,PIU7LHLT59,100,"1980"
D10195,2,09/30/2021,PIU5LHRDRZ,30,"1950"
D10195,2,10/01/2021,PJ10NGRQVW,100,"1850"
D10195,2,10/01/2021,PJ19NHD82B,30,"1820"
D10195,2,10/02/2021,PJ23P7EBQZ,100,"1720"
D10195,2,10/02/2021,PJ26P93WQ6,30,"1690"
D10195,2,10/03/2021,PJ32QTRHM6,100,"1590"
D10195,2,10/03/2021,PJ34QTV3HI,30,"1560"
D10195,2,10/04/2021,PJ49SGAVLD,100,"1460"
D10195,2,10/04/2021,PJ47SGER7P,30,"1430"
D10195,2,10/05/2021,PJ50TX4EXC,100,"1330"
D10195,2,10/05/2021,PJ52TXAHQM,30,"1300"
D10195,2,10/06/2021,PJ63VLGFQ9,100,"1200"
D10195,2,10/06/2021,PJ50TX4EXC_D2,30,"1170"
D10195,2,10/07/2021,PJ77X98E0X,30,"1140"
D10195,2,10/07/2021,PJ72X9HZ9Y,30,"1110"
D10195,2,10/08/2021,PJ87XLCG6T,70,"1040"
D10195,2,10/08/2021,PJ84YY7G2G,100,940
D10195,2,10/08/2021,PJ82YY9W4E,30,910
D10195,2,10/09/2021,PJ961LK81U,100,810
D10195,2,10/09/2021,PJ921LSANO,30,780
D10195,2,10/11/2021,PJB8355LD6,100,680
D10195,2,10/11/2021,PJB7355UNB,30,650
D10195,2,10/11/2021,PJB24HD2OW,100,550
D10195,2,10/11/2021,PJB24HUL3M,30,520
D10195,2,10/13/2021,PJD06H599Y,100,420
D10195,2,10/13/2021,PJD46H8GPW,30,390
D10195,2,10/13/2021,PJD87ON1NU,100,290
D10195,2,10/13/2021,PJD77OSV07,30,260
D10195,2,10/14/2021,PJE4805TW0,100,160
D10195,2,10/14/2021,PJE78097BH,30,130
D10195,2,10/14/2021,PJE58C9N5D,30,100
D10195,2,10/14/2021,PJE48C87AE,100,0
D10195,3,10/15/2021,PJF2AQLR3A,100,"3800"
D10195,3,10/15/2021,PJF6AQRQYS,30,"3770"
D10195,3,10/17/2021,PJH0CPTAF4,100,"3670"
D10195,3,10/17/2021,PJH1CPUU3V,30,"3640"
D10195,3,10/19/2021,PJJ3G17GNF,100,"3540"
D10195,3,10/20/2021,PJK7HTDH1F,30,"3510"
D10195,3,10/20/2021,PJK1IKF0YJ,100,"3410"
D10195,3,10/21/2021,PJL7K12NYR,100,"3310"
D10195,3,10/21/2021,PJL7K16U41,30,"3280"
D10195,3,10/21/2021,PJL6K1M9GI,30,"3250"
D10195,3,10/24/2021,PJO2OMFKSI,30,"3220"
D10195,3,10/24/2021,PJO2OMHFA4,100,"3120"
D10195,3,10/29/2021,PJT9VN4OVB,100,"3020"
D10195,3,10/29/2021,PJT4VN6M3O,30,"2990"
D10195,3,10/29/2021,PJT4VNC1IO,100,"2890"
D10195,3,10/29/2021,PJT5VNE83V,30,"2860"
D10195,3,10/29/2021,PJT0VNFYEI,100,"2760"
D10195,3,10/29/2021,PJT5VNHQNZ,30,"2730"
D10195,3,10/29/2021,PJT7VNJKOP,100,"2630"
D10195,3,10/29/2021,PJT9VNMSQJ,30,"2600"
D10195,3,10/30/2021,PJU3YIQ4U1,100,"2500"
D10195,3,10/30/2021,PJU2YIS7GE,30,"2470"
D10195,3,10/31/2021,PJV813FQEY,100,"2370"
D10195,3,10/31/2021,PJV513J647,30,"2340"
D10195,3,11/02/2021,PK234JUB9F,100,"2240"
D10195,3,11/02/2021,PK204JW6VS,30,"2210"
D10195,3,11/02/2021,PK214JYYB9,100,"2110"
D10195,3,11/02/2021,PK294JZRYP,30,"2080"
D10195,3,11/03/2021,PK39665V1F,100,"1980"
D10195,3,11/03/2021,PK3866B212,30,"1950"
D10195,3,11/05/2021,PK598TH0FP,100,"1850"
D10195,3,11/05/2021,PK588TLF4G,30,"1820"
D10195,3,11/06/2021,PK64BCCGVW,100,"1720"
D10195,3,11/06/2021,PK69BCE4HL,30,"1690"
D10195,3,11/07/2021,PK76CTOO48,100,"1590"
D10195,3,11/07/2021,PK78CTQWP4,30,"1560"
D10195,3,11/09/2021,PK90G00W6G,100,"1460"
D10195,3,11/09/2021,PK96G082RS,30,"1430"
D10195,3,11/09/2021,PK97G0CNT7,100,"1330"
D10195,3,11/09/2021,PK98G0HP28,30,"1300"
D10195,3,11/10/2021,PKA3HH2W7D,100,"1200"
D10195,3,11/11/2021,PKC2JFUNFK,30,"1170"
D10195,3,11/11/2021,PKC3JFXRI1,100,"1070"
D10195,3,11/12/2021,PKC0KAH7Y2,100,970
D10195,3,11/12/2021,PKC2KAMJVA,30,940
D10195,3,11/12/2021,PKC8KATACW,100,840
D10195,3,11/12/2021,PKC2KB6YC4,30,810
D10195,3,11/12/2021,PKC8KBFFAW,100,710
D10195,3,11/12/2021,PKC0KBLKWQ,30,680
D10195,3,11/12/2021,PKC1KBP2ZX,100,580
D10195,3,11/12/2021,PKC7KBTUQV,100,480
D10195,3,11/12/2021,PKC2KBWQLW,100,380
D10195,3,11/12/2021,PKC7KC03AH,100,280
D10195,3,11/12/2021,PKC4KC3XJC,100,180
D10195,3,11/12/2021,PKC3KC6UQ9,100,80
D10195,3,11/12/2021,PKC0KCTQMQ,80,0
D10195,4,11/13/2021,PKD0MCXOKY,100,"4640"
D10195,4,11/13/2021,PKD5MD2TFT,30,"4610"
D10195,4,11/15/2021,PKF4NZBOLA,30,"4580"
D10195,4,11/15/2021,PKF8NZCAXK,100,"4480"
D10195,4,11/15/2021,PKF5PFTNCL,100,"4380"
D10195,4,11/15/2021,PKF0PFX7HS,30,"4350"
D10195,4,11/16/0201,PKG7QZSLPR,100,"4250"
D10195,4,11/16/0201,PKG1QZYEL1,30,"4220"
D10195,4,11/17/2021,PKH1SRFOP7,100,"4120"
D10195,4,11/17/2021,PKH8SRGZHA,30,"4090"
D10195,4,11/18/2021,PKI6UDWVPK,100,"3990"
D10195,4,11/18/2021,PKI1UDZ6JX,30,"3960"
D10195,4,11/20/2021,PKK5W92A8T,100,"3860"
D10195,4,11/23/2021,PKN3298Y91,100,"3760"
D10195,4,11/23/2021,PKN529ET0B,30,"3730"
D10195,4,11/23/2021,PKN829L3XK,30,"3700"
D10195,4,12/03/2021,PL37JULZIJ,100,"3600"
D10195,4,12/03/2021,PL35KFBGSF,100,"3500"
D10195,4,12/03/2021,PL39KJD4V7,100,"3400"
D10195,4,12/05/2021,PL59OERADB,100,"3300"
D10195,4,12/05/2021,PL56OEXMTY,30,"3270"
D10195,4,12/08/2021,PL81TUJXEL,100,"3170"
D10195,4,12/08/2021,PL82TUNP8C,30,"3140"
D10195,4,12/09/2021,PL92U98MB2,100,"3040"
D10195,4,12/09/2021,PL93U9SQQ9,30,"3010"
D10195,4,12/09/2021,PL93UBYBKR,100,"2910"
D10195,4,12/15/2021,PLF37318D1,100,"2810"
D10195,4,12/15/2021,PLF97360NZ,100,"2710"
D10195,4,12/21/2021,PLL7GMDXR1,100,"2610"
D10195,4,12/21/2021,PLL2GMJW4E,50,"2560"
D10195,4,12/26/2021,PLQ5PCH6KZ,100,"2460"
D10195,4,12/26/2021,PLQ5PCM673,100,"2360"
D10195,4,12/26/2021,PLQ2PCTHYU,100,"2260"
D10195,4,12/30/2021,PLU4VZEU90,100,"2160"
D10195,4,12/30/2021,PLU5W08UV9,100,"2060"
D10195,4,01/03/2022,QA352AXP23,100,"1960"
D10195,4,01/03/2022,QA392B0OH5,100,"1860"
D10195,4,01/05/2022,QA5269K1GK,100,"1760"
D10195,4,01/05/2022,QA5169O4Q7,100,"1660"
D10195,4,01/06/2022,QA698OHEU1,150,"1510"
D10195,4,01/10/2022,QAA0EEN1F8,100,"1410"
D10195,4,01/17/2022,QAH5QH8PYF,100,"1310"
D10195,4,01/21/2022,QAL1WVWHBD,100,"1210"
D10195,4,01/21/2022,QAL8WX32E4,50,"1160"
D10195,4,02/03/2022,QB34KGOM3E,100,"1060"
D10195,4,02/03/2022,QB30KGT7D0,100,960
D10195,4,02/08/2022,QB85TF342R,100,860
D10195,4,02/08/2022,QB80TFR4UK,30,830
D10195,4,03/10/2022,QCA2FSAE00,30,800
D10196,1,08/24/2021,PHO418S69W,"1625","4875"
D10196,1,08/31/2021,PHV3BQZP0L,"1625","3250"
D10196,1,09/01/2021,PI14CGPBC8,"3250",0
D10196,2,10/08/2021,PJ84XRG6G6,100,"7800"
D10196,2,10/08/2021,PJ82XRN8XS,100,"7700"
D10196,2,10/18/2021,PJI2ETG742,100,"7600"
D10197,1,08/20/2021,PHK0TVI6AQ,100,"5750"
D10197,1,08/20/2021,PHK0TVKDWK,100,"5650"
D10197,1,08/20/2021,PHK8TVO9KU,17,"5633"
D10197,1,08/21/2021,PHL1W46FAT,100,"5533"
D10197,1,08/21/2021,PHL0W48XI0,100,"5433"
D10197,1,08/21/2021,PHL5W4AW6B,17,"5416"
D10197,1,08/23/2021,PHN3YC5IC7,100,"5316"
D10197,1,08/23/2021,PHN2YCAQI2,17,"5299"
D10197,1,08/31/2021,PHV8AM4E76,5299,0
D10197,2,09/14/2021,PIE1W2NAC7,"1000","6900"
D10197,2,09/29/2021,PIT2JD4196,700,"6200"
D10197,2,10/01/2021,PJ14MQN28S,950,"5250"
D10197,2,10/01/2021,PJ19MZ439B,50,"5200"
D10197,2,10/05/2021,PJ50STHIMQ,100,"5100"
D10197,2,10/05/2021,PJ58TCZKHK,100,"5000"
D10197,2,10/05/2021,PJ58TD246Y,100,"4900"
D10197,2,10/07/2021,PJ74WPTVQ6,100,"4800"
D10197,2,10/07/2021,PJ76WPWMNW,100,"4700"
D10197,2,10/07/2021,PJ72WPZLA4,100,"4600"
D10197,2,10/08/2021,PJ88YEELXW,100,"4500"
D10197,2,10/08/2021,PJ83YFH0KR,100,"4400"
D10197,2,10/15/2021,PJF99USNXB,100,"4300"
D10197,2,10/15/2021,PJF79UUC97,40,"4260"
D10197,2,10/15/2021,PJF19UVT39,100,"4160"
D10197,2,10/15/2021,PJF09VCNXC,70,"4090"
D10197,2,10/15/2021,PJF09Y5M6E,70,"4020"
D10197,2,10/16/2021,PJG8B2B4H8,100,"3920"
D10197,2,10/16/2021,PJG9B6OI5P,480,"3440"
D10197,2,10/19/2021,PJJ3FNOOEN,100,"3340"
D10197,2,10/19/2021,PJJ2FNQ6OI,100,"3240"
D10197,2,10/26/2021,PJQ2R5U6JA,507,"2733"
D10197,2,11/02/2021,PK253NLXAF,300,"2433"
D10197,2,11/08/2021,PK89D76NBT,100,"2333"
D10197,2,11/10/2021,PKA6GOF2P4,100,"2233"
D10197,2,11/10/2021,PKA6GOJJ7Q,100,"2133"
D10197,2,11/19/2021,PKJ3UIVO41,100,"2033"
D10197,2,11/19/2021,PKJ5UKVWG1,100,"1933"
D10197,2,11/19/2021,PKJ1UL5JQP,80,"1853"
D10197,2,01/12/2022,QAC4HQLOR4,100,"1753"
D10197,2,01/12/2022,QAC4HQS1PC,100,"1653"
D10197,2,03/23/2022,QCN95L2Q4L,477,"1176"
D10198,1,09/21/2021,PIL07HOH3W,"12500",0
D10198,2,10/18/2021,PJI7E55M9R,"13000",200
D10198,3,12/02/2021,PL20IKQNA8,"12100",0
D10198,4,01/10/2022,QAA1EI6U0D,"13000",200
D10198,5,01/10/2022,QAA1EI6U0D_D2,200,"15600"
D10198,5,10/18/2021,PJI7E55M9R_D2,200,"15400"
D10198,5,02/22/2022,QBM1JZIXS3,"1000","14400"
D10198,5,02/26/2022,QBQ0R9TYB0,2000,"12400"
D10198,5,03/02/2022,QC20YW2822,2000,"10400"
D10198,5,03/07/2022,QC73AJCFKH,1000,"9400"
D10198,5,03/10/2022,QCA4G01CVE,5000,"4400"
D10198,5,03/11/2022,QCB1I3K23Z,2000,"2400"
D10198,5,03/14/2022,QCE6N6E65C,2400,0
D10199,1,09/22/2021,PIM49L02RA,"6000","20000"
D10199,1,10/07/2021,PJ78VXWHWS,"5000","15000"
D10199,1,10/13/2021,PJD672M096,"15000",0
D10199,2,11/11/2021,PKB6I5LJFS,"2000","24000"
D10199,2,11/13/2021,PKD7L8F5PD,"1000","23000"
D10199,2,11/13/2021,PKD8L8M246,"1300","21700"
D10199,2,11/17/2021,PKH3R5XZ5X,2000,"19700"
D10199,2,11/17/2021,PKH2RR6XD6,2000,"17700"
D10199,2,11/22/2021,PKM71CGQKH,1000,"16700"
D10199,2,11/25/2021,PKP65QPFHI,500,"16200"
D10199,2,11/30/2021,PKU5E4YAOT,500,"15700"
D10199,2,12/02/2021,PL20HST5XS,500,"15200"
D10199,2,12/03/2021,PL34K3P6WS,500,"14700"
D10199,2,12/06/2021,PL63PMJH2N,500,"14200"
D10199,2,12/09/2021,PL93UPJZQN,500,"13700"
D10199,2,12/14/2021,PLE23TPNHK..,500,"13200"
D10199,2,12/20/2021,PLK8E9XPY8,500,"12700"
D10199,2,12/22/2021,PLM2HZD9V2,500,"12200"
D10199,2,12/30/2021,PLU8V3TZAK,500,"11700"
D10199,2,01/05/2022,QA526B2R8S,500,"11200"
D10199,2,01/10/2022,QAA2EV6XHG,500,"10700"
D10199,2,01/14/2022,QAE6LJTVU6,100,"10600"
D10199,2,01/14/2022,QAE4LJWKUW,100,"10500"
D10199,2,01/14/2022,QAE3LJZ5VH,100,"10400"
D10199,2,01/26/2022,QAQ45QX17M,500,"9900"
D10199,2,02/02/2022,QB28IQF7PM,500,"9400"
D10199,2,02/07/2022,QB72SCEWDS,500,"8900"
D10199,2,02/16/2022,QBG59HU79D,500,"8400"
D10199,2,03/03/2022,QC322DKXBS,500,"7900"
D10199,2,03/21/2022,QCL51P3849,500,"7400"
D10199,2,03/28/2022,QCS0FDXWKW,500,"6900"
D10199,2,06/10/2022,QFA8I2O09K,300,"6600"
D10199,2,08/08/2022,QH88UYED98,600,"6000"
D10199,2,08/24/2022,QHO3Q36IF5,400,"5600"
D10199,2,10/29/2022,QJT9UDJ30J,500,"5100"
D10199,2,12/22/2022,QLM6QJB5N2,500,"4600"
D10199,2,07/20/2023,RGK2ZRSHDC,500,"4100"
D10200,1,10/01/2021,PJ19NPPROF,"1625","5175"
D10200,1,10/08/2021,PJ82XMJXTQ,"1625","3550"
D10200,1,10/13/2021,PJD579QNJ1,"1625","1925"
D10200,1,10/21/2021,PJL1IXECZ9,800,"1125"
D10200,1,10/21/2021,PJL4JR18TA,1125,0
D10200,2,11/01/2021,PK151RUBPL,"1625","4875"
D10200,2,11/06/2021,PK62B9OUBC,"1625","3250"
D10200,2,11/19/2021,PKJ3VHQ5BX,"3250",0
D10200,3,12/08/2021,PL83SOJHKZ,"1300","5200"
D10200,3,12/10/2021,PLA0WESLEQ,"1200","4000"
D10200,3,12/14/2021,PLE13YHCY1,"1500","2500"
D10200,3,12/17/2021,PLH79RCJZP,2500,0
D10200,4,01/13/2022,QAD3JVGKUR,"6500",0
D10200,5,02/11/2022,QBB0ZP67IO,"6500",0
D10200,6,03/03/2022,QC321YVEL6,"6500",0
D10200,7,03/04/2022,QC463LJ5JE,"4700",900
D10200,7,03/04/2022,QC473S1T1P,900,0
D10200,8,04/02/2022,QD28OJ9VEG,"6500",300
D10200,8,04/18/2022,QDI9K7WEF1,300,0
D10200,9,06/05/2022,QF578W7MI5,"6500",0
D10200,10,06/30/2022,QFU5N7AK7D,"6250",0
D10200,11,07/28/2022,QGS78APMXJ,"6500",0
D10200,12,08/17/2022,QHH6BXDCW0,"6100",0
D10200,13,09/13/2022,QID8WAD6IE,"6500",0
D10200,14,10/10/2022,QJA5MFAETP,"9030",0
D10200,15,11/10/2022,QKA9ME53VT,"9400",120
D10200,15,11/10/2022,QKA9MO107F,120,0
D10200,16,12/14/2022,QLE64U56EW,800,"10260"
D10200,16,12/19/2022,QLJ9I781FP,500,"9760"
D10200,16,12/23/2022,QLN6T1MRYI,500,"9260"
D10200,16,01/10/2023,RAA441QHM4,500,"8760"
D10200,16,01/16/2023,RAG5I0L5MJ,2000,"6760"
D10200,16,01/18/2023,RAI3MZF7BD,500,"6260"
D10200,16,01/24/2023,RAO73R62LD,500,"5760"
D10200,16,02/03/2023,RB34SBIVO2_D2,490,"5270"
D10200,16,02/15/2023,RBF6OXG3S2,500,"4770"
D10200,16,02/21/2023,RBL8618HTW,500,"4270"
D10200,16,03/07/2023,RC6861FL5A,500,"3770"
D10200,16,06/26/2023,RFQ1ZH71LZ,500,"3270"
D10200,16,06/29/2023,RFT88WYZQS,200,"3070"
D10200,16,06/30/2023,RFU7B73PTH,200,"2870"
D10200,16,07/01/2023,RG17FK4JX1,2400,470
D10200,16,07/03/2023,RG35KHWP8D,470,0
D10201,1,10/3/2021,PJ34PLFNUA,500,"6000"
D10201,1,10/6/2021,PJ60V7AYV2,1125,"4875"
D10201,1,10/13/2021,PJD87ROOCY,500,"4375"
D10201,1,10/17/2021,PJH6DI2Y0E,100,"4275"
D10201,1,10/17/2021,PJH2DIAXKI,400,"3875"
D10201,1,10/26/2021,PJQ8RQRBFW,3875,0
D10201,2,12/7/2021,PL76S1CL4A,500,"6300"
D10201,2,12/19/2021,PLJ7DTP2P3,3000,"3300"
D10201,2,12/24/2021,PLO0LXS4U4,3300,0
D10202,1,10/8/2021,PJ88XO00OM,2000,"7520"
D10202,1,10/19/2021,PJJ1GHG6LF,8400,880
D10203,1,10/5/2021,PJ57U3UCAH,500,"5450"
D10203,1,10/7/2021,PJ88XEJ5KC,500,"4950"
D10203,1,10/14/2021,PJE87VM3LE,1400,"3550"
D10203,1,10/15/2021,PJF29KUC6U,220,"3330"
D10203,1,10/18/2021,PJI3E524ET,700,"2630"
D10203,1,10/19/2021,PJJ7H5CQD9,570,"2060"
D10203,1,10/21/2021,PJL2IUSZ0G,800,"1260"
D10203,1,10/22/2021,PJM7KGO47V,1260,0
D10203,2,10/23/2021,PJN4ND8HBW,1400,"4200"
D10203,2,10/24/2021,PJO2OQKZS4,1000,"3200"
D10203,2,10/25/2021,PJP4QDAOJW,1000,"2200"
D10203,2,10/27/2021,PJR2S6B4LW,2200,0
D10203,2,10/28/2021,PJS2V6WG48,450,"5300"
D10203,2,10/30/2021,PJU9YNB407,600,"4700"
D10203,2,10/31/2021,PJV516837Z,600,"4100"
D10203,3,11/1/2021,PK141FRC3Q,350,"3750"
D10203,3,11/8/2021,PK85EIDOMJ,1000,"2750"
D10203,3,11/9/2021,PK91G460SR,1400,"1350"
D10203,3,11/10/2021,PKA8GEU1R0,1350,0
D10203,4,11/11/2021,PKB7J9A7CP,400,"7580"
D10203,4,11/18/2021,PKH8SQYJFG,1050,"6530"
D10203,4,11/18/2021,PKI1UFJNK9,1000,"5530"
D10203,4,11/19/2021,PKJ8W5W626,1000,"4530"
D10203,4,11/20/2021,PKK0XX2KUM,750,"3780"
D10203,4,11/21/2021,PKL4ZFXUXS,550,"3230"
D10203,4,11/23/2021,PKM4255AZC,700,"2530"
D10203,4,11/23/2021,PKN02E9ZXM,2530,0
D10203,5,11/25/2021,PKP17APP7R,750,"7510"
D10203,5,12/3/2021,PL36L1VJMM,1400,"6110"
D10203,5,12/5/2021,PL54OHJ2YI,700,"5410"
D10203,5,12/6/2021,PL61QCMGEV,800,"4610"
D10203,5,12/8/2021,PL86U1H5AI,1520,"3090"
D10203,5,12/9/2021,PL99VTUXWJ,1600,"1490"
D10203,5,12/10/2021,PLA3W3Y3MT,1490,0
D10203,6,1/3/2022,QA333VLCIN,1400,"8120"
D10203,6,1/4/2022,QA435KWZCJ,700,"7420"
D10203,6,1/7/2022,QA76AMSOJS,700,"6720"
D10203,6,1/8/2022,QA86CBMV1E,700,"6020"
D10203,6,1/9/2022,QA92DW4EHC,750,"5270"
D10203,6,1/10/2022,QAA3EBXZGT,5270,0
D10203,7,1/25/2022,QAP65OC4Z6,900,"7640"
D10203,7,1/29/2022,QAT6CQOOLY,3000,"4640"
D10203,7,1/31/2022,QAV3ECWBMR,1500,"3140"
D10203,7,1/31/2022,QAV8ETF7Y4,1800,"1340"
D10203,7,1/31/2022,QAV1G5QMIJ,1340,0
D10203,8,3/3/2022,QC322VYCU8,500,"9720"
D10203,8,3/8/2022,QC80BNCK90,900,"8820"
D10203,8,3/10/2022,QCA8FEWOQM,550,"8270"
D10203,8,3/10/2022,QCA0HCKJES,550,"7720"
D10203,8,3/24/2022,QCO570BS5T,600,"7120"
D10204,1,10/26/2021,PJQ3RVEDY9,3000,"9350"
D10204,1,11/2/2021,PK214DBDC3,3100,"6250"
D10204,1,11/7/2021,PK72BSEI2Y,3200,"3050"
D10204,1,11/9/2021,PK91F0GZ3H,3050,0
D10204,2,11/24/2021,PKO04UEAHK,3100,"9250"
D10204,2,11/30/2021,PKU8FM2EHI,3100,"6150"
D10204,2,12/7/2021,PL73S0MRRT,6150,0
D10204,3,1/5/2022,QA5978LHX3,12352,2
D10204,4,2/3/2022,QB32LJOGCK,12000,350
D10204,4,2/3/2022,QB31LK4WEP,352,2
D10204,5,3/3/2022,QC3634UVAS,12255,0
D10204,6,4/1/2022,QD14MPN34W,4350,"15370"
D10204,6,4/4/2022,qQD41T3JW21,15370,0
D10204,7,5/6/2022,QE62K3BWOM,19000,720
D10204,7,5/6/2022,QE60K4IZ9E,720,0
D10205,1,10/13/2021,PJD67QJ8BA,100,"7700"
D10205,1,10/13/2021,PJD37QMAZ3,60,"7640"
D10205,1,10/13/2021,PJD77QOV31,100,"7540"
D10205,1,10/14/2021,PJE69CZ2CQ,100,"7440"
D10205,1,10/14/2021,PJE69CZVZ4,60,"7380"
D10205,1,10/14/2021,PJE39D0QUF,100,"7280"
D10205,1,10/15/2021,PJF0AZQORI,100,"7180"
D10205,1,10/15/2021,PJF4AZQQNE,60,"7120"
D10205,1,10/15/2021,PJG1AZQZ4L,100,"7020"
D10205,1,10/16/2021,PJG0CETT10,100,"6920"
D10205,1,10/16/2021,PJG5CEXBAZ,60,"6860"
D10205,1,10/16/2021,PJG3CEYWPL,100,"6760"
D10205,1,10/17/2021,PJH3DE79D7,100,"6660"
D10205,1,10/17/2021,PJH7DE8M05,60,"6600"
D10205,1,10/17/2021,PJH6DEBVUC,100,"6500"
D10205,1,10/18/2021,PJI3FCBRK3,100,"6400"
D10205,1,10/18/2021,PJI7FCDP7P,60,"6340"
D10205,1,10/18/2021,PJI2FCFRLC,100,"6240"
D10205,1,10/19/2021,PJJ8GS22VO,100,"6140"
D10205,1,10/19/2021,PJJ1GS99P9,100,"6040"
D10205,1,10/19/2021,PJJ9GSF659,60,"5980"
D10205,1,10/20/2021,PJK4IM1S3W,100,"5880"
D10205,1,10/20/2021,PJK3IM2PBZ,60,"5820"
D10205,1,10/20/2021,PJK5IM3UST,100,"5720"
D10205,1,10/21/2021,PJL8K67JW4,260,"5460"
D10205,1,10/22/2021,PJM2LKUU3S,100,"5360"
D10205,1,10/22/2021,PJM0LKWJO4,60,"5300"
D10205,1,10/22/2021,PJM4LL2VEK,100,"5200"
D10205,1,10/23/2021,PJN8NDP5A2,260,"4940"
D10205,1,10/24/2021,PJO9OTTEZ3,260,"4680"
D10205,1,10/26/2021,PJQ3QDUWO3,260,"4420"
D10205,1,10/26/2021,PJQ2QDVUXE,260,"4160"
D10205,1,10/27/2021,PJR0T24FSM,260,"3900"
D10205,1,10/28/2021,PJS4UMLJDE,260,"3640"
D10205,1,10/29/2021,PJT1W5J84N,260,"3380"
D10205,1,10/30/2021,PJU0YI8JC4,260,"3120"
D10205,1,10/31/2021,PJV813KBLW,100,"3020"
D10205,1,10/31/2021,PJV213LNY0,60,"2960"
D10205,1,10/31/2021,PJV811X8IW,100,"2860"
D10205,1,11/1/2021,PK112V7ABP,100,"2760"
D10205,1,11/2/2021,PK202WAUJW,160,"2600"
D10205,1,11/2/2021,PK2437F1PI,260,"2340"
D10205,1,11/3/2021,PK375RVENH,100,"2240"
D10205,1,11/3/2021,PK315S18QD,60,"2180"
D10205,1,11/3/2021,PK345S6X34,100,"2080"
D10205,1,11/4/2021,PK467SFGIM,260,"1820"
D10205,1,11/5/2021,PK579JHU2Z,100,"1720"
D10205,1,11/5/2021,PK579JRLPV,100,"1620"
D10205,1,11/5/2021,PK579JU1U3,60,"1560"
D10205,1,11/6/2021,PK65B0NVT1,260,"1300"
D10205,1,11/7/2021,PK73CJU12T,260,"1040"
D10205,1,11/8/2021,PK86EI3TN4,260,780
D10205,1,11/9/2021,PK92FYKTDG,260,520
D10205,1,11/10/2021,PKA7H9BK2N,100,420
D10205,1,11/10/2021,PKA0H9FTIW,100,320
D10205,1,11/10/2021,PKA8H9L0F6,60,260
D10205,1,11/11/2021,PKB4I12NJQ,260,0
D10205,2,11/11/2021,PKB4J4RX0G,260,"7540"
D10205,2,11/12/2021,PKC7KWF49R,260,"7280"
D10205,2,11/13/2021,PKD6MF4TRE,260,"7020"
D10205,2,11/14/2021,PKE3NYT5K7,260,"6760"
D10205,2,11/15/2021,PKF5PHB8EF,260,"6500"
D10205,2,11/17/2021,PKH8R49Q8E,260,"6240"
D10205,2,11/17/2021,PKH6SQBJO8,260,"5980"
D10205,2,11/18/2021,PKI1U6II1X,100,"5880"
D10205,2,11/18/2021,PKI6U6MR38,100,"5780"
D10205,2,11/18/2021,PKI4U6R0KG,60,"5720"
D10205,2,11/19/2021,PKJ9W5A2EL,260,"5460"
D10205,2,11/21/2021,PKL0XXTZLY,260,"5200"
D10205,2,11/21/2021,PKL3ZFN8CF,260,"4940"
D10205,2,11/22/2021,PKM024IP6U,260,"4680"
D10205,2,11/23/2021,PKN83XCFI2,260,"4420"
D10205,2,11/25/2021,PKP15NIYQF,260,"4160"
D10205,2,11/25/2021,PKP07BAKFW,260,"3900"
D10205,2,11/26/2021,PKQ18Z5IL9,260,"3640"
D10205,2,11/27/2021,PKR2AR9QEG,260,"3380"
D10205,2,11/28/2021,PKS6CARS18,260,"3120"
D10205,2,11/29/2021,PKT3DYY6L5,260,"2860"
D10205,2,11/30/2021,PKU7FOJI5B,260,"2600"
D10205,2,12/1/2021,PL15HI49RF,260,"2340"
D10205,2,12/3/2021,PL36J9SGUE,260,"2080"
D10205,2,12/3/2021,PL39L2LF0Z,260,"1820"
D10205,2,12/5/2021,PL58MXV0ZC,260,"1560"
D10205,2,12/6/2021,PL66OKRE6U,260,"1300"
D10205,2,12/7/2021,PL75QDH5KJ,260,"1040"
D10205,2,12/8/2021,PL85S7U3GB,260,780
D10205,2,12/9/2021,PL96U2G6U2,260,520
D10205,2,12/9/2021,PL95VRLXKD,260,260
D10205,2,12/10/2021,PLA5W4FKJ5,260,0
D10205,3,12/10/2021,PLA5XMHXSH,304,"8796"
D10205,3,12/12/2021,PLC423B81Y,304,"8492"
D10205,3,12/12/2021,PLC6ZHHO76,304,"8188"
D10205,3,12/13/2021,PLD43QGH8E,304,"7884"
D10205,3,12/14/2021,PLE35GCHJT,304,"7580"
D10205,3,12/15/2021,PLF477B5TA,304,"7276"
D10205,3,12/17/2021,PLH98YLQZF,100,"7176"
D10205,3,12/17/2021,PLH68YM2LE,100,"7076"
D10205,3,12/17/2021,PLH88YMCT8,100,"6976"
D10205,3,12/17/2021,PLH98YTMER,4,"6972"
D10205,3,12/17/2021,PLH5AQ6UIF,304,"6668"
D10205,3,12/18/2021,PLI0CI04EM,304,"6364"
D10205,3,12/20/2021,PLK3E24ZET,304,"6060"
D10205,3,12/20/2021,PLK0FMV03O,304,"5756"
D10205,3,12/21/2021,PLL3HEXV5D,304,"5452"
D10205,3,12/22/2021,PLM4J4WLOO,304,"5148"
D10205,3,12/23/2021,PLN7L1QMGB,304,"4844"
D10205,3,12/25/2021,PLP6N7IEQ8,304,"4540"
D10205,3,12/25/2021,PLP7OTAHUR,100,"4440"
D10205,3,12/25/2021,PLP8OTAYD8,100,"4340"
D10205,3,12/25/2021,PLP7OTBH1Z,100,"4240"
D10205,3,12/25/2021,PLP1OTGUIT,4,"4236"
D10205,3,12/26/2021,PLQ0Q7KF3E,304,"3932"
D10205,3,12/27/2021,PLR7RP0IIJ,304,"3628"
D10205,3,12/28/2021,PLS2T7ZX8K,304,"3324"
D10205,3,12/29/2021,PLT0URYR9S,304,"3020"
D10205,3,12/30/2021,PLU1WDIKET,304,"2716"
D10205,3,1/1/2022,QA13Y9KNDJ,304,"2412"
D10205,3,1/1/2022,QA17ZQMPO5,304,"2108"
D10205,3,1/2/2021,QA28278Q8C,304,"1804"
D10205,3,1/3/2022,QA303VE5DY,304,"1500"
D10205,3,1/4/2022,QA495KDLG9,304,"1196"
D10205,3,1/6/2022,QA637AQ63V,304,892
D10205,3,1/6/2022,QA698YBF9R,304,588
D10205,3,1/7/2022,QA739S7RJX,588,0
D10205,4,1/7/2022,QA75AKF979,304,"8796"
D10205,4,1/8/2022,QA88CBVPEA,304,"8492"
D10205,4,1/9/2022,QA94DW7TWQ,304,"8188"
D10205,4,1/10/2022,QAA3FLG6FZ,304,"7884"
D10205,4,1/19/2022,QAJ9UJZ08H,2275,"5609"
D10205,4,1/24/2022,QAO92MW07B,1100,"4509"
D10205,4,1/29/2022,QAT9CDFLJJ,2275,"2234"
D10205,4,2/5/2022,QB58OGB4J4,2234,0
D10205,5,2/27/2022,QBR9UC0DO5,4550,"4970"
D10205,5,3/3/2022,QC333DLZZL,2275,"2695"
D10205,5,3/7/2022,QC779YH0A7,2275,420
D10205,5,3/7/2022,QC79ALEEU5,420,0
D10205,6,3/24/2022,QCO585GV9L,2275,"6750"
D10205,6,3/25/2022,QCP09DEEFU,1700,"5050"
D10205,6,3/28/2022,QCS9F0N245,2775,"2275"
D10205,6,4/1/2022,QD11N0W5UL,2275,0
D10206,1,10/14/2021,PJE49DP9GM,300,"5950"
D10206,1,10/15/2021,PJF8AZFP4Y,1000,"4950"
D10206,1,10/19/2021,PJJ1GRZ2YR,100,"4850"
D10206,1,10/19/2021,PJJ3GTXRDF,100,"4750"
D10206,1,10/19/2021,PJJ4GS6OOQ,100,"4650"
D10206,1,10/21/2021,PJL5K7RFPL,100,"4550"
D10206,1,10/21/2021,PJL2K7ST8U,36,"4514"
D10206,1,10/22/2021,PJM9LGZ74V,100,"4414"
D10206,1,10/22/2021,PJM6LH32G2,50,"4364"
D10206,1,10/22/2021,PJM0LH5LXI,100,"4264"
D10206,1,10/23/2021,PJN9NDYRHZ,100,"4164"
D10206,1,10/23/2021,PJN2NE99O8,100,"4064"
D10206,1,10/24/2021,PJO4OU3UFC,100,"3964"
D10206,1,10/24/2021,PJO2OU66JM,100,"3864"
D10206,1,10/25/2021,PJP1OU9OOP,50,"3814"
D10206,1,10/27/2021,PJR9S362AZ,500,"3314"
D10206,1,10/28/2021,PJS2UKFSN6,102,"3212"
D10206,1,10/30/2021,PJU9WWS5NT,100,"3112"
D10206,1,10/30/2021,PJU8WWT7BW,17,"3095"
D10206,1,11/1/2021,PK192B4NLN,800,"2295"
D10206,1,11/4/2021,PK416FOP5B,500,"1795"
D10206,1,11/5/2021,PK578ESQN3,100,"1695"
D10206,1,11/5/2021,PK568F1H6O,19,"1676"
D10206,1,11/5/2021,PK548F4BPG,100,"1576"
D10206,1,11/5/2021,PK528F8GAA,100,"1476"
D10206,1,11/6/2021,PK60A4JGX8,1476,0
D10206,2,11/8/2021,PK87CWIALJ,100,"6150"
D10206,2,11/8/2021,PK85CWIQNT,17,"6133"
D10206,2,11/8/2021,PK80CWJ2W8,100,"6033"
D10206,2,11/9/2021,PK90EJDLA8,100,"5933"
D10206,2,11/9/2021,PK94EJDOEU,17,"5916"
D10206,2,11/9/2021,PK98EJDRQ4,100,"5816"
D10206,2,11/11/2021,PKB0HT9BQI,434,"5382"
D10206,2,11/12/2021,PKD7KWH3TV,440,"4942"
D10206,2,11/15/2021,PKF2PJLW0K,100,"4842"
D10206,2,11/15/2021,PKF5PJOLB5,100,"4742"
D10206,2,11/16/2021,PKG1PPWKN1,77,"4665"
D10206,2,11/16/2021,PKG7R45619,100,"4565"
D10206,2,11/16/2021,PKG5R45P4F,50,"4515"
D10206,2,11/16/2021,PKG4R467HI,100,"4415"
D10206,2,11/17/2021,PKH6SRNTLI,100,"4315"
D10206,2,11/17/2021,PKH1SRNOP9,50,"4265"
D10206,2,11/17/2021,PKH3SROFBX,100,"4165"
D10206,2,11/20/2021,PKK1WQB36X,400,"3765"
D10206,2,11/23/2021,PKN425TQ1G,500,"3265"
D10206,2,11/23/2021,PKN73X6BSV,100,"3165"
D10206,2,11/23/2021,PKN73XAGVT,100,"3065"
D10206,2,11/23/2021,PKN03XCRVO,100,"2965"
D10206,2,11/25/2021,PKP25TTRUM,500,"2465"
D10206,2,11/26/2021,PKQ47BRY14,100,"2365"
D10206,2,11/26/2021,PKQ57BS2HZ,100,"2265"
D10206,2,11/29/2021,PKT8CZYMO6,1000,"1265"
D10206,2,11/29/2021,PKT9D02EOL,6,"1259"
D10206,2,11/30/2021,PKU9EBV9K9,1259,0
D10207,1,10/20/2021,PJK1IO4M5X,2275,"6825"
D10207,1,10/27/2021,PJR2RZWT7M,100,"6725"
D10207,1,10/27/2021,PJR3RZWZJP,100,"6625"
D10207,1,10/27/2021,PJR7RZX6U1,100,"6525"
D10207,1,10/27/2021,PJR7RZXO5X,100,"6425"
D10207,1,10/28/2021,PJS7V501VT,900,"5525"
D10207,1,11/1/2021,PK192V5W0T,100,"5425"
D10207,1,11/1/2021,PK102V6UBK,100,"5325"
D10207,1,11/1/2021,PK112VCX0N,100,"5225"
D10207,1,11/2/2021,PK202WOTZ8,100,"5125"
D10207,1,11/2/2021,PK232WP80L,100,"5025"
D10207,1,11/2/2021,PK252WPJG1,100,"4925"
D10207,1,11/2/2021,PK234K7QAV,100,"4825"
D10207,1,11/2/2021,PK234K8J6B,100,"4725"
D10207,1,11/3/2021,PK3268FBK2,1000,"3725"
D10207,1,11/8/2021,PK81CZ5DRJ,900,"2825"
D10207,1,11/9/2021,PK96G1JYLU,100,"2725"
D10207,1,11/9/2021,PK90G1OG9Y,100,"2625"
D10207,1,11/9/2021,PK91G1RK0R,100,"2525"
D10207,1,11/9/2021,PK94G1VAFQ,100,"2425"
D10207,1,11/10/2021,PKA4GTIHQ8,2425,0
D10207,2,11/17/2021,PKH4SRMG5G,1000,"8470"
D10207,2,11/18/2021,PKI1UG35DT,100,"8370"
D10207,2,11/18/2021,PKI2UG3JEA,100,"8270"
D10207,2,11/19/2021,PKJ6UG5RBM,100,"8170"
D10207,2,11/19/2021,PKJ3W63WKF,100,"8070"
D10207,2,11/19/2021,PKJ6W655X0,100,"7970"
D10207,2,11/19/2021,PKJ6W67X30,100,"7870"
D10207,2,11/19/2021,PKJ6W6GITA,100,"7770"
D10207,2,11/19/2021,PKJ6W6HKTC,100,"7670"
D10207,2,11/20/2021,PKK9X0JJYT,100,"7570"
D10207,2,11/20/2021,PKK8X0LWW0,100,"7470"
D10207,2,11/20/2021,PKK1X0Q6ZB,100,"7370"
D10207,2,11/23/2021,PKN62N1JUG,100,"7270"
D10207,2,11/23/2021,PKN22N3ODW,75,"7195"
D10207,2,11/24/2021,PKO45NDT2M,800,"6395"
D10207,2,11/28/2021,PKS9CAXB03,100,"6295"
D10207,2,11/28/2021,PKS7CAY8N5,100,"6195"
D10207,2,11/29/2021,PKT4DZ3PCQ,100,"6095"
D10207,2,11/29/2021,PKT2DZ3PTM,100,"5995"
D10207,2,11/29/2021,PKT5DZ4LUH,100,"5895"
D10207,2,12/1/2021,PL12GGNI6I,900,"4995"
D10207,2,12/8/2021,PL87T3N2N7,1450,"3545"
D10207,2,12/9/2021,PL99U3VZ4V,800,"2745"
D10207,2,12/9/2021,PL92UEPUYY,2325,420
D10207,2,12/9/2021,PL94UG0XGO,420,0
D10207,3,12/21/2021,PLL2GUVS7K,770,"7990"
D10207,3,12/28/2021,PLS7T8IIOF,900,"7090"
D10207,3,1/13/2022,QAD0JDNGUO,100,"6990"
D10207,3,1/13/2022,QAD0JDPRFQ,50,"6940"
D10207,3,1/13/2022,QAD9JDS9IR,100,"6840"
D10207,3,1/17/2022,QAH6PPMTR8,2000,"4840"
D10207,3,1/19/2022,QAJ7SWJF0D,100,"4740"
D10207,3,1/19/2022,QAJ8SWJLKS,100,"4640"
D10207,3,1/21/2022,QAL2WRIYYM,400,"4240"
D10207,3,1/29/2022,QAT1AXR0AL,400,"3840"
D10207,3,1/31/2022,QAV5EDCW6D,100,"3740"
D10207,3,1/31/2022,QAV4EF0H3K,100,"3640"
D10207,3,1/31/2022,QAV2EF7KF6,100,"3540"
D10207,3,2/2/2022,QB26I4I1S2,100,"3440"
D10207,3,2/2/2022,QB29I4KVUB,100,"3340"
D10207,3,2/22/2022,QBM2KCCZW6,100,"3240"
D10208,1,10/26/2021,PJQ3R2YLMR,3250,"9750"
D10208,1,11/2/2021,PK233SRALJ,3250,"6500"
D10208,1,11/9/2021,PK94F9W3I2,3250,"3250"
D10208,1,11/16/2021,PKG7QI6WJV,3250,0
D10208,2,11/27/2021,PKR99YCW5H,3250,"9750"
D10208,2,12/4/2021,PL43LZ13PN,3250,"6500"
D10208,2,12/11/2021,PLB4YND5D6,3250,"3250"
D10208,2,12/18/2021,PLI8BF3BHQ,3250,0
D10208,3,12/27/2021,PLR0QVFXDW,3250,"9750"
D10208,3,1/3/2022,QA302Q584U,3250,"6500"
D10208,3,1/10/2022,QAA2F5377K,3250,"3250"
D10208,3,1/17/2022,QAH3QGYPM5,3250,0
D10208,4,7/7/2022,QG711Q7QOR,3250,"9750"
D10208,4,7/14/2022,QGE8GH988U,3250,"6500"
D10208,4,7/21/2022,QGL9TYCPG3,3250,"3250"
D10208,4,7/28/2022,QGS98CWKW5,3250,0
D10208,5,8/4/2022,QH46MYME5Y,3250,"9750"
D10208,5,8/11/2022,QHB21IUM6K,3250,"6500"
D10208,5,8/18/2022,QHI2F28I0Y,3250,"3250"
D10208,5,8/25/2022,QHP9RMR4QN,3250,0
D10208,6,8/31/2022,QHV24JLF4E,3250,"9750"
D10208,6,9/7/2022,QI74J8480K,3200,"6550"
D10208,6,9/14/2022,QIE3YTNSP9,3250,"3300"
D10208,6,9/21/2022,QIL0F2T8CO,3250,50
D10208,6,9/22/2022,QIM5FK16D5,50,0
D10208,7,9/30/2022,QIU3Y19CNJ,3250,"9750"
D10208,7,10/5/2022,QJ60E9Q4VG,3250,"6500"
D10208,7,10/13/2022,QJD0U4MDVU,3250,"3250"
D10208,7,10/21/2022,QJL0C422QE,3250,0
D10208,8,10/29/2022,QJT8UWVU32,3250,"9350"
D10208,8,11/5/2022,QK50CFL1I8,3250,"6100"
D10208,8,11/12/2022,QKC7SRWE8D,3250,"2850"
D10208,8,11/15/2022,QKF4YE6NZ2,2850,0
D10208,9,11/22/2022,QKM5GONE7B,3250,"9250"
D10208,9,11/29/2022,QKT0WWNAJE,3250,"6000"
D10208,9,12/6/2022,QL69JNS9ZZ,3250,"2750"
D10208,9,12/8/2022,QL86NZQNQI,2750,0
D10208,10,12/15/2022,QLF09XBOEY,3250,"9650"
D10208,10,12/22/2022,QLM1QCWN2L,3250,"6400"
D10208,10,12/29/2022,QLT6AAXDHS,3250,"3150"
D10208,10,1/4/2023,QKM5GONE7B_D2,3150,0
D10208,11,1/11/2023,RAB671VVB0,3250,"9450"
D10208,11,1/18/2023,RAI6O2GBXA,3250,"6200"
D10208,11,1/25/2023,RAP85FCLPK,3250,"2950"
D10208,11,1/30/2023,RAU9I6IQW9,2950,0
D10208,12,2/6/2023,RB6630G7S2_D2,3250,"9250"
D10208,12,2/13/2023,RBD1KVWOWR,3250,"6000"
D10208,12,2/20/2023,RBK24C0KQA,3250,"2750"
D10208,12,2/22/2023,RBM98RM18N,2750,0
D10208,13,3/2/2023,RC21UDIFWD,3250,"9650"
D10208,13,3/9/2023,RC92EQW27G,3250,"6400"
D10208,13,3/16/2023,RCG1XQUB3X,3250,"3150"
D10208,13,3/22/2023,RCM2DV12C8,3150,0
D10208,14,4/1/2023,RD156BU4V3,3250,"9750"
D10208,14,4/8/2023,RD83OFX1YL,3250,"6500"
D10208,14,4/15/2023,RDF29GBV9G,3250,"3250"
D10208,14,4/22/2023,RDM6SIGOS2,3250,0
D10209,1,10/28/2021,PJS0UOFNU8,1000,"5500"
D10209,1,11/1/2021,PK141DDP3E,400,"5100"
D10209,1,11/2/2021,PK224A38DO,500,"4600"
D10209,1,11/4/2021,PK558158Q7,200,"4400"
D10209,1,11/8/2021,PK81D34A1P,800,"3600"
D10209,1,11/12/2021,PKC7JGJNMD,1150,"2450"
D10209,1,11/18/2021,PKI5T84SZV,2450,0
D10209,2,12/8/2021,PL81SR22PR,750,"5730"
D10209,2,12/11/2021,PLB9XW7WM3,400,"5330"
D10209,2,12/14/2021,PLE13TM2R3,5330,0
D10209,3,12/30/2021,PLU3V3I79Z,550,"5950"
D10209,3,1/6/2022,QA607WJA70,450,"5500"
D10209,3,1/8/2022,QA81AU675X,400,"5100"
D10209,3,1/10/2022,QAA4EAZA2S,4600,500
D10209,3,1/11/2022,QAB1GGZM1B,350,150
D10209,3,1/11/2022,QAB6GIFSAE,150,0
D10209,4,2/5/2022,QB52OOFTMI,700,"7200"
D10209,4,2/7/2022,QB70RD1ISS,800,"6400"
D10209,4,2/14/2022,QBE26JF3JA,300,"6100"
D10209,4,2/15/2022,QBF58D3C7H,250,"5850"
D10209,4,2/18/2022,QBI7DW5OHL,400,"5450"
D10209,4,2/21/2022,QBL1JEP7IX,500,"4950"
D10209,4,2/22/2022,QBM7KC381N,400,"4550"
D10209,4,2/25/2022,QBP0P0TBFA,300,"4250"
D10209,4,2/28/2022,QBS7VXH6B9,300,"3950"
D10209,4,3/8/2022,QC81D07U4H,100,"3850"
D10210,1,10/28/2021,PJS2V433EC,4480,0
D10210,2,11/25/2021,PKP171EKPT,1300,"4140"
D10210,2,11/18/2021,PKI6U5UCMW,1300,"2840"
D10210,2,12/3/2021,PL33KPAPPN,1300,"1540"
D10210,2,12/11/2021,PLB9YGQR3X,680,860
D10210,2,12/13/2021,PLD52UXCZ3,500,360
D10210,2,12/17/2021,PLH89C8FY0,360,0
D10210,3,12/12/2022,QLC6ZJYD50,600,"4600"
D10210,3,12/12/2022,QLC7ZKC33J,700,"3900"
D10210,3,19/12/2022,QLJ9K6G7OV,1300,"2600"
D10210,3,26/12/2022,QLQ93QDR7N,1300,"1300"
D10210,3,1/3/2023,RA32KTKF1W,1300,0
D10210,4,1/16/2023,RAG5JD3V7H,3000,"1480"
D10210,4,1/18/2023,RAI5OGKMCV,1480,0
D10210,5,1/26/2023,RAQ09TE3C8,1300,"3380"
D10210,5,2/2/2023,RB24QJARU2_D2,3380,0
D10210,6,2/10/2023,RBA3BIACN9_D2,1300,"4140"
D10210,6,2/17/2023,RBH9TPN791,1300,"2840"
D10210,6,2/24/2023,RB05D7CBI9,1300,"1540"
D10210,6,3/4/2023,RC45Y9E3G9,1000,540
D10210,6,3/6/2023,RC644RSISY,540,0
D10211,1,10/23/2021,PJN7MXE9LN,100,"3800"
D10211,1,10/23/2021,PJN0MXHV0C,30,"3770"
D10211,1,10/24/2021,PJO8O4ESJE,100,"3670"
D10211,1,10/24/2021,PJO2O4HGI8,30,"3640"
D10211,1,10/25/2021,PJP4Q30I5C,100,"3540"
D10211,1,10/25/2021,PJP4Q345YC,30,"3510"
D10211,1,10/26/2021,PJQ3RAV5VJ,100,"3410"
D10211,1,10/26/2021,PJQ4RAYQIO,30,"3380"
D10211,1,10/27/2021,PJR0TH5PQ8,100,"3280"
D10211,1,10/27/2021,PJR6TH8I6I,30,"3250"
D10211,1,10/28/2021,PJS5V4DM5Z,100,"3150"
D10211,1,10/28/2021,PJS9V4IQ6J,30,"3120"
D10211,1,10/29/2021,PJT8WT0VFQ,100,"3020"
D10211,1,10/29/2021,PJT2WT2R98,30,"2990"
D10211,1,10/30/2021,PJU8YJONRG,100,"2890"
D10211,1,10/30/2021,PJU1YJR5N3,30,"2860"
D10211,1,10/31/2021,PJV0ZN8GX0,100,"2760"
D10211,1,10/31/2021,PJV7ZNBK21,30,"2730"
D10211,1,11/1/2021,PK122QQBIY,30,"2700"
D10211,1,11/1/2021,PK102QV4WU,100,"2600"
D10211,1,11/2/2021,PK234H7A9L,100,"2500"
D10211,1,11/2/2021,PK244H8WOO,30,"2470"
D10211,1,11/3/2021,PK426AYJCQ,100,"2370"
D10211,1,11/3/2021,PK436AZ9G7,30,"2340"
D10211,1,11/4/2021,PK447UYIC8,100,"2240"
D10211,1,11/4/2021,PK457V0J6R,30,"2210"
D10211,1,11/5/2021,PK599E7RAH,100,"2110"
D10211,1,11/5/2021,PK539EBRLV,30,"2080"
D10211,1,11/6/2021,PK60BCEPQC,100,"1980"
D10211,1,11/6/2021,PK65BCG6AZ,30,"1950"
D10211,1,11/7/2021,PK73C7BSZF,100,"1850"
D10211,1,11/7/2021,PK76C7E0GM,30,"1820"
D10211,1,11/8/2021,PK81EGATR5,100,"1720"
D10211,1,11/8/2021,PK83EGDXPR,30,"1690"
D10211,1,11/9/2021,PK99G116Y1,100,"1590"
D10211,1,11/9/2021,PK97G12WM9,30,"1560"
D10211,1,11/10/2021,PKA0HMQ30W,100,"1460"
D10211,1,11/10/2021,PKA8HMRTTY,30,"1430"
D10211,1,11/11/2021,PKB8J4RRO2,100,"1330"
D10211,1,11/11/2021,PKB1J4U75L,30,"1300"
D10211,1,11/12/2021,PKC2KPRH26,100,"1200"
D10211,1,11/12/2021,PKC5KPUCQ7,30,"1170"
D10211,1,11/13/2021,PKD2MFTQYQ,100,"1070"
D10211,1,11/13/2021,PKD8MFW61M,30,"1040"
D10211,1,11/15/2021,PKF4O4PPSS,100,940
D10211,1,11/15/2021,PKF2O4R03Y,30,910
D10211,1,11/16/2021,PKG0PL112K,100,810
D10211,1,11/16/2021,PKG1PL1QAD,30,780
D10211,1,11/16/2021,PKG8QNCWIW,100,680
D10211,1,11/17/2021,PKH4R7T3W6,30,650
D10211,1,11/17/2021,PKH2SO7XSM,100,550
D10211,1,11/17/2021,PKH2SOC0X0,30,520
D10211,1,11/18/2021,PKI3TTOX3Z,100,420
D10211,1,11/18/2021,PKI9TTRPN1,30,390
D10211,1,11/19/2021,PKJ6VYZGGO,100,290
D10211,1,11/19/2021,PKJ2VZ3KVC,30,260
D10211,1,11/20/2021,PKK7WOAQT1,100,160
D10211,1,11/20/2021,PKK7WOEW7N,60,100
D10211,1,11/20/2021,PKK3WOJ2ER,100,0
D10211,2,11/20/2021,PKK7XUV6JN,100,"6350"
D10211,2,11/20/2021,PKK3XUWJ4Z,90,"6260"
D10211,2,11/20/2021,PKK0XUXOGE,27,"6233"
D10211,2,11/22/2021,PKM2ZHS552,100,"6133"
D10211,2,11/22/2021,PKM5ZHSOZV,90,"6043"
D10211,2,11/22/2021,PKM9ZHSXLP,27,"6016"
D10211,2,11/22/2021,PKM023CM2E,100,"5916"
D10211,2,11/22/2021,PKM223DL12,90,"5826"
D10211,2,11/22/2021,PKM423ENWU,20,"5806"
D10211,2,11/22/2021,PKM523GK5T,7,"5799"
D10211,2,11/23/2021,PKN13V91O3,100,"5699"
D10211,2,11/23/2021,PKN53V9RO1,90,"5609"
D10211,2,11/23/2021,PKN13VB67N,27,"5582"
D10211,2,11/25/2021,PKP95O3JC1,100,"5482"
D10211,2,11/25/2021,PKP65O32AM,90,"5392"
D10211,2,11/25/2021,PKP15O3LSP,27,"5365"
D10211,2,11/25/2021,PKP477GK8G,100,"5265"
D10211,2,11/25/2021,PKP377IHHR,90,"5175"
D10211,2,11/25/2021,PKP177JN6J,27,"5148"
D10211,2,11/27/2021,PKR193A9PF,100,"5048"
D10211,2,11/27/2021,PKR193BX7N,90,"4958"
D10211,2,11/27/2021,PKR993CLJ5,27,"4931"
D10211,2,11/27/2021,PKR7AP20AP,100,"4831"
D10211,2,11/27/2021,PKR8AP34EC,90,"4741"
D10211,2,11/27/2021,PKR0AP9RL8,27,"4714"
D10211,2,11/28/2021,PKS7C8YICX,100,"4614"
D10211,2,11/28/2021,PKS0C90FPY,90,"4524"
D10211,2,11/28/2021,PKS0C93ENE,27,"4497"
D10211,2,11/29/2021,PKT7DW1QXH,100,"4397"
D10211,2,11/29/2021,PKT5DW3VL5,90,"4307"
D10211,2,11/30/2021,PKU1ECB5NV,27,"4280"
D10211,2,12/1/2021,PL11FQLTKP,27,"4253"
D10211,2,11/30/2021,PKU5FNM2UD,100,"4153"
D10211,2,11/30/2021,PKU2FNMKVQ,90,"4063"
D10211,2,12/2/2021,PL26HSD2BK,100,"3963"
D10211,2,12/2/2021,PL25HSFJ6P,90,"3873"
D10211,2,12/2/2021,PL22HSINA6,27,"3846"
D10211,2,12/3/2021,PL37JWFOYD,100,"3746"
D10211,2,12/3/2021,PL30JWHQ38,90,"3656"
D10211,2,12/3/2021,PL39JWJQB7,27,"3629"
D10211,2,12/4/2021,PL49MVLW0D,100,"3529"
D10211,2,12/4/2021,PL42MVMVF6,90,"3439"
D10211,2,12/4/2021,PL41MVO8KV,27,"3412"
D10211,2,12/5/2021,PL53O6KEQN,100,"3312"
D10211,2,12/5/2021,PL53O6NP23,90,"3222"
D10211,2,12/6/2021,PL66PQU050,100,"3122"
D10211,2,12/6/2021,PL63PQYSI7,90,"3032"
D10211,2,12/6/2021,PL66PR22X2,54,"2978"
D10211,2,12/7/2021,PL77S45S2P,100,"2878"
D10211,2,12/7/2021,PL79S47HUN,90,"2788"
D10211,2,12/7/2021,PL76S4968G,27,"2761"
D10211,2,12/8/2021,PL86TDYAD2,100,"2661"
D10211,2,12/8/2021,PL83TE19AZ,90,"2571"
D10211,2,12/8/2021,PL88THGMM2,27,"2544"
D10211,2,12/10/2021,PLA7XHVJAR,100,"2444"
D10211,2,12/10/2021,PLA5XHZ0W3,90,"2354"
D10211,2,12/10/2021,PLA7XI1PK5,27,"2327"
D10211,2,12/11/2021,PLB3ZFKW2T,100,"2227"
D10211,2,12/11/2021,PLB2ZFMH62,90,"2137"
D10211,2,12/11/2021,PLB4ZFO0X2,27,"2110"
D10211,2,12/12/2021,PLC922PH7B,100,"2010"
D10211,2,12/12/2021,PLC822Q8YQ,90,"1920"
D10211,2,12/12/2021,PLC222RI6M,27,"1893"
D10211,2,12/13/2021,PLD23QF1OI,100,"1793"
D10211,2,12/13/2021,PLD43QF1DG,90,"1703"
D10211,2,12/13/2021,PLD33QFR9X,27,"1676"
D10211,2,12/14/2021,PLE15AYOCL,100,"1576"
D10211,2,12/14/2021,PLE25B38Q4,90,"1486"
D10211,2,12/15/2021,PLF972HJ4P,100,"1386"
D10211,2,12/15/2021,PLF572K9JD,90,"1296"
D10211,2,12/15/2021,PLF172OVNT,44,"1252"
D10211,2,12/16/2021,PLG78EZ7OJ,100,"1152"
D10211,2,12/16/2021,PLG88F2Z0I,90,"1062"
D10211,2,12/16/2021,PLG58F6MJF,27,"1035"
D10211,2,12/18/2021,PLI4ATYIOE,100,935
D10211,2,12/18/2021,PLI6AU18D4,27,908
D10211,2,12/18/2021,PLI7B0C9RX,90,818
D10211,2,12/17/2021,PLH89XE27I,434,384
D10211,2,12/18/2020,PLI1B0SZC5,384,0
D10211,3,12/19/2021,PLJ7CNJ6ZH,100,"6350"
D10211,3,12/19/2021,PLJ9CNKGGR,90,"6260"
D10211,3,12/19/2021,PLJ2CNLQX2,27,"6233"
D10211,3,12/19/2021,PLJ9DW858X,100,"6133"
D10211,3,12/19/2021,PLJ4DW9UX2,90,"6043"
D10211,3,12/19/2021,PLJ8DWC4Q6,27,"6016"
D10211,3,12/20/2021,PLK0FO906Q,100,"5916"
D10211,3,12/20/2021,PLK6FOAQQ0,90,"5826"
D10211,3,12/21/2021,PLL9HFGIFN,217,"5609"
D10211,3,12/21/2021,PLL2G2QUV2,27,"5582"
D10211,3,12/22/2021,PLM9J6FN2T,217,"5365"
D10211,3,12/23/2021,PLN0L0705M,217,"5148"
D10211,3,12/24/2021,PLO8N01IVU,217,"4931"
D10211,3,12/25/2021,PLP8NZHGRK,217,"4714"
D10211,3,12/27/2021,PLR2RNRAUU,217,"4497"
D10211,3,12/29/2021,PLT1TTZQNT,100,"4397"
D10211,3,12/29/2021,PLT2TUFX0U,90,"4307"
D10211,3,12/29/2021,PLT8TVHD6W,27,"4280"
D10211,3,12/29/2021,PLT3USPV4Z,217,"4063"
D10211,3,12/31/2021,PLV1XOLBO3,100,"3963"
D10211,3,12/31/2021,PLV1XOUFTZ,90,"3873"
D10211,3,12/31/2021,PLV4XOX65I,27,"3846"
D10211,3,1/1/2022,QA10Z4MX3I,217,"3629"
D10211,3,1/1/2022,QA10Z4P1IM,100,"3529"
D10211,3,1/1/2022,QA17Z4UTJP,17,"3512"
D10211,3,1/3/2022,QA343V0RJ4,217,"3295"
D10211,3,1/3/2022,QA343V23ZA,100,"3195"
D10211,3,1/4/2022,QA465H3OR0,100,"3095"
D10211,3,1/4/2022,QA445H5SS6,90,"3005"
D10211,3,1/4/2022,QA405H9MZM,27,"2978"
D10211,3,1/5/2022,QA5976MY3H,100,"2878"
D10211,3,1/5/2022,QA5976OHP5,90,"2788"
D10211,3,1/5/2022,QA5876PRLM,27,"2761"
D10211,3,1/6/2022,QA628XCMF2,211,"2550"
D10211,3,1/8/2022,QA85BDETMB,100,"2450"
D10211,3,1/8/2022,QA80BDGTXI,90,"2360"
D10211,3,1/8/2022,QA85BDPZ8D,44,"2316"
D10211,3,1/8/2022,QA83C8T4AF,190,"2126"
D10211,3,1/9/2022,QA96DS17DE,217,"1909"
D10211,3,1/10/2022,QAA2FHP3WK,317,"1592"
D10211,3,1/11/2022,QAB2H3T6DO,217,"1375"
D10211,3,1/12/2022,QAC9IVY50L,217,"1158"
D10211,3,1/13/2022,QAE2KM7OKY,217,941
D10211,3,1/14/2022,QAE5M958VF,217,724
D10211,3,1/14/2022,QAF4MOTS0G,434,290
D10211,3,1/14/2022,QAF4MYCSD0,294,4
D10211,4,1/15/2022,QAF7O1ZLR9,217,"6233"
D10211,4,1/16/2022,QAG9PICA3V,100,"6133"
D10211,4,1/16/2022,QAG2PIDRFE,90,"6043"
D10211,4,1/16/2022,QAG8PIFASC,27,"6016"
D10211,4,1/17/2022,QAH5R8A48N,217,"5799"
D10211,4,1/18/2022,QAI7SS3YNB,217,"5582"
D10211,4,1/20/2022,QAK1ULMOI1,217,"5365"
D10211,4,1/20/2022,QAK6W6W62OC0,217,"5148"
D10211,4,1/21/2022,QAL3XWEYAP,217,"4931"
D10211,4,1/22/2022,QAM6ZN6BEW,217,"4714"
D10211,4,1/24/2022,QAO03WMB7A,217,"4497"
D10211,4,1/26/2022,QAQ15XF1VL,217,"4280"
D10211,4,1/26/2022,QAQ66YQR1M,217,"4063"
D10211,4,1/27/2022,QAR3922J01,217,"3846"
D10211,4,1/29/2022,QAT0B40TKQ,217,"3629"
D10211,4,1/29/2022,QAT5COYIJ3,217,"3412"
D10211,4,1/30/2022,QAU4EAL5FE,217,"3195"
D10211,4,1/31/2022,QAV3G5BDAX,217,"2978"
D10211,4,2/1/2022,QB17HYXQJN,217,"2761"
D10211,4,2/2/2022,QB21JTPGYX,217,"2544"
D10211,4,2/3/2022,QB37LJFWI7,217,"2327"
D10211,4,2/4/2022,QB45NKP6QP,217,"2110"
D10211,4,2/6/2022,QB65QCP2E1,100,"2010"
D10211,4,2/6/2022,QB65QCR1YZ,90,"1920"
D10211,4,2/6/2022,QB60QCSX6A,27,"1893"
D10211,4,2/6/2022,QB68QYBE94,217,"1676"
D10211,4,2/7/2022,QB75T24AQ9,217,"1459"
D10211,4,2/8/2022,QB84URN7OS,217,"1242"
D10211,4,2/9/2022,QB91WQ2WTF,217,"1025"
D10211,4,2/10/2022,QBA0YI2N3U,217,808
D10211,4,2/12/2022,QBC71JV989,217,591
D10211,4,2/12/2022,QBC021X42S,591,0
D10211,5,2/13/2022,QBD43DPET0,304,"8796"
D10211,5,2/13/2022,QBD44Q6PDK,304,"8492"
D10211,5,2/14/2022,QBE96SU20X,304,"8188"
D10211,5,2/15/2022,QBF08OIP82,304,"7884"
D10211,5,2/16/2022,QBG49X45C6,304,"7580"
D10211,5,2/17/2022,QBH6C7BKU6,304,"7276"
D10211,5,2/18/2022,QBI3E4JISP,304,"6972"
D10211,5,2/19/2022,QBJ0G3K68M,100,"6872"
D10211,5,2/20/2022,QBK3G7SZ11,100,"6772"
D10211,5,2/20/2022,QBK9G7VC4J,90,"6682"
D10211,5,2/20/2022,QBK7G8262D,14,"6668"
D10211,5,2/21/2022,QBL6JFWDPM,100,"6568"
D10211,5,2/21/2022,QBL5JFY13N,90,"6478"
D10211,5,2/22/2022,QBM7L8HFLP,204,"6274"
D10211,5,2/22/2022,QBM6L8K39A,100,"6174"
D10211,5,2/23/2022,QBN7N1ME11,204,"5970"
D10211,5,2/23/2022,QBN4N1NA4I,200,"5770"
D10211,5,2/24/2022,QBO6OUHYME,204,"5566"
D10211,5,2/24/2022,QBO1OUJDEB,100,"5466"
D10211,5,2/26/2022,QBQ9QQTX41_D2,250,"5216"
D10211,5,2/26/2022,QBQ2QQUB86,54,"5162"
D10211,5,2/26/2022,QBQ2SNDI64,204,"4958"
D10211,5,2/26/2022,QBQ2SNDS28,100,"4858"
D10211,5,2/28/2022,QBS3W7H6UB,304,"4554"
D10211,5,3/1/2022,QC16Y95WVU,304,"4250"
D10211,5,3/2/2022,QC201E7EJU,304,"3946"
D10211,5,3/3/2022,QC303FBYRA,304,"3642"
D10211,5,3/4/2022,QC475HLFDL,304,"3338"
D10211,5,3/5/2022,QC527MAU1M,304,"3034"
D10211,5,3/7/2022,QC71BD9YK9,304,"2730"
D10211,5,3/8/2022,QC81DAH3UX,304,"2426"
D10211,5,3/9/2022,QC98FE1N5U,304,"2122"
D10211,5,3/11/2022,QCB7HFIPTX,240,"1882"
D10211,5,3/11/2022,QCB3HFK9I9,64,"1818"
D10211,5,3/12/2022,QCC6JC8POI,280,"1538"
D10211,5,3/12/2022,QCC5JC959V,24,"1514"
D10211,5,3/12/2022,QCC5JVMHQZ,1514,0
D10211,6,3/13/2022,QCD0MXCGNO,217,"6183"
D10211,6,3/14/2022,QCE7OUSRRL,217,"5966"
D10211,6,3/15/2022,QCF1QAMQYN,217,"5749"
D10211,6,3/16/2022,QCG8SQE26C,217,"5532"
D10211,6,3/17/2022,QCH5UGJ3RF,217,"5315"
D10211,6,3/18/2022,QCI4WKNYP0,217,"5098"
D10211,6,3/20/2022,QCK5YKKW6D,217,"4881"
D10211,6,3/22/2022,QCM6343G5A,217,"4664"
D10211,6,3/22/2022,QCM24W8C38,217,"4447"
D10211,6,3/23/2022,QCN16M07DN,100,"4347"
D10211,6,3/23/2022,QCN86M7G3O,100,"4247"
D10211,6,3/23/2022,QCN36MD4J9,17,"4230"
D10211,6,3/24/2022,QCO58KE6GV,217,"4013"
D10211,6,3/25/2022,QCP6AELJ02,217,"3796"
D10211,6,3/26/2022,QCQ7CF33EP,100,"3696"
D10211,6,3/26/2022,QCQ5CF3MDP,17,"3679"
D10211,6,3/26/2022,QCQ9CF5G7T,100,"3579"
D10211,6,3/29/2022,QCT6G3IVHQ,217,"3362"
D10211,6,3/29/2022,QCT4HVVMEY,200,"3162"
D10211,6,3/29/2022,QCT3HVXXIV,17,"3145"
D10211,6,3/30/2022,QCU5JU926T,217,"2928"
D10211,6,4/1/2022,QD12MP2FWQ,217,"2711"
D10211,6,4/2/2022,QD22O23YOA,217,"2494"
D10211,6,4/2/2022,QD27Q2YTM9,217,"2277"
D10211,6,4/4/2022,QD43TXQ69Z,100,"2177"
D10211,6,4/4/2022,QD40TXTP68,217,"1960"
D10211,6,4/5/2022,QD53VVHVXF,100,"1860"
D10211,6,4/5/2022,QD51VVJUCD,17,"1843"
D10211,6,4/5/2022,QD56VVMLHY,100,"1743"
D10211,6,4/6/2022,QD67XXA2VX,334,"1409"
D10211,6,4/7/2022,QD79YYLBE5,217,"1192"
D10211,6,4/7/2022,QD73ZZKRJ7,434,758
D10211,6,4/8/2022,QD811F9FGZ,541,217
D10211,6,3/19/2022,QCO58KE6GV_D2,217,0
D10211,7,4/9/2022,QD9954DCHN,217,"6283"
D10211,7,4/11/2022,QDB68OX68W,217,"6066"
D10211,7,4/12/2022,QDC6ARGYQI,217,"5849"
D10211,7,4/13/2022,QDD2CN4M3I,217,"5632"
D10211,7,4/14/2022,QDE6EKR780,217,"5415"
D10211,7,4/15/2022,QDG8GKLME0,217,"5198"
D10211,7,4/16/2022,QDG2IC5NQI,217,"4981"
D10211,7,4/18/2022,QDI0LKJOYC,217,"4764"
D10211,7,4/20/2022,QDK7NK0F31,217,"4547"
D10211,7,4/20/2022,QDK3P9TFQT,217,"4330"
D10211,7,4/21/2022,QDL9R6H5DB,217,"4113"
D10211,7,4/22/2022,QDM6T1SBN4,217,"3896"
D10211,7,4/25/2022,QDP4YN2A32,217,"3679"
D10211,7,4/26/2022,QDQ91JAXL5,217,"3462"
D10211,7,4/27/2022,QDR43H4QQS,217,"3245"
D10211,7,4/29/2022,QDT95V2D8Z,217,"3028"
D10211,7,4/29/2022,QDT472AGUY,217,"2811"
D10211,7,5/2/2022,QE22CRW3T4,217,"2594"
D10211,7,5/1/2022,QE129QY2T2,217,"2377"
D10211,7,5/3/2022,QE31ENCK2P,217,"2160"
D10211,7,5/4/2022,QE46GGUFHC,217,"1943"
D10211,7,5/5/2022,QE56ILS9UA,217,"1726"
D10211,7,5/6/2022,QE62KJF0SU,217,"1509"
D10211,7,5/7/2022,QE73KYAZJF,1509,0
D10211,8,5/7/2022,QE76MOULY0,217,"6283"
D10211,8,5/10/2022,QEA9QLPAYN,217,"6066"
D10211,8,5/10/2022,QEA6SHO1QU,217,"5849"
D10211,8,5/11/2022,QEB2UENS52,217,"5632"
D10211,8,5/14/2022,QEE615XTH6,217,"5415"
D10211,8,5/16/2022,QEG54YEUBH,217,"5198"
D10211,8,5/17/2022,QEH96IP695,217,"4981"
D10211,8,5/19/2022,QEJ88UASPM,100,"4881"
D10211,8,5/19/2022,QEJ38UD8D1,90,"4791"
D10211,8,5/19/2022,QEJ98UF1HN,20,"4771"
D10211,8,5/19/2022,QEJ9AMJ2PL,224,"4547"
D10211,8,5/22/2022,QEM2EM0QSM,217,"4330"
D10211,8,5/24/2022,QEO5K68WV3,217,"4113"
D10211,8,5/26/2022,QEQ8O1PV7K,217,"3896"
D10211,8,5/28/2022,QES9S1RJCR,217,"3679"
D10211,8,5/30/2022,QEU6VJOR3C,217,"3462"
D10211,8,5/30/2022,QEU2VUBK0U,217,"3245"
D10211,8,5/31/2022,QEV8XXF36I,434,"2811"
D10211,8,6/1/2022,QF2613R8G6,217,"2594"
D10211,8,6/2/2022,QF202TRFNE,434,"2160"
D10211,8,6/5/2022,QF528M5SA4,2160,0
D10212,1,10/30/2021,PJU8Y61EI0,2275,"7245"
D10212,1,11/11/2021,PKB2IF5FZ4,800,"6445"
D10212,1,11/13/2021,PKD0MFEHZC,1275,"5170"
D10212,1,11/19/2021,PKJ3W32RZ9,1800,"3370"
D10212,1,11/23/2021,PKN629J7X6,1500,"1870"
D10212,1,11/23/2021,PKN43SBOR6,1450,420
D10212,1,11/25/2021,PKP85OVJZO,420,0
D10213,1,11/2/2021,PK253CRMS3,1600,"5200"
D10213,1,11/9/2021,PK96F3AJ6S,2000,"3200"
D10213,1,11/16/2021,PKG8QF4A8A,1500,"1700"
D10213,1,11/23/2021,PKN0354U7G,1700,0
D10213,2,12/2/2021,PL29IB1KKT,1500,"5000"
D10213,2,12/4/2021,PL41LJZJN9,100,"4900"
D10213,2,12/4/2021,PL43LK42KL,100,"4800"
D10213,2,12/11/2021,PLB5Y52R25,2000,"2800"
D10213,2,12/17/2021,PLH69IE0YG,2000,800
D10213,2,12/20/2021,PLK7E9L6TX,1300,500
D10213,3,12/30/2021,PLU5V6UCF1,1700,"4800"
D10213,3,1/6/2022,QA638QOCXF,2300,"2500"
D10213,3,1/14/2022,QAE5LQBLWT,1700,800
D10213,3,1/17/2022,QAH0QKMVJ2,800,0
D10213,4,2/24/2022,QBO0NZF9UI,3150,"9850"
D10213,4,3/4/2022,QC404SFEOK,3400,"6450"
D10213,4,3/11/2022,QCB5HU4TL9,3300,"3150"
D10213,4,3/17/2022,QCH6T3D9O8,3150,0
D10213,5,3/26/2022,QCQ2BWOOB0,1000,"12000"
D10213,5,4/14/2022,QDE4D6NYMG,12000,0
D10213,6,5/11/2022,QEB6TEJYXC,13000,0
D10213,7,6/4/2022,QF466KW4MC,7000,"6000"
D10213,7,6/7/2022,QF71BHNUFF,6000,0
D10213,8,7/4/2022,QG40U1LPWQ,7000,"6000"
D10213,8,7/5/2022,QG51X0I3R5,6000,0
D10213,9,7/30/2022,QGU1CFOL77,5000,"8000"
D10213,9,8/1/2022,QH16H5SFTM,4000,"4000"
D10213,9,8/2/2022,QH26IE0OQ4,4000,0
D10213,10,8/29/2022,QHT2ZWHZG2,13000,0
D10213,11,9/22/2022,QIM8FM2CNY,13000,0
D10213,12,10/22/2022,QJM5DXFCE3,13000,600
D10213,12,10/22/2022,QJM4DZF2LS,600,0
D10213,13,11/15/2022,QKF8ZAJR3E,5000,"8000"
D10213,13,11/18/2022,QKI162OW1L,8000,0
D10213,14,12/14/2022,QLE45Z3PFG,12800,0
D10213,15,1/11/2023,QLE45Z3PMN,13000,0
D10213,16,1/23/2023,RAN3Z9RZVB,11400,0
D10213,17,2/10/2023,RBA5C5CXXZ,12000,0
D10213,18,2/24/2023,RBO6D6LJ2U,11600,0
D10213,19,3/22/2023,,12800,0
D10213,20,4/19/2023,RDJ3IQ5SDJ,13000,0
D10213,21,,,13000,0
D10213,22,6/12/2023,RFC4UXKNWG,13000,0
D10213,23,6/23/2023,RFN1QL6ZCB,11400,0
D10213,24,7/14/2023,RGE4HQQAXM,12300,0
D10213,25,8/15/2023,RHG98SI3KH,13600,0
D10214,1,11/4/2021,PK417TWQBB,1625,"5175"
D10214,1,11/12/2021,PKC4JGYMV2,1625,"3550"
D10214,1,11/20/2021,PKK9XTX8PB,1000,"2550"
D10214,1,11/24/2021,PKO35FBA6V,1000,"1550"
D10214,1,11/29/2021,PKT1DYEG45,500,"1050"
D10214,1,11/30/2021,PKU7FN97HL,950,100
D10214,1,12/1/2021,PL18GA2WPI,100,0
D10215,1,10/28/2021,PJS2UZF7JQ,520,"7280"
D10215,1,10/29/2021,PJT1WUNTHZ,260,"7020"
D10215,1,11/1/2021,PK151ADHCR,700,"6320"
D10215,1,11/4/2021,PK5181KK39,1100,"5220"
D10215,1,11/4/2021,PK558676O9,20,"5200"
D10215,1,11/7/2021,PK71CS2H11,950,"4250"
D10215,1,11/14/2021,PKE7MR7A8N,380,"3870"
D10215,1,11/16/2021,PKG9POMQCZ,260,"3610"
D10215,1,11/24/2021,PKO245SDQG,3610,0
D10216,1,11/1/2021,PK182LGOCS,100,"3800"
D10216,1,11/1/2021,PK162LXRVW,100,"3700"
D10216,1,11/1/2021,PK122MS2QW,50,"3650"
D10216,1,11/2/2021,PK213TWUTD,100,"3550"
D10216,1,11/3/2021,PK325H0JJW,100,"3450"
D10216,1,11/3/2021,PK305YY5YS,55,"3395"
D10216,1,11/4/2021,PK467KQEG8,50,"3345"
D10216,1,11/5/2021,PK558UFQAB,80,"3265"
D10216,1,11/5/2021,PK5399I69H,120,"3145"
D10216,1,11/6/2021,PK62ADP6S0,100,"3045"
D10216,1,11/6/2021,PK67AJYDVF,70,"2975"
D10216,1,11/8/2021,PK84E1AKRM,75,"2900"
D10216,1,11/14/2021,PKE2N8L9LA,100,"2800"
D10216,1,11/14/2021,PKE0N8NVSM,80,"2720"
D10216,1,11/14/2021,PKE7NGZQED,100,"2620"
D10216,1,11/14/2021,PKE7NH8DQZ,100,"2520"
D10216,1,11/14/2021,PKE2NPAQVW,100,"2420"
D10216,1,11/14/2021,PKE5NPINXN,100,"2320"
D10216,1,11/14/2021,PKE1NPQ7C3,100,"2220"
D10216,1,11/15/2021,PKF1P06OLF,70,"2150"
D10216,1,11/15/2021,PKF3P5LR87,100,"2050"
D10216,1,11/15/2021,PKF7P5W80H,50,"2000"
D10216,1,11/21/2021,PKL2YRA2F4,100,"1900"
D10216,1,11/21/2021,PKL3YTL3R9,100,"1800"
D10216,1,11/21/2021,PKL4YVKYZ0,100,"1700"
D10216,1,11/22/2021,PKM71OU2C3,100,"1600"
D10216,1,11/22/2021,PKM621OL94,100,"1500"
D10216,1,11/24/2021,PKO44REVKS,100,"1400"
D10216,1,11/24/2021,PKO55F1Y91,100,"1300"
D10216,1,11/24/2021,PKO95F7SIB,100,"1200"
D10216,1,11/25/2021,PKP16I227L,100,"1100"
D10216,1,11/25/2021,PKP36MXC2D,100,"1000"
D10216,1,11/25/2021,PKP86YE3AQ,100,900
D10216,1,11/25/2021,PKP06YQ2QQ,25,875
D10216,1,11/26/2021,PKQ487W11K,100,775
D10216,1,11/26/2021,PKQ3882PEB,50,725
D10216,1,11/26/2021,PKQ48K3NAU,100,625
D10216,1,11/29/2021,PKT2CMC98Y,100,525
D10216,1,11/29/2021,PKT4CMFOKG,100,425
D10216,1,11/29/2021,PKT2CMK33W,80,345
D10216,1,11/30/2021,PKU0EHG26K,100,245
D10216,1,11/30/2021,PKU7EHJN1N,100,145
D10216,1,12/1/2021,PL14GT98KC,100,45
D10216,1,12/1/2021,PL17GTE5I5,45,0
D10217,1,11/12/2021,PKB2IN6FNW,1625,"6275"
D10218,1,11/15/2021,PKF3OPIV9V,600,"5900"
D10218,1,11/16/2021,PKG2Q8BA3E,300,"5600"
D10218,1,11/17/2021,PKH9S34TSH,300,"5300"
D10218,1,11/18/2021,PKI4U9ZI1Q,300,"5000"
D10218,1,11/20/2021,PKK1WOWH6F,700,"4300"
D10218,1,11/23/2021,PKN82XU328,100,"4200"
D10218,1,11/23/2021,PKN42XX6K0,100,"4100"
D10218,1,11/23/2021,PKN72Y1A3R,100,"4000"
D10218,1,11/25/2021,PKP45RWUUA,300,"3700"
D10218,1,11/26/2021,PKQ57H6EG5,300,"3400"
D10218,1,11/29/2021,PKT5D3U91T,300,"3100"
D10218,1,11/30/2021,PKU0FC640S,670,"2430"
D10218,1,12/1/2021,PL18FZFWHO,2430,0
D10218,2,12/16/2021,PLG27SH10Y,500,"6000"
D10218,2,12/26/2021,PLQ5Q24Z99,300,"5700"
D10218,2,12/24/2021,PLO1LPZYCJ,500,"5200"
D10218,2,12/29/2021,PLT8THSBW6,5200,0
D10218,3,1/20/2022,QAK7UWRBF7,500,"6300"
D10218,3,1/22/2022,QAM1Y1EHC3,500,"5800"
D10218,3,1/24/2022,QAO92REAKL,1000,"4800"
D10218,3,1/27/2022,QAR87KBI1Q,2000,"2800"
D10218,3,1/31/2022,QAV7FFRJRT,500,"2300"
D10218,3,2/1/2022,QB11GBCG9H,1000,"1300"
D10218,3,2/1/2022,QB17GP37G5,1300,0
D10218,4,3/1/2022,QC18WD805U,100,"7870"
D10218,4,3/1/2022,QC12WD8LIK,100,"7770"
D10218,4,3/1/2022,QC11WD9JE9,100,"7670"
D10218,4,3/1/2022,QC13X3WX9D,800,"6870"
D10218,4,3/1/2022,QC10XRTD9O,500,"6370"
D10218,4,3/2/2022,QC22ZEUB5C,500,"5870"
D10218,4,3/8/2022,QC83BMYF01,500,"5370"
D10218,4,3/7/2022,QC75AFZCWB,100,"5270"
D10218,4,3/7/2022,QC70AG43CU,100,"5170"
D10218,4,3/7/2022,QC74AG7XFS,100,"5070"
D10218,4,3/7/2022,QC75AHNMDZ,100,"4970"
D10218,4,3/7/2022,QC70AHVGAG,50,"4920"
D10218,4,3/15/2022,QCF3P4N49X,500,"4420"
D10218,4,3/27/2022,QCR5DQJEX5,220,"4200"
D10218,4,3/28/2022,QCS3FOX81H,600,"3600"
D10218,4,4/7/2022,QD74Y9VDZC,100,"3500"
D10218,4,4/7/2022,QD79Y9Z7YF,100,"3400"
D10218,4,4/7/2022,QD75YA3AEJ,100,"3300"
D10218,4,4/28/2022,QDS23NFLFU,500,"2800"
D10218,4,5/9/2022,QE96PSQNDQ,200,"2600"
D10218,4,5/10/2022,QEA2QQ1ODC,500,"2100"
D10218,4,5/17/2022,QEH76ISY51,300,"1800"
D10219,1,11/5/2021,PK538ULBPD,434,"13166"
D10219,1,11/6/2021,PK67A37A8T,434,"12732"
D10219,1,11/7/2021,PK78CW74YY,868,"11864"
D10219,1,11/9/2021,PK95FE79G9,434,"11430"
D10219,1,11/10/2021,PKA9HA8Q71,434,"10996"
D10219,1,11/11/2021,PKB7IX9FUR,434,"10562"
D10219,1,11/12/2021,PKD1KWK5AT,868,"9694"
D10219,1,11/17/2021,PKH2R4C69O,868,"8826"
D10219,1,11/19/2021,PKJ6UGPVP4,868,"7958"
D10219,1,11/21/2021,PKL0ZF40JC,868,"7090"
D10219,1,11/24/2021,PKO75N8939,435,"6655"
D10219,1,12/5/2021,PL58OJU9KG,1000,"5655"
D10219,1,12/7/2021,PL71S5CW59,500,"5155"
D10219,1,12/9/2021,PL97V5O8ZT,507,"4648"
D10219,1,12/10/2021,PLA4X3D0BO,1000,"3648"
D10219,1,12/11/2021,PLB5Y5QBTF,3648,0
D10220,1,11/3/2021,PK3963RK8P,3250,"3550"
D10220,1,11/18/2021,PKI6UDF7GA,1200,"2350"
D10220,1,11/23/2021,PKN52KK7U1,2050,300
D10220,1,11/23/2021,PKN72O0LNH,300,0
D10221,1,11/9/2021,PK93ESARHH,1085,"4915"
D10221,1,11/11/2021,PKB8IUEHNG,434,"4481"
D10221,1,11/12/2021,PKC4KUE7IK,217,"4264"
D10221,1,11/13/2021,PKD3MIA2L5,100,"4164"
D10221,1,11/13/2021,PKD3MIBMHX,100,"4064"
D10221,1,11/14/2021,PKE0NXW9FI,234,"3830"
D10221,1,11/15/2021,PKF2PI0PEU,217,"3613"
D10221,1,11/16/2021,PKG6R0EVFO,100,"3513"
D10221,1,11/16/2021,PKG5R0JC6L,100,"3413"
D10221,1,11/16/2021,PKG0R135FO,17,"3396"
D10221,1,11/17/2021,PKH4SP3I0U,217,"3179"
D10221,1,11/18/2021,PKI7UEH5S3,217,"2962"
D10221,1,11/19/2021,PKJ1W6NF8R,217,"2745"
D10221,1,11/20/2021,PKK4XV3KD4,434,"2311"
D10221,1,11/23/2021,PKN02LY8X2,2311,0
D10221,1,11/22/2021,PKM41K3618,217,217
D10221,2,11/30/2021,PKU5ECHMHN,1625,"4875"
D10221,2,12/8/2021,PL82TPRJFW,1000,"3875"
D10221,2,12/11/2021,PLB4Y0HJ9U,625,"3250"
D10221,2,12/16/2021,PLG08TR5ME,1000,"2250"
D10221,2,12/20/2021,PLK8EDUZMY,2250,0
D10221,3,1/12/2022,QAC9IO4C65,2000,"5900"
D10221,3,1/25/2022,QAP35FVH41,500,"5400"
D10221,3,1/27/2022,QAR98ZIWPL,500,"4900"
D10221,3,1/28/2022,QAS3ARO1PL,500,"4400"
D10221,3,2/9/2022,QB94WKSJJ6,1000,"3400"
D10221,3,3/9/2022,QC91EP4ZXZ,2000,"1400"
D10222,1,11/5/2021,PK5086PZCO,100,"3470"
D10222,1,11/5/2021,PK5886T0GY,30,"3440"
D10222,1,11/6/2021,PK62A46JTY,100,"3340"
D10222,1,11/6/2021,PK62A4B0BQ,30,"3310"
D10222,1,11/7/2021,PK72CEJM0A,30,"3280"
D10222,1,11/7/2021,PK79CEGTHL,100,"3180"
D10222,1,11/8/2021,PK89ECA1TX,100,"3080"
D10222,1,11/8/2021,PK80ECFIAQ,30,"3050"
D10222,1,11/9/2021,PK94F0RPJ8,100,"2950"
D10222,1,11/9/2021,PK94F0V314,30,"2920"
D10222,1,11/10/2021,PKA0HKKICI,100,"2820"
D10222,1,11/10/2021,PKA8HKMGJE,30,"2790"
D10222,1,11/11/2021,PKB4I9KRZU,100,"2690"
D10222,1,11/11/2021,PKB8I9N0O4,30,"2660"
D10222,1,11/12/2021,PKC9KQNMQ7,100,"2560"
D10222,1,11/12/2021,PKC1KQQF95,30,"2530"
D10222,1,11/13/2021,PKD6LIC3M0,100,"2430"
D10222,1,11/13/2021,PKD0LIH9EQ,30,"2400"
D10222,1,11/14/2021,PKE5MYXICL,100,"2300"
D10222,1,11/14/2021,PKE0MZ4SKQ,30,"2270"
D10222,1,11/15/2021,PKF6OJOULS,100,"2170"
D10222,1,11/15/2021,PKF6OJRVWS,30,"2140"
D10222,1,11/16/2021,PKG1QFJ3F3,100,"2040"
D10222,1,11/16/2021,PKG6QFNLNS,30,"2010"
D10222,1,11/17/2021,PKH9SLMN9V,100,"1910"
D10222,1,11/17/2021,PKH4SLREIG,30,"1880"
D10222,1,11/18/2021,PKI1UC0OZZ,100,"1780"
D10222,1,11/18/2021,PKI6UC3HZY,30,"1750"
D10222,1,11/19/2021,PKJ2W30GWE,100,"1650"
D10222,1,11/19/2021,PKJ1W352R7,30,"1620"
D10222,1,11/20/2021,PKK2XDWSTM,100,"1520"
D10222,1,11/20/2021,PKK5XE0VJD,30,"1490"
D10222,1,11/21/2021,PKL1YNYWML,100,"1390"
D10222,1,11/21/2021,PKL5YO23EX,30,"1360"
D10222,1,11/22/2021,PKM616KH6Q,100,"1260"
D10222,1,11/22/2021,PKM816MXBU,30,"1230"
D10222,1,11/22/2021,PKM41DJB7S,1230,0
D10223,1,11/9/2021,PK97FQUH5T,435,"15365"
D10223,1,11/10/2021,PKA9HCS3E5,435,"14930"
D10223,1,11/11/2021,PKB9J7R97P,435,"14495"
D10223,1,11/12/2021,PKC3KQ083V,435,"14060"
D10223,1,11/13/2021,PKD6MI92TG,435,"13625"
D10223,1,11/15/2021,PKF2NYYO7K,435,"13190"
D10223,1,11/16/2021,PKG3PXI51B,435,"12755"
D10223,1,11/17/2021,PKH7SEZ8C5,435,"12320"
D10223,1,11/19/2021,PKJ8W5SC7Y,870,"11450"
D10224,1,11/11/2021,PKB8J21JUC,3250,"9750"
D10224,1,11/22/2021,PKM3ZRECM3,1400,"8350"
D10224,1,11/22/2021,PKM4ZRMZ4G,1450,"6900"
D10224,1,12/2/2021,PL27IFUPPJ,3250,"3650"
D10224,1,12/6/2021,PL65Q39A43,3650,0
D10224,2,4/1/2022,QD12NFX4XE,2500,"13300"
D10224,2,4/11/2022,QDB87B6I38,3700,"9600"
D10224,2,4/11/2022,QDB97BALAF,1500,"8100"
D10224,2,5/9/2022,QE94PU54AA,1000,"7100"
D10225,1,11/10/2021,PKA7HB2GIX,400,"11300"
D10225,1,11/11/2021,PKB8IWQPIO,400,"10900"
D10225,1,11/12/2021,PKC9KQLRUP,400,"10500"
D10225,1,11/13/2021,PKD3MCP103,400,"10100"
D10225,1,11/14/2021,PKE3NM2QS7,400,"9700"
D10225,1,11/15/2021,PKF7PEVQWT,400,"9300"
D10225,1,11/16/2021,PKG7R1EKPP,400,"8900"
D10225,1,11/17/2021,PKH3SF0343,390,"8510"
D10225,1,11/18/2021,PKI9UCFDBN,400,"8110"
D10225,1,11/19/2021,PKJ7VWZPZ9,390,"7720"
D10225,1,11/20/2021,PKK5XHL5LD,400,"7320"
D10225,1,11/22/2021,PKM921T8Y5,800,"6520"
D10225,1,11/23/2021,PKN83U9G5K,390,"6130"
D10225,1,11/24/2021,PKO55I84GJ,100,"6030"
D10225,1,11/24/2021,PKO45IEK3Y,200,"5830"
D10225,1,11/26/2021,PKQ38Y7UZJ,800,"5030"
D10225,1,11/27/2021,PKR3AP616F,400,"4630"
D10225,1,11/29/2021,PKT8DVUYJG,800,"3830"
D10225,1,12/1/2021,PL18HACWIY,800,"3030"
D10225,1,12/2/2021,PL26J60KBK,390,"2640"
D10225,1,12/7/2021,PL71QQ65UX,2250,390
D10225,1,12/7/2021,PL78QQEH1E,390,0
D10225,2,12/8/2021,PL85U0AAZF,390,"12750"
D10225,2,12/10/2021,PLA5W9RN45,400,"12350"
D10225,2,12/12/2021,PLC0ZUOT2A,400,"11950"
D10225,2,12/14/2021,PLE53XYSEX,400,"11550"
D10225,2,12/16/2021,PLG78VO7YD,30,"11520"
D10225,2,12/16/2021,PLG18W9T4J,300,"11220"
D10225,2,12/17/2021,PLH7AOIGRH,390,"10830"
D10226,1,11/16/2021,PKG7Q2GYGN,1300,"3340"
D10226,1,11/18/2021,PKI6U9MPI2,1000,"2340"
D10226,1,11/24/2021,PKO94B4VJ5,300,"2040"
D10226,1,11/24/2021,PKO74DPH2V,2040,0
D10226,2,12/1/2021,PL19HFGF79,1000,"5320"
D10226,2,12/23/2021,PLN6K31N4A,200,"5120"
D10226,2,12/23/2021,PLN0KOIRTC,1000,"4120"
D10226,2,1/17/2022,QAH5R2YYVR,100,"4020"
D10226,2,1/17/2022,QAH0R32G0C,100,"3920"
D10227,1,11/30/2021,PKU6ER7MBA,1100,"3640"
D10227,1,12/27/2021,PLR6QJVC3K,2000,"1640"
D10228,1,11/30/2021,PKU9ETNGG1,1625,"4875"
D10228,1,12/8/2021,PL81SZ8BG3,530,"4345"
D10228,1,12/8/2021,PL89T1MNEF,1100,"3245"
D10228,1,12/10/2021,PLA6WPS7FE,1625,"1620"
D10228,1,12/14/2021,PLE749LYMR,1620,0
D10229,1,11/19/2021,PKJ1VSFM9V,100,"5100"
D10229,1,11/19/2021,PKJ5VV9PDL,100,"5000"
D10229,1,11/20/2021,PKK6XK4E1Y,100,"4900"
D10229,1,11/20/2021,PKK1XK6SQN,80,"4820"
D10229,1,11/16/2021,PKG7QO3TBT,174,"4646"
D10229,1,11/17/2021,PKH3SBS0WJ,80,"4566"
D10229,1,11/17/2021,PKH9SBNXLX,100,"4466"
D10229,1,11/18/2021,PKI0U1BHWY,100,"4366"
D10229,1,11/18/2021,PKI6U1G7M0,80,"4286"
D10229,1,11/22/2021,PKM91RPZR9,100,"4186"
D10229,1,11/22/2021,PKM61RVWQO,80,"4106"
D10229,1,11/23/2021,PKN73LLH6J,100,"4006"
D10229,1,11/23/2021,PKN13LP0UH,80,"3926"
D10229,1,11/24/2021,PKO24RVS5M,100,"3826"
D10229,1,11/24/2021,PKO44RXI1Q,80,"3746"
D10229,1,11/26/2021,PKQ58PEB1L,100,"3646"
D10229,1,11/26/2021,PKQ38PSSVD,100,"3546"
D10229,1,11/28/2021,PKS9B3KJ51,100,"3446"
D10229,1,11/28/2021,PKS4B3Q1US,100,"3346"
D10229,1,11/30/2021,PKU7E64KXP,100,"3246"
D10229,1,11/30/2021,PKU7E6HUTB,100,"3146"
D10229,1,11/30/2021,PKU4ETIIIM,100,"3046"
D10229,1,12/3/2021,PL39JE45HF,100,"2946"
D10229,1,12/3/2021,PL38JF02OI,100,"2846"
D10229,1,12/3/2021,PL34KF11RK,100,"2746"
D10229,1,12/6/2021,PL60Q6PBAC,100,"2646"
D10229,1,12/6/2021,PL69Q6XIIX,100,"2546"
D10229,1,12/8/2021,PL85S7RJ81,100,"2446"
D10229,1,12/13/2021,PLD42JX7Z8,2046,400
D10229,1,12/11/2021,PLB2Z6MBBW,100,300
D10229,1,12/11/2021,PLB2Z7B1SU,100,200
D10229,1,12/11/2021,PLB2Z7E30I,100,100
D10229,1,12/11/2021,PLB4Z7I3E2,100,0
D10229,2,12/18/2021,PLI0C9GG9S,100,"5100"
D10229,2,12/18/2021,PLI5CFSLSL,100,"5000"
D10229,2,12/18/2021,PLI1CFVGEN,100,"4900"
D10229,2,12/18/2021,PLI5CFZPQR,100,"4800"
D10229,2,12/19/2021,PLJ9DBLHK7,100,"4700"
D10229,2,12/19/2021,PLJ0DPJ72E,100,"4600"
D10229,2,12/19/2021,PLJ5DVZGP5,100,"4500"
D10229,2,12/13/2021,PLD33PVAAJ,174,"4326"
D10229,2,12/21/2021,PLL9GBDD1P,100,"4226"
D10229,2,12/23/2021,PLN1KM9L27,100,"4126"
D10229,2,12/23/2021,PLN2KMSYSA,100,"4026"
D10229,2,12/23/2021,PLN9KSQCB7,100,"3926"
D10229,2,12/27/2021,PLR2R2AE5Y,100,"3826"
D10229,2,12/27/2021,PLR5R2ET8Z,100,"3726"
D10229,2,12/27/2021,PLR3R2JLDV,100,"3626"
D10229,2,12/27/2021,PLR7R2MFTR,100,"3526"
D10229,2,12/27/2021,PLR9R2RFI5,100,"3426"
D10229,2,12/28/2021,PLS7RRBGH9,100,"3326"
D10229,2,12/28/2021,PLS5RWXVV1,100,"3226"
D10229,2,12/28/2021,PLS9RX2FKR,100,"3126"
D10229,2,12/24/2021,PLO0LVR7B8,100,"3026"
D10229,2,1/3/2022,QA333DFNXV,3026,0
D10229,3,1/13/2022,QAD0JTYCPG,2000,"3200"
D10229,3,1/13/2022,QAD4JY6PU0,34,"3166"
D10229,3,1/13/2022,QAD4JUEJ98,2446,720
D10229,4,2/1/2022,QB11GXUOFD,7200,0
D10229,5,2/15/2022,QBF5832L3D,7115,0
D10229,6,3/2/2022,QC27Z54PE9,7000,20
D10229,6,3/2/2022,QC29ZN5EYX,20,0
D10229,7,3/3/2022,QC393CUSP1,100,"7700"
D10229,7,3/3/2022,QC323C7Q3Q,100,"7600"
D10229,7,3/4/2022,QC453W4FA1,200,"7400"
D10229,7,3/6/2022,QC6899FUMS,240,"7160"
D10229,7,3/3/2022,QC313D8JNZ,60,"7100"
D10229,7,3/7/2022,QC73BAO29H,100,"7000"
D10229,7,3/7/2022,QC75BAUT7X,100,"6900"
D10229,7,3/7/2022,QC75BAZ5VD,60,"6840"
D10229,7,3/8/2022,QC80D8TJL0,100,"6740"
D10229,7,3/8/2022,QC89D99GMF,100,"6640"
D10229,7,3/8/2022,QC80D9MUEW,60,"6580"
D10229,7,3/9/2022,QC97F044QD,100,"6480"
D10229,7,3/9/2022,QC91F0B9P1,60,"6420"
D10229,7,3/12/2022,QCC6KT6196,100,"6320"
D10229,7,3/12/2022,QCC9KTILZB,100,"6220"
D10229,7,3/12/2022,QCC4KTUQQ8,100,"6120"
D10229,7,3/13/2022,QCD1MSXWY7,100,"6020"
D10229,7,3/13/2022,QCD6MT4JV6,60,"5960"
D10229,7,3/13/2022,QCD1MVFM65,80,"5880"
D10229,7,3/19/2022,QCJ1YCTKXN,100,"5780"
D10229,7,3/19/2022,QCJ1YDLG07,100,"5680"
D10229,7,3/19/2022,QCJ8YDQI5C,60,"5620"
D10229,7,3/26/2022,QCQ9CE9OYL,100,"5520"
D10229,7,3/26/2022,QCQ8CF3AXK,100,"5420"
D10229,7,3/29/2022,QCT4GNUQ86,5420,0
D10229,8,3/30/2022,QCU9JVGNPZ,100,"7600"
D10229,8,3/31/2022,QCV7K7F1K9,100,"7500"
D10229,8,3/31/2022,QCV0K7MB1O,100,"7400"
D10229,8,3/31/2022,QCV3LTIKOL,100,"7300"
D10229,8,4/1/2022,QD14MDEB04,100,"7200"
D10229,8,4/2/2022,QD22O6914I,100,"7100"
D10229,8,4/3/2022,QD36R94LNC,100,"7000"
D10229,8,4/3/2022,QD34ROBX8Q,100,"6900"
D10229,8,4/4/2022,QD44SEVCXQ,100,"6800"
D10229,8,4/5/2022,QD52V8F09E,100,"6700"
D10229,8,4/5/2022,QD50V8ORLE,100,"6600"
D10229,8,4/5/2022,QD52V8X83Y,100,"6500"
D10229,8,4/7/2022,QD74ZPMWLE,100,"6400"
D10229,8,4/7/2022,QD70ZPVHQ6,100,"6300"
D10229,8,4/7/2022,QD73ZWPWAJ,100,"6200"
D10229,8,4/7/2022,QD71ZWZ0OZ,100,"6100"
D10229,8,4/7/2022,QD70ZZIPFC,100,"6000"
D10229,8,4/8/2022,QD802YY8Y8,100,"5900"
D10229,8,4/9/2022,QD944EAH5E,100,"5800"
D10229,8,4/10/2022,QDA254JDQA,100,"5700"
D10229,8,4/11/2022,QDB3861OXB,100,"5600"
D10229,8,4/11/2022,QDB389VXLV,100,"5500"
D10229,8,4/11/2022,QDB18R71E9,100,"5400"
D10229,8,4/12/2022,QDC9AK4G45,100,"5300"
D10229,8,4/12/2022,QDC1AKGTWT,100,"5200"
D10229,8,4/13/2022,QDD5CIOTQ1,100,"5100"
D10229,8,4/13/2022,QDD1CJ11XZ,100,"5000"
D10229,8,4/15/2022,QDF1GJ2IQP,100,"4900"
D10229,8,4/16/2022,QDG6HAS0TW,100,"4800"
D10229,8,4/16/2022,QDG8HB53JI,100,"4700"
D10229,8,4/16/2022,QDG9HBDEIV,100,"4600"
D10229,8,4/17/2022,QDH2JSEVZ0,100,"4500"
D10229,8,4/17/2022,QDH2JSL8AG,100,"4400"
D10229,8,4/18/2022,QDI4LL6PYM,30,"4370"
D10229,8,4/18/2022,QDI5LM7KYB,100,"4270"
D10229,8,4/18/2022,QDI8LMBYEQ,100,"4170"
D10229,8,4/20/2022,QDK3PCWP9P,100,"4070"
D10229,8,4/20/2022,QDK6PCYHUI,100,"3970"
D10229,8,4/20/2022,QDK2PD0G76,100,"3870"
D10229,8,4/21/2022,QDL9Q6NSVP,100,"3770"
D10229,8,4/21/2022,QDL8Q6Z81C,100,"3670"
D10229,8,4/21/2022,QDL2Q732FE,100,"3570"
D10229,8,4/23/2022,QDN5TI983N,100,"3470"
D10229,8,4/23/2022,QDN9U1Q8ZT,100,"3370"
D10229,8,4/25/2022,QDP4XLWI0K,3370,0
D10229,9,5/23/2022,QEN0H5VKFM,10400,0
D10230,1,12/17/2021,PLH59DQB83,13000,0
D10230,2,1/13/2022,QAD9JI90Z3,13000,0
D10230,3,2/11/2022,QBB4ZKITL6,13000,0
D10230,4,3/2/2022,QC20ZCVIK4,12100,0
D10230,5,4/1/2022,QD16MD9Y7Q,13000,0
D10230,6,4/13/2022,QDD5BTVV5X,11400,0
D10230,7,5/11/2022,QEB5SXSU6P,19350,0
D10230,8,6/8/2022,QF84EA6JGY,19500,0
D10230,9,7/7/2022,QG7323L0BV,19500,0
D10230,10,8/6/2022,QH65R68FEZ,19500,900
D10230,10,8/6/2022,QH68R7PGM6,900,0
D10230,11,9/5/2022,QI54FMLVHS,20400,0
D10230,12,10/5/2022,QJ53BUAGS3,20400,0
D10230,13,11/7/2022,QK72GD6WL4,20400,0
D10230,14,12/6/2022,QL68KAYEA0,17000,"3400"
D10230,14,12/7/2022,QL76L58I0Y,400,"3000"
D10230,14,12/7/2022,QL78L4L2K0,400,"2600"
D10230,14,12/7/2022,QL79L2EVPB,800,"1800"
D10230,14,12/7/2022,QL76L235XC,900,900
D10230,14,12/7/2022,QL75LWVEQL,900,0
D10230,15,1/5/2023,RA59RE9KO5,19000,500
D10230,15,1/5/2023,RA57RI86XZ,500,0
D10230,16,2/16/2023,RBG5SFZ2UF,9000,"12900"
D10231,1,12/8/2021,PL84T9U7BS,1000,"12000"
D10231,1,12/18/2021,PLI2BW6KPS,300,"11700"
D10231,1,123/22/2021,PLM6IOYY0G,500,"11200"
D10232,1,12/18/2021,PLI2B8EKPE,13000,0
D10232,2,1/16/2022,QAG8PJUJAA,13000,0
D10232,3,2/15/2022,QBF87YTWK6,13000,0
D10232,4,3/16/2022,QCG3R0A4N9,13000,0
D10232,5,4/13/2022,QDD3CKKLV9,19500,0
D10232,6,5/13/2022,QED6Y18XEQ,5400,"15000"
D10232,6,5/14/2022,QEE6YW1UMW,14100,900
D10232,6,5/14/2022,QEE8Z44XMU,900,0
D10232,7,6/13/2022,QFD6OVKX4E,16000,"4400"
D10232,7,6/14/2022,QFE9P7QHGD,4400,0
D10232,8,7/19/2022,QGJ8QGIHHE,4400,"17500"
D10232,8,8/13/2022,QHD75HL75H,1000,"16500"
D10232,8,8/13/2022,QHD15IUAIZ,240,"16260"
D10233,1,12/1/2021,PL16GSHJYC,1426,"5000"
D10233,1,12/8/2021,PL86SU88ZM,2000,"3000"
D10233,1,12/11/2021,PLB9Y9OYBR,2000,"1000"
D10233,1,12/14/2021,PLE64SX77C,500,500
D10233,1,12/14/2021,PLE44UIISQ,500,0
D10234,1,11/30/2021,PKU9E34CG5,1600,"5200"
D10234,1,12/8/2021,PL80SJWTIY,1550,"3650"
D10234,1,12/18/2021,PLI8AWR5WW,1000,"2650"
D10234,1,12/21/2021,PLL7H4TIHR,700,"1950"
D10234,1,12/24/2021,PLO3MLAWW1,700,"1250"
D10234,1,1/8/2022,QA81ARV463,900,350
D10235,1,12/4/2021,PL41LGBIS7,2600,"7560"
D10235,1,12/10/2021,PLA3WG9D5N,2000,"5560"
D10235,1,12/11/2021,PLB7Y5VO7F,600,"4960"
D10235,1,12/17/2021,PLH49NAG6U,700,"4260"
D10235,1,12/18/2021,PLI1BFXPQ1,4260,0
D10236,1,12/8/2021,PL80T6IX5Y,1200,"11440"
D10236,1,12/11/2021,PLB3YSQ6PT,1600,"9840"
D10236,1,12/16/2021,PLG07JDUAG,1000,"8840"
D10236,1,12/18/2021,PLI6BWJC3Y,1000,"7840"
D10236,1,12/20/2021,PLK9FABQH5,450,"7390"
D10236,1,12/22/2021,PLM1IM3NMN,1800,"5590"
D10236,1,12/30/2021,PLU5VLEP8L,1000,"4590"
D10236,1,1/3/2022,QA353CQ5VN,500,"4090"
D10236,1,1/5/2022,QA566N68SU,200,"3890"
D10236,1,1/6/2022,QA608E0IGO,450,"3440"
D10236,1,1/10/2022,QAA4ED5BEW,500,"2940"
D10236,1,1/21/2022,QAL2WT6V0E,400,"2540"
D10236,1,1/24/2022,QAO62Z2BZ6,780,"1760"
D10237,1,1/19/2022,QAJ2UKVHLS,434,"15366"
D10237,1,1/21/2022,QAL9XT129P,500,"14866"
D10237,1,1/31/2022,QAV3ED5LN7,1200,"13666"
D10237,1,2/11/2022,QBB5YURXUV,500,"13166"
D10237,1,2/17/2022,QBH7AXC2RD,1500,"11666"
D10237,1,2/23/2022,QBN3LKAHV9,700,"10966"
D10237,1,2/24/2022,QBO2NG51NY,500,"10466"
D10237,1,3/4/2022,QC4240QX9K,500,"9966"
D10237,1,3/8/2022,QC87C54HUT,500,"9466"
D10237,1,3/17/2022,QCH8T3DX4Q,450,"9016"
D10237,1,3/24/2022,QCO56RJNUP,500,"8516"
D10237,1,4/8/2022,QD8220TOES,200,"8316"
D10237,1,4/23/2022,QDN9UEKOX3,600,"7716"
D10237,1,5/16/2022,QEG6478926,300,"7416"
D10237,1,5/20/2022,QEK3BSCAFR,200,"7216"
D10237,1,10/11/2022,QJB1PQWKXF,100,"7116"
D10238,1,1/21/2022,QAL8WADP08,217,"7683"
D10238,1,1/22/2022,QAM8Y08V50,217,"7466"
D10238,1,1/25/2022,QAP8460AVW,217,"7249"
D10238,1,1/27/2022,QAR87EUM5A,210,"7039"
D10238,1,1/27/2022,QAR17EVR57,6,"7033"
D10238,1,1/31/2022,QAV3G1D9FJ,651,"6382"
D10239,1,2/18/2022,QBI8CJLEIE,13000,0
D10239,2,1/3/2023,RA31LLJSTX,13600,0
D10239,3,2/1/2023,RA31LLJSTX_D2,13000,0
D10239,4,3/1/2023,RC10R770PO,13000,0
D10239,5,4/24/2023,RDO6WRKDYU,5000,"8600"
D10239,5,4/28/2023,RDS57UX3RZ,8600,0
D10239,6,5/31/2023,REV4UWRZ50,13000,0
D10239,7,7/10/2023,RGA56ZPLA3,13000,600
D10240,1,1/22/2022,QAM2ZQJNPY,109,"2941"
D10240,1,1/24/2022,QAO53YUE4Z,100,"2841"
D10240,1,1/24/2022,QAO43YPTGC,109,"2732"
D10240,1,1/27/2022,QAR47RQ4GY,550,"2182"
D10240,1,2/2/2022,QB21I5TXUL,327,"1855"
D10240,1,2/4/2022,QB41MLM5WT,100,"1755"
D10240,1,2/4/2022,QB43MLRCAV,9,"1746"
D10240,1,2/5/2022,QB51NXG9PZ,100,"1646"
D10240,1,2/5/2022,QB59NXNOC9,100,"1546"
D10240,1,2/5/2022,QB59O21ES5,1546,0
D10240,2,2/14/2022,QBE35C8GM5,100,"2925"
D10240,2,2/14/2022,QBE15CMS5J,100,"2825"
D10240,2,2/14/2022,QBE85CUIFI,18,"2807"
D10240,2,2/15/2022,QBF38Q05B3,100,"2707"
D10240,2,2/15/2022,QBF88Q0U7M,100,"2607"
D10240,2,2/15/2022,QBF18Q1SBR,18,"2589"
D10240,2,2/25/2022,QBP1P4G3Y9,2000,589
D10240,2,2/25/2022,QBP2P4M768,100,489
D10240,2,2/25/2022,QBP1P4YGQ1,100,389
D10240,2,2/25/2022,QBP5P5BAYZ,100,289
D10240,2,2/25/2022,QBP3PBU1QF,200,89
D10240,2,2/25/2022,QBP2PGTK34,89,0
D10240,3,3/2/2022,QC24YNMTC4,100,"2725"
D10240,3,3/2/2022,QC27YO250H,100,"2625"
D10240,3,3/2/2022,QC21YO6RKP,18,"2607"
D10240,3,3/4/2022,QC424TPNLU,100,"2507"
D10240,3,3/4/2022,QC404TW1U4,100,"2407"
D10240,3,3/4/2022,QC474U2EMP,18,"2389"
D10240,3,3/7/2022,QC78AGHKBE,436,"1953"
D10240,3,3/8/2022,QC84BUDYTC,436,"1517"
D10240,3,3/9/2022,QC96EL4PU2,1500,17
D10240,3,3/9/2022,QC92EMX5T4,17,0
D10240,4,3/11/2022,QCB0HIW7R4,100,"2775"
D10240,4,3/11/2022,QCB4HJ08EG,9,"2766"
D10240,4,3/16/2022,QCG0QYUN98,100,"2666"
D10240,4,3/16/2022,QCG7QYXYXR,9,"2657"
D10240,4,3/23/2022,QCN35ERJBR,1059,"1598"
D10240,4,3/23/2022,QCN15D9M1V,763,835
D10240,4,3/23/2022,QCN359KV49,36,799
D10240,4,3/23/2022,QCN459CP3A,100,699
D10240,4,3/23/2022,QCN7598XQ1,100,599
D10240,4,3/23/2022,QCN958Y5G1,100,499
D10240,4,3/23/2022,QCN058GS7Q,100,399
D10240,4,3/23/2022,QCN95SJW69,399,0
D10240,5,3/25/2022,QCP98MCZNJ,100,"3150"
D10240,5,3/25/2022,QCP38ME5TP,100,"3050"
D10240,5,3/25/2022,QCP38ME5TP_D2,18,"3032"
D10240,5,3/25/2022,QCP8ACXWJM,100,"2932"
D10240,5,4/5/2022,QD58UAKKFS,100,"2832"
D10240,5,4/5/2022,QD55UKU4FB,50,"2782"
D10240,5,4/19/2022,QDJ7LZF7UJ,273,"2509"
D10240,5,4/20/2022,QDK2NSHBMG,100,"2409"
D10240,5,4/20/2022,QDK3NSOOBD,100,"2309"
D10240,5,4/20/2022,QDK1NSU0R3,100,"2209"
D10240,5,4/21/2022,QDL8PLUK02,2200,9
D10240,5,4/21/2022,QDL4Q3EZ2O,9,0
D10240,6,4/26/2022,QDQ5YQ69FF,100,"2897"
D10240,6,4/26/2022,QDQ7YQ9B9X,100,"2797"
D10240,6,4/26/2022,QDQ2YQCMWG,100,"2697"
D10240,6,4/26/2022,QDQ1YVAVE1,100,"2597"
D10240,6,4/27/2022,QDR71ORWUN,100,"2497"
D10240,6,4/27/2022,QDR61OW8MO,45,"2452"
D10240,6,5/3/2022,QE37DH0J21,100,"2352"
D10240,6,5/3/2022,QE37DH5S13,100,"2252"
D10240,6,5/3/2022,QE32DHBTE8,100,"2152"
D10240,6,5/3/2022,QE32DNHIOW,100,"2052"
D10240,6,5/4/2022,QE41EXQUG7,100,"1952"
D10240,6,5/4/2022,QE42EY0R52,100,"1852"
D10240,6,5/4/2022,QE45EY9CQZ,100,"1752"
D10240,6,5/4/2022,QE46F11I92,63,"1689"
D10240,6,5/4/2022,QE43F16SMB,100,"1589"
D10240,6,5/4/2022,QE41F1E72R,9,"1580"
D10240,6,5/4/2022,QE48F4TYWO,1580,0
D10240,7,5/25/2022,QEP7M5H9B3,1000,"5500"
D10240,7,5/31/2022,QEV6W39264,100,"5400"
D10240,7,5/31/2022,QEV5W3CAAX,100,"5300"
D10240,7,5/31/2022,QEV0W3G6KS,100,"5200"
D10240,7,5/31/2022,QEV9W3ISCB,100,"5100"
D10240,7,6/2/2022,QF2911MSDT,100,"5000"
D10240,7,6/2/2022,QF2714NHLB,1500,"3500"
D10240,7,6/2/2022,QF2221OM12,3500,0
D10241,1,1/28/2022,QAS6APE04S,100,"6400"
D10241,1,1/28/2022,QAS3APMLAZ,100,"6300"
D10241,1,1/28/2022,QAS3AQ3HD9,50,"6250"
D10241,1,1/29/2022,QAT6CIXJZO,300,"5950"
D10241,1,1/7/2022,QB77RGOQ0J,500,"5450"
D10241,1,2/9/2022,QB93WGQ41J,600,"4850"
D10241,1,2/19/2022,QBJ7FSGQ7P,1050,"3800"
D10241,1,2/24/2022,QBO8NHYCGQ,2000,"1800"
D10241,1,2/24/2022,QBO4NZFZQA,1800,0
D10241,2,3/3/2022,QC392WA3JD,1630,"4850"
D10241,2,3/11/2022,QCB1HISI5F,1150,"3700"
D10241,2,3/17/2022,QCH1UAYIGD,1000,"2700"
D10241,2,3/23/2022,QCN45WIKCM,2700,0
D10241,3,4/2/2022,QD24ORAAK8,1000,"5500"
D10241,3,4/15/2022,QDF3ER6NV7,2000,"3500"
D10241,3,4/18/2022,QDI0KCWV82,2000,"1500"
D10241,3,4/19/2022,QDJ9LYRNIB,1500,0
D10241,4,5/12/2022,QEC7V0ZDIP,2000,"4500"
D10241,4,5/13/2022,QED1X68XDX,1500,"3000"
D10241,4,5/14/2022,QEE811G15O,1500,"1500"
D10241,4,5/16/2022,QEG73M0N4F,1500,0
D10241,5,6/10/2022,QFA1I7B7CV,2800,"3700"
D10241,5,6/11/2022,QFB6KKI3IC,3700,0
D10241,6,7/9/2022,QG935B1VRD,3000,"3500"
D10241,6,7/10/2022,QGA596AZXH,2000,"1500"
D10241,6,7/11/2022,QGB6A2KY4G,1500,0
D10241,7,8/7/2022,QH72UHHCLK,2000,"4500"
D10241,7,8/8/2022,QH88VQZ0YM,4500,0
D10241,8,9/5/2022,QI56FENH5C,6500,0
D10241,9,10/2/2022,QJ204UG8MU,4600,"1900"
D10241,9,10/3/2022,QJ305L0MSO,1900,0
D10241,10,10/28/2022,QJS5QKI15Z,4000,"2350"
D10241,10,10/28/2022,QJS6RLDGYK,2350,0
D10241,11,11/29/2022,QKT8WZC0XQ,3700,"3100"
D10241,11,11/30/2022,QKU1XZSFZF,2800,300
D10241,11,11/30/2022,QKU0Y3YG6W,300,0
D10241,12,12/28/2022,QLS36XREJT,6500,0
D10241,13,1/23/2022,RAN0ZLR5WK,6400,0
D10241,14,2/16/2023,RBG7TAA9F9,4000,"2500"
D10241,14,2/19/2023,RBJ71XZ6Z7,800,"1700"
D10241,14,2/20/2023,RBK72QBKG7,1700,0
D10241,15,3/20/2023,RCK285Q48G,6500,0
D10241,16,4/16/2023,RDG4BPLJVC,3000,"3500"
D10241,16,4/17/2023,RDH5DWY051,3500,0
D10241,17,5/5/2023,REF5LCDY41,6500,0
D10241,18,6/10/2023,RFC0UW5CQK,6500,0
D10241,19,7/10/2023,RGA881W1J2,4100,"2700"
D10241,19,7/11/2023,RGB29PAU1W,2400,300
D10241,19,7/12/2023,RGC1CRIJUZ,300,0
D10241,20,8/8/2023,RH80KNSNI8,6500,0
D10242,1,3/4/2022,QC494H41KD,13000,0
D10242,2,3/31/2022,QCV4K84CPU,13120,120
D10242,3,4/30/2022,QDU0866P0U,12120,0
D10242,4,5/25/2022,QEP5KMVCAP,12000,800
D10242,4,5/26/2022,QEQ4NK0524,800,0
D10242,5,7/5/2022,QG59WL0Y1V,13000,0
D10242,6,8/4/2022,QH41NKDXQ1,7000,"6600"
D10242,6,8/5/2022,QH56PHND44,6600,0
D10242,7,9/3/2022,QI33CCV19D,11000,"2600"
D10242,7,9/5/2022,QI58FEZP0E,2600,0
D10242,8,10/3/2022,QJ365SZUPI,9500,"3500"
D10242,8,10/4/2022,QJ4587AZ9V,3500,0
D10242,9,11/8/2022,QK81IVX059,2000,"13800"
D10242,9,11/10/2022,QKA8N1H7MI,1000,"12800"
D10242,9,12/9/2022,QL96QII720,1000,"11800"
D10242,9,12/15/2022,QLF37JK28R,1500,"10300"
D10242,9,1/4/2023,RA47NTJPV5,1000,"9300"
D10242,9,2/1/2023,RB13OZBTMH_D2,100,"9200"
D10242,9,3/1/2023,RC11R2O2JH,500,"8700"
D10242,9,4/20/2023,RDK2MQHZP2,200,"8500"
D10243,1,3/4/2022,QC493SWJQ1,1700,"5440"
D10243,1,3/12/2022,QCC4JF01TK,1740,"3700"
D10243,1,3/23/2022,QCN35QJGQV,3700,0
D10243,2,4/11/2022,QDB87F9NYU,6700,0
D10243,3,5/9/2022,QE99OZE4E3,7150,0
D10244,1,3/3/2022,QC312PU1WV,11000,200
D10245,1,3/4/2022,QC474DMNO1,3000,"10000"
D10245,1,3/25/2022,QCP39OQABX,3000,"7000"
D10245,1,3/26/2022,QCQ5AWUTDL,2000,"5000"
D10245,1,3/27/2022,QCR8DPL28Y,2400,"2600"
D10245,1,3/27/2022,QCR3DPUHFX,100,"2500"
D10245,1,3/28/2022,QCS6F09AFC,2400,100
D10245,1,3/28/2022,QCS8F0E4LO,100,0
D10246,1,3/2/2022,QC29ZHR6YZ,217,"6583"
D10246,1,3/3/2022,QC362IHS1U,217,"6366"
D10246,1,3/4/2022,QC474L53XB,217,"6149"
D10246,1,3/5/2022,QC536OOG49,217,"5932"
D10246,1,3/7/2022,QC769V02O0,217,"5715"
D10246,1,3/8/2022,QC83D0B51D,217,"5498"
D10246,1,3/9/2022,QC91EZ32B1,217,"5281"
D10246,1,3/14/2022,QCE5NHXPB1,1050,"4231"
D10246,1,3/16/2022,QCG6S3Y6UA,217,"4014"
D10246,1,3/17/2022,QCH3TY9SE9,217,"3797"
D10246,1,4/8/2022,QD8227NC26,2897,900
D10246,1,4/5/2022,QD56VNCS6G,1000,100
D10247,1,3/10/2022,QCA0H107S2,3000,"10600"
D10247,1,3/29/2022,QCT0HTV11G,4000,"6600"
D10247,1,3/30/2022,QCU4IE4HUG,6000,600
D10247,1,3/30/2022,QCU0IEMENO,600,0
D10247,2,4/9/2022,QD903QM89C,1450,"13150"
D10247,2,5/5/2022,QE56HQEI42,11550,"1600"
D10247,3,5/31/2022,QEV1WL5B57,13000,0
D10247,4,6/24/2022,QFO6A1QSF6,12600,0
D10247,5,7/22/2022,QGM3WHO3T3,500,"19900"
D10247,5,7/23/2022,QGN8Y4U15O,19900,0
D10247,6,8/22/2022,QHM9LUHLWX,19500,900
D10247,6,8/22/2022,QHM6LVT3DY,500,400
D10247,6,8/22/2022,QHM5LY64OB,400,0
D10247,7,11/16/2022,QKG31OC6Y1,1625,"4575"
D10247,7,11/22/2022,QKM8F7KVJ6,1625,"2950"
D10247,7,11/29/2022,QKT0WBLZC4,2950,0
D10247,8,12/8/2022,QL85P2QM73,1625,"4675"
D10247,8,12/15/2022,QLF582MLM5,1625,"3050"
D10247,8,12/21/2022,QLL6OORC36,1625,"1425"
D10247,8,12/23/2022,QLN3TWB21D,1425,0
D10247,9,1/6/2023,RA66RUO7EY,1625,"4525"
D10247,9,1/9/2023,RA991GSJWX,1625,"2900"
D10247,9,1/14/2023,QKM8F7KVJ6_D2,2900,0
D10247,10,1/22/2023,RAM9WGDCWJ,1625,"4525"
D10247,10,2/1/2023,RB13MLNFDT,1625,"2900"
D10247,10,2/4/2023,RB46ULB0AE,2900,0
D10247,11,2/23/2023,RBN9A0HNEP_D2,3000,"3200"
D10247,11,2/23/2023,RBN5ATI8D7,3200,0
D10247,12,3/22/2023,RCM0DUSCXY,6450,0
D10247,13,4/17/2023,RDH3DAB0L3,6400,0
D10247,14,5/12/2023,REC4E8EK8U,500,"6000"
D10247,14,5/13/2023,RED8HQY6KA,150,"5850"
D10247,14,5/15/2023,REF4LGBTS4,5850,0
D10248,1,3/3/2022,QC668KE7XY,434,"12466"
D10248,1,3/4/2022,QC5763VDRH,434,"12032"
D10248,1,3/5/2022,QC454MI8AX,434,"11598"
D10248,1,3/6/2022,QC332F690V,434,"11164"
D10248,1,3/7/2022,QC76AFFTZC,434,"10730"
D10248,1,3/8/2022,QC81CHCD6L,434,"10296"
D10248,1,3/9/2022,QC90EFQPXC,434,"9862"
D10248,1,3/10/2022,QCA9GDHBGV,434,"9428"
D10248,1,3/11/2022,QCB1IA2Y61,434,"8994"
D10248,1,3/12/2022,QCC9KCKU61,434,"8560"
D10248,1,3/13/2022,QCD2M1J3SE,434,"8126"
D10248,1,3/14/2022,QCE0NXG0C6,434,"7692"
D10248,1,3/15/2022,QCF7PSDMVD,434,"7258"
D10248,1,3/16/2022,QCG4RPFTXA,434,"6824"
D10248,1,3/17/2022,QCH2TP4RTI,434,"6390"
D10248,1,3/18/2022,QCI3VF4H2J,434,"5956"
D10248,1,3/19/2022,QCJ4XJ7L9A,434,"5522"
D10248,1,3/20/2022,QCK9106679,434,"5088"
D10248,1,3/21/2022,QCL62ZU62G,434,"4654"
D10248,1,3/22/2022,QCM54P5RIL,434,"4220"
D10248,1,3/23/2022,QCN96JZOPZ,434,"3786"
D10248,1,3/24/2022,QCO08GFL4G,434,"3352"
D10248,1,3/27/2022,QCR6DVIAK4,1302,"2050"
D10248,1,3/28/2022,QCS4ES80J0,434,"1616"
D10248,1,3/29/2022,QCT8H17AL2,1517,99
D10248,1,3/29/2022,QCT4H1T9XK,100,1
D10248,2,3/29/2022,QCT5HQ43JV,434,"12566"
D10248,2,3/30/2022,QCU6JFJJ8G,434,"12132"
D10248,2,3/31/2022,QCV5LQR32V,434,"11698"
D10248,2,4/2/2022,QD26Q1CARK,434,"11264"
D10248,2,4/3/2022,QD38RVWCYW,434,"10830"
D10248,2,4/5/2022,QD59VVWFWX,434,"10396"
D10248,2,4/13/2022,QDD5CMWXW9,434,"9962"
D10248,2,4/27/2022,QDR32N3ARX,9692,270
D10248,2,4/27/2022,QDR92NUZIV,270,0
D10248,3,5/17/2022,QEH45H4TKO,12000,200
D10248,3,5/17/2022,QEH65MIY84,200,0
D10248,4,6/16/2022,QFG7TBQOFR,60,"13540"
D10248,4,6/16/2022,QFG8TBTM5C,6000,"7540"
D10248,4,6/17/2022,QFH3V82MSR,6500,"1040"
D10248,4,6/17/2022,QFH4V7ZDOO,40,"1000"
D10248,4,6/17/2022,QFH2VZX04Y,1000,0
D10249,1,3/8/2022,QC80D1PI6C,3250,"3250"
D10249,1,3/23/2022,QCN36MNW5P,3250,0
D10249,2,4/12/2022,QDC69434WO,3250,"3250"
D10249,2,4/20/2022,QDK7NT6XGP,3250,0
D10249,3,5/28/2022,QES1QW4CEN,6500,0
D10249,4,6/24/2022,QFO7AOZ2Z1,6500,0
D10249,5,6/25/2022,QFP9CSSK5B,5000,"1800"
D10249,5,7/27/2022,QGR66Z9RAE,200,"1600"
D10249,5,8/15/2022,QHF78QB6JR,100,"1500"
D10249,5,8/24/2022,QHO2PIZYK0,300,"1200"
D10249,5,8/24/2022,PENALTIES&INTEREST W/OFF,1200,0
D10250,1,3/3/2022,QC627TQE2O,260,"7900"
D10250,1,3/4/2022,QC5975IIER,260,"7640"
D10250,1,3/5/2022,QC424UB4LM,260,"7380"
D10250,1,3/6/2022,QC332OTCZV,260,"7120"
D10250,1,3/8/2022,QC85BI5119,260,"6860"
D10250,1,3/9/2022,QC86CV9XL0,260,"6600"
D10250,1,3/10/2022,QCA7FVHLNZ,260,"6340"
D10250,1,3/10/2022,QCA2H2AJ72,260,"6080"
D10250,1,3/12/2022,QCC6K8GNKO,260,"5820"
D10250,1,3/13/2022,QCD9MKMI57,520,"5300"
D10250,1,3/14/2022,QCF3P0QREV,260,"5040"
D10250,1,3/16/2022,QCG0SOADAK,520,"4520"
D10250,1,3/19/2022,QCJ1XUA2UV,780,"3740"
D10250,1,3/20/2022,QCK4ZZD9UM,260,"3480"
D10250,1,3/27/2022,QCR7DVDMWB,1580,"1900"
D10250,1,3/30/2022,QCU2J28Y5E,580,"1320"
D10250,1,4/1/2022,QD19LY2ACF,940,380
D10250,1,4/1/2022,QD11LY5XJT,20,360
D10250,1,4/1/2022,QD17MJKTC5,360,0
D10250,2,4/4/2022,QD41S0JEJL,420,"8340"
D10250,2,4/19/2022,QDJ3M3GV1P,1000,"7340"
D10250,2,4/21/2022,QDL6QKVRUC,550,"6790"
D10250,2,4/22/2022,QDM0SMN7O6,480,"6310"
D10250,2,4/28/2022,QDS54LKO4H,100,"6210"
D10250,2,4/29/2022,QDT55YCBFX,230,"5980"
D10250,2,5/11/2022,QEB9STOE0T,10000,"4020"
D10251,1,3/4/2022,QC618PKGQL,140,"3760"
D10251,1,3/5/2022,QC556TIHWN,140,"3620"
D10251,1,3/6/2022,QC484LMVHS,140,"3480"
D10251,1,3/7/2022,QC70ATPHUO,140,"3340"
D10251,1,3/8/2022,QC81CTLXBF,140,"3200"
D10251,1,3/9/2022,QC93ER35QN,140,"3060"
D10251,1,3/10/2022,QCA2GHF6TO,140,"2920"
D10251,1,3/11/2022,QCB3IIGU3N,100,"2820"
D10251,1,3/11/2022,QCB6IIMQ9S,40,"2780"
D10251,1,3/12/2022,QCC7KMGTKZ,100,"2680"
D10251,1,3/12/2022,QCC4KMMWXU,40,"2640"
D10251,1,3/13/2022,QCD4MG320G,100,"2540"
D10251,1,3/14/2022,QCE7OC4OI5,100,"2440"
D10251,1,3/14/2022,QCE5OC925X,40,"2400"
D10251,1,3/15/2022,QCF2QBJK7E,100,"2300"
D10251,1,3/17/2022,QCH8TZPT3W,100,"2200"
D10251,1,3/17/2022,QCH9TZZ1EZ,40,"2160"
D10251,1,3/18/2022,QCI4VKFWW4,100,"2060"
D10251,1,3/19/2022,QCJ7X86ZBJ,100,"1960"
D10251,1,3/21/2022,QCL12B1LUL,100,"1860"
D10251,1,3/21/2022,QCL82B8DDQ,40,"1820"
D10251,1,3/23/2022,QCN8696AWU,100,"1720"
D10251,1,3/23/2022,QCN469F0E0,40,"1680"
D10251,1,3/24/2022,QCO47ZNIRY,100,"1580"
D10251,1,3/24/2022,QCO17ZV8AF,40,"1540"
D10251,1,3/26/2022,QCQ9AZ92ML,100,"1440"
D10251,1,3/27/2022,QCR7DOLNY7,100,"1340"
D10251,1,3/27/2022,QCR7DOR5MV,40,"1300"
D10251,1,3/28/2022,QCS6F07A4K,1300,0
D10251,2,3/29/2022,QCT5HDFG1D,100,"3800"
D10251,2,3/29/2022,QCT4HEK3UU,40,"3760"
D10251,2,3/30/2022,QCU8J0I8P8,100,"3660"
D10251,2,3/31/2022,QCV8L4D5TG,100,"3560"
D10251,2,3/31/2022,QCV6L4KLTG,40,"3520"
D10251,2,4/1/2022,QD13NFGQJJ,40,"3480"
D10251,2,4/1/2022,QD19NF9863,100,"3380"
D10251,2,4/3/2022,QD32R7CI9E,100,"3280"
D10251,2,4/3/2022,QD31R7GEIT,40,"3240"
D10251,2,4/4/2022,QD41TUW7DP,100,"3140"
D10251,2,4/4/2022,QD40TUZFRO,40,"3100"
D10251,2,4/5/2022,QD54VHA646,100,"3000"
D10251,2,4/5/2022,QD53VHPJ79,40,"2960"
D10251,2,4/6/2022,QD66XB6HFY,100,"2860"
D10251,2,4/6/2022,QD61XNCIZZ,40,"2820"
D10251,2,4/7/2022,QD71ZF1U3R,100,"2720"
D10251,2,4/7/2022,QD76ZF6XM0,40,"2680"
D10251,2,4/8/2022,QD852HFYMF,100,"2580"
D10251,2,4/8/2022,QD822HNA1O,40,"2540"
D10251,2,4/9/2022,QD964H6A3Q,100,"2440"
D10251,2,4/10/2022,QDA76E629P,100,"2340"
D10251,2,4/10/2022,QDA06EBBXU,40,"2300"
D10251,2,4/10/2022,QDA76ELLAZ,40,"2260"
D10251,2,4/11/2022,QDB389OUIJ,100,"2160"
D10251,2,4/11/2022,QDB58A8C7Z,40,"2120"
D10251,2,4/12/2022,QDC2ADIB3M,100,"2020"
D10251,2,4/12/2022,QDC9ADPIWB,40,"1980"
D10251,2,4/13/2022,QDD2BKYBSS,100,"1880"
D10251,2,4/13/2022,QDD7BL25B7,40,"1840"
D10251,2,4/15/2022,QDF6G0PVEK,100,"1740"
D10251,2,4/15/2022,QDF9G0YEDR,40,"1700"
D10251,2,4/17/2022,QDH1J9ITWJ,100,"1600"
D10251,2,4/17/2022,QDH0J9NPGI,100,"1500"
D10251,2,4/18/2022,QDI5KY4GXX,100,"1400"
D10251,2,4/18/2022,QDI1KY8DO7,100,"1300"
D10251,2,4/19/2022,QDJ2MKSUSE,100,"1200"
D10251,2,4/19/2022,QDJ1MKW2YB,80,"1120"
D10251,2,4/21/2022,QDL2Q0WR2U,100,"1020"
D10251,2,4/21/2022,QDL9Q1090X,100,920
D10251,2,4/22/2022,QDM7SFIDF3,100,820
D10251,2,4/22/2022,QDM8SFNH7S,100,720
D10251,2,4/23/2022,QDN1UEMW71,100,620
D10251,2,4/23/2022,QDN4UET6ZA,100,520
D10251,2,4/25/2022,QDP9XD38JX,520,0
D10251,3,4/26/2022,QDQ5ZO6IK7,100,"3800"
D10251,3,4/26/2022,QDQ3ZOANBP,100,"3700"
D10251,3,4/27/2022,QDR92LZM6D,100,"3600"
D10251,3,4/27/2022,QDR82M2EOY,100,"3500"
D10251,3,4/29/2022,QDT16J9IOZ,100,"3400"
D10251,3,4/29/2022,QDT36JEH2F,40,"3360"
D10251,3,5/2/2022,QE29CB7XI3,40,"3320"
D10251,3,5/2/2022,QE27CBCHB9,100,"3220"
D10251,3,5/3/2022,QE32E3FHDK,100,"3120"
D10251,3,5/3/2022,QE34E3N09A,40,"3080"
D10251,3,5/4/2022,QE40FO9KWA,100,"2980"
D10251,3,5/4/2022,QE44FOC652,40,"2940"
D10251,3,5/6/2022,QE60JT60VA,100,"2840"
D10251,3,5/6/2022,QE60JTBTFM,40,"2800"
D10251,3,5/7/2022,QE79LUM0DN,100,"2700"
D10251,3,5/7/2022,QE77LUQ6JF,40,"2660"
D10251,3,5/8/2022,QE88NQXDSU,100,"2560"
D10251,3,5/8/2022,QE82NR1BVE,40,"2520"
D10251,3,5/11/2022,QEB8TT7VR0,100,"2420"
D10251,3,5/16/2022,QEG7475PMT,100,"2320"
D10251,3,5/16/2022,QEG4478X52,100,"2220"
D10251,3,5/17/2022,QEH46GU67E,100,"2120"
D10251,3,5/20/2022,QEK8C0TGVA,100,"2020"
D10251,3,5/20/2022,QEK2C0Z6G8,100,"1920"
D10251,3,5/22/2022,QEM9FUCEUX,100,"1820"
D10251,3,5/22/2022,QEM0FUG82E,100,"1720"
D10251,3,5/23/2022,QEN2HU92T0,100,"1620"
D10251,3,5/23/2022,QEN6HUJ7E4,100,"1520"
D10251,3,5/24/2022,QEO9IQTFGP,100,"1420"
D10251,3,5/24/2022,QEO3IQWAA7,100,"1320"
D10251,3,5/24/2022,QEO8IR4AVI,100,"1220"
D10251,3,5/24/2022,QEO1IRCKYP,100,"1120"
D10251,3,5/24/2022,QEO6IRGEMY,100,"1020"
D10251,3,5/24/2022,QEO9IRKEU5,100,920
D10251,3,5/24/2022,QEO5IRNRMX,100,820
D10251,3,5/24/2022,QEO0IRQT1O,100,720
D10251,3,5/24/2022,QEO6IRXAI0,90,630
D10251,3,5/13/2022,QED3WONRON,100,530
D10251,3,5/13/2022,QED3WOJW6F,100,430
D10251,3,5/24/2022,QEO8J90EMO,340,90
D10251,3,5/24/2022,QEO8JABKF8,90,0
D10251,4,5/25/2022,QEP7LH9WSP,100,"3770"
D10251,4,5/25/2022,QEP9LHE24V,40,"3730"
D10251,4,5/26/2022,QEQ4N8KEHW,100,"3630"
D10251,4,5/26/2022,QEQ1N8P5FZ,40,"3590"
D10251,4,5/28/2022,QES6QV2UXY,100,"3490"
D10251,4,5/28/2022,QES9QVC6P9,100,"3390"
D10251,4,5/29/2022,QET5T5DC4H,100,"3290"
D10251,4,5/29/2022,QET3T5GJAT,40,"3250"
D10251,4,5/30/2022,QEU2V18C9G,100,"3150"
D10251,4,5/30/2022,QEU2V1CWCE,50,"3100"
D10251,4,5/31/2022,QEV7X9KG1N,100,"3000"
D10251,4,5/31/2022,QEV5X9ZPCB,40,"2960"
D10251,4,6/2/2022,QF222DP0E8,100,"2860"
D10251,4,6/2/2022,QF292DTCOJ,40,"2820"
D10251,4,6/4/2022,QF4562QJVL,100,"2720"
D10251,4,6/4/2022,QF4562UDMH,40,"2680"
D10251,4,6/8/2022,QF88E4SKQG,100,"2580"
D10251,4,6/8/2022,QF81E4WJTD,40,"2540"
D10251,4,6/10/2022,QFA6IBM1EA,100,"2440"
D10251,4,6/10/2022,QFA2IBTML6,30,"2410"
D10251,4,6/11/2022,QFB5K66UYT,100,"2310"
D10251,4,6/11/2022,QFB4K6AOU4,40,"2270"
D10251,4,6/12/2022,QFC8M5YJ1W,100,"2170"
D10251,4,6/12/2022,QFC7M648R5,40,"2130"
D10251,4,6/14/2022,QFE7Q44CVZ,100,"2030"
D10251,4,6/14/2022,QFE6Q49E2Q,40,"1990"
D10251,4,6/16/2022,QFG6U6E07E,100,"1890"
D10251,4,6/16/2022,QFG2U6KN9O,50,"1840"
D10251,4,6/17/2022,QFH2W597EA,100,"1740"
D10251,4,6/17/2022,QFH1W5ENUR,60,"1680"
D10251,4,06/19//2022,QFJ0ZYOA6Q,100,"1580"
D10251,4,06/19//2022,QFJ9ZYWMP1,30,"1550"
D10251,4,6/20/2022,QFK02M9PZW,1550,0
D10251,5,6/21/2022,QFL54XGB6Z,100,"6400"
D10251,5,6/21/2022,QFL64XKPG8,100,"6300"
D10251,5,6/22/2022,QFM46ZKCR4,100,"6200"
D10251,5,6/23/2022,QFN68GWV04,100,"6100"
D10251,5,6/23/2022,QFN98H0B6H,100,"6000"
D10251,5,6/24/2022,QFO6ASR53S,100,"5900"
D10251,5,6/24/2022,QFO5ASW5GT,100,"5800"
D10251,5,6/25/2022,QFP2CP78VE,100,"5700"
D10251,5,6/25/2022,QFP0CPD4MY,100,"5600"
D10251,5,6/26/2022,QFQ8EHQISK,100,"5500"
D10251,5,6/26/2022,QFQ6EHWL16,70,"5430"
D10251,5,6/28/2022,QFS9I2WO3Z,100,"5330"
D10251,5,6/28/2022,QFS8I30BIS,100,"5230"
D10251,5,7/1/2022,QG18OKKCCK,100,"5130"
D10251,5,7/1/2022,QG17OKQCLT,40,"5090"
D10251,5,7/3/2022,QG39SIBLA1,100,"4990"
D10251,5,7/3/2022,QG34SIEM0C,100,"4890"
D10251,5,7/3/2022,QG30SIHSY0,100,"4790"
D10251,5,7/5/2022,QG55WN98UD,100,"4690"
D10251,5,7/5/2022,QG55WNCWSD,100,"4590"
D10251,5,7/7/2022,QG712JUHJJ,100,"4490"
D10251,5,7/7/2022,QG712K0GXF,100,"4390"
D10251,5,7/8/2022,QG8444JL6U,100,"4290"
D10251,5,7/8/2022,QG8544NMU7,40,"4250"
D10251,5,7/9/2022,QG936LIMQ5,100,"4150"
D10251,5,7/9/2022,QG906LPXKU,100,"4050"
D10251,5,7/10/2022,QGA78M0HUP,100,"3950"
D10251,5,7/10/2022,QGA48M3S3U,100,"3850"
D10251,5,7/12/2022,QGC3C8VFK7,300,"3550"
D10251,5,7/13/2022,QGD6ESZAAO,100,"3450"
D10251,5,7/13/2022,QGD6ET4M7U,100,"3350"
D10251,5,7/14/2022,QGE4GSMI3C,100,"3250"
D10251,5,7/14/2022,QGE3GSQHG5,100,"3150"
D10251,5,7/15/2022,QGF2IIIZIM,3200,50
D10251,6,7/16/2022,QGG9KJ593N,100,"6300"
D10251,6,7/16/2022,QGG7KJ8S5H,100,"6200"
D10251,6,7/18/2022,QGI6OEAFGC,100,"6100"
D10251,6,7/18/2022,QGI7OTIRKT,100,"6000"
D10251,6,7/18/2022,QGI1OTZNQ9,17,"5983"
D10251,6,7/19/2022,QGJ7QLRKET,100,"5883"
D10251,6,7/19/2022,QGJ6QLZS8I,100,"5783"
D10251,6,7/20/2022,QGK0SW0BY0,100,"5683"
D10251,6,7/21/2022,QGL5UHWNSZ,100,"5583"
D10251,6,7/21/2022,QGL8UI1SOM,100,"5483"
D10251,6,7/24/2022,QGO215YYQW,100,"5383"
D10251,6,7/24/2022,QGO3165LH3,63,"5320"
D10251,6,7/26/2022,QGQ555NQPV,100,"5220"
D10251,6,7/26/2022,QGQ055UZUA,100,"5120"
D10251,6,7/26/2022,QGQ1566FPJ,27,"5093"
D10251,6,7/28/2022,QGS88NZSL8,100,"4993"
D10251,6,7/28/2022,QGS18O2M9V,50,"4943"
D10251,6,7/28/2022,QGS193BQ2F,100,"4843"
D10251,6,7/31/2022,QGV2F17YB4,100,"4743"
D10251,6,7/31/2022,QGV9F1BF3J,100,"4643"
D10251,6,7/31/2022,QGV6F1GDRY,38,"4605"
D10251,6,8/3/2022,QH29IZLNAH,100,"4505"
D10251,6,8/3/2022,QH21IZQ3P9,100,"4405"
D10251,6,8/3/2022,QH25IZUVD3,9,"4396"
D10251,6,8/7/2022,QH79TPS1NX,100,"4296"
D10251,6,8/7/2022,QH78TPY7RG,100,"4196"
D10251,6,8/9/2022,QH95XOU9VD,100,"4096"
D10251,6,8/9/2022,QH95XOZQBL,100,"3996"
D10251,6,8/9/2022,QH90XP7PIC,20,"3976"
D10251,6,8/11/2022,QHB2228T1K,2400,"1576"
D10251,6,8/11/2022,QHB31JR0QZ,100,"1476"
D10251,6,8/11/2022,QHB61JNGZC,100,"1376"
D10251,6,8/11/2022,QHB424WA6U,1326,50
D10251,6,8/11/2022,QHB1261I2R,50,0
D10251,7,8/13/2022,QHD85PL5GG,100,"6400"
D10251,7,8/13/2022,QHD25PPDXQ,100,"6300"
D10251,7,8/13/2022,QHD45PT8UW,17,"6283"
D10251,7,8/16/2022,QHG9B6LFIN,100,"6183"
D10251,7,8/16/2022,QHG6B6P176,100,"6083"
D10251,7,8/16/2022,QHG8B6W22K,40,"6043"
D10251,7,8/18/2022,QHI9EWVDTP,100,"5943"
D10251,7,8/18/2022,QHI5EX2KFV,100,"5843"
D10251,7,8/18/2022,QHI0EX7BYQ,100,"5743"
D10251,7,8/19/2022,QHJ0H1J99A,100,"5643"
D10251,7,8/20/2022,QHK3IVYI2Z,100,"5543"
D10251,7,8/20/2022,QHK5IW3W9B,50,"5493"
D10251,7,8/21/2022,QHL1KB23XH,100,"5393"
D10251,7,8/21/2022,QHL5KB6F71,100,"5293"
D10251,7,8/21/2022,QHL0KBA07M,50,"5243"
D10251,7,8/24/2022,QHO7Q9MQYF,100,"5143"
D10251,7,8/24/2022,QHO2Q9SXQ0,100,"5043"
D10251,7,8/26/2022,QHQ7UCQMWZ,100,"4943"
D10251,7,8/28/2022,QHS0X9JTQY,100,"4843"
D10251,7,8/28/2022,QHS7XA8KFB,100,"4743"
D10251,7,8/28/2022,QHS0XAAYJY,12,"4731"
D10251,7,8/30/2022,QHU1370XQR,100,"4631"
D10251,7,8/31/2022,QHV05FFSMU,100,"4531"
D10251,7,8/31/2022,QHV55FNKI9,17,"4514"
D10251,7,9/1/2022,QI1568Z2NV,100,"4414"
D10251,7,9/1/2022,QI13692263,50,"4364"
D10251,7,9/1/2022,QI13790WIH,100,"4264"
D10251,7,9/1/2022,QI1279KVAK,100,"4164"
D10251,7,9/3/2022,QI31BWWTAR,100,"4064"
D10251,7,9/3/2022,QI36BX593K,100,"3964"
D10251,7,9/3/2022,QI38BXFMAM,29,"3935"
D10251,7,9/6/2022,QI61HKZL5D,1000,"2935"
D10251,7,9/8/2022,QI80KRVI3Q,580,"2355"
D10251,7,9/8/2022,QI80M57KF6,1050,"1305"
D10251,7,9/8/2022,QI80M5FN8M,14,"1291"
D10251,7,9/9/2022,QI98N0OOMA,1200,91
D10251,7,9/9/2022,QI98N5C6W0,91,0
D10251,8,9/11/2022,QIB4S87AYC,100,"6400"
D10251,8,9/11/2022,QIB3S8BYBL,100,"6300"
D10251,8,9/11/2022,QIB5S8JJKV,80,"6220"
D10251,8,9/14/2022,QIE4YG55X6,600,"5620"
D10251,8,9/18/2022,QII08BUZT2,370,"5250"
D10251,8,9/22/2022,QIM8H6VA18,100,"5150"
D10251,8,9/22/2022,QIM8H73984,100,"5050"
D10251,8,9/22/2022,QIM6H78C6Q,70,"4980"
D10251,8,9/27/2022,QIR7S2UHAZ,100,"4880"
D10251,8,9/27/2022,QIR9S37ITT,100,"4780"
D10251,8,9/27/2022,QIR7S3ETBR,70,"4710"
D10251,8,10/3/2022,QJ306DV5U0,500,"4210"
D10251,8,10/4/2022,QJ467SS51M,400,"3810"
D10251,8,10/4/2022,QJ45928PLZ,1900,"1910"
D10251,8,10/5/2022,QJ56B2TDEM,100,"1810"
D10251,8,10/5/2022,QJ55B2Y0Z3,100,"1710"
D10251,8,10/5/2022,QJ51B35YBH,60,"1650"
D10251,8,10/7/2022,QJ75EQYMJF,1650,0
D10251,9,10/8/2022,QJ82IXVMR6,200,"7540"
D10251,9,10/13/2022,QJD4UAEHSK,300,"7240"
D10251,9,10/17/2022,QJH33JVFW3,100,"7140"
D10251,9,10/17/2022,QJH03KBKLK,78,"7062"
D10251,9,10/20/2022,QJK091KMOY,300,"6762"
D10251,9,10/31/2022,QJV9YYNRR9,250,"6512"
D10251,9,11/1/2022,QK1221ZWQ6,100,"6412"
D10251,9,11/1/2022,QK12225EL8,57,"6355"
D10251,9,11/3/2022,QK316PQ1DF,100,"6255"
D10251,9,11/3/2022,QK3878VRWI,200,"6055"
D10251,9,11/3/2022,QK3279A5E2,77,"5978"
D10251,9,11/4/2022,QK498G1IAV,100,"5878"
D10251,9,11/4/2022,QK458G7WMP,100,"5778"
D10251,9,11/4/2022,QK468GELV6,22,"5756"
D10251,9,11/4/2022,QK498GX88B,98,"5658"
D10251,9,11/4/2022,QK459CH0BV,5000,658
D10251,9,11/4/2022,QK479CVJO7,658,0
D10251,10,11/10/2022,QKA1NZXU91,200,"9280"
D10251,10,11/12/2022,QKC0TCPFHM,100,"9180"
D10251,10,11/12/2022,QKC7TCWEBT,100,"9080"
D10251,10,11/15/2022,QKF713PGTX,220,"8860"
D10251,10,11/21/2022,QKL6ENVX7I,200,"8660"
D10251,10,11/30/2022,QKU0ZH54W2,100,"8560"
D10251,10,11/30/2022,QKU0ZHFWYC,60,"8500"
D10251,10,12/7/2022,QL76MZITJ8,100,"8400"
D10251,10,12/7/2022,QL71MZQDYL,70,"8330"
D10251,10,12/10/2022,QLA4TYJO4E,1000,"7330"
D10251,10,12/16/2022,QLG5B4HYZJ,450,"6880"
D10251,10,12/28/2022,QLS778A7JV,500,"6380"
D10251,10,1/6/2023,RA69THDOZL,1500,"4880"
D10251,10,1/13/2023,RAD8B3YFQ4,200,"4680"
D10251,10,1/17/2023,RAH1KI0BWF,200,"4480"
D10251,10,1/19/2023,RAJ6Q9VVWM,100,"4380"
D10251,10,1/19/2023,RAJ3QA0MAF,100,"4280"
D10251,10,1/2/2023,RAN61GWTGC,100,"4180"
D10251,10,1/23/2023,RAN91H6DA7,100,"4080"
D10251,10,1/30/2023,RAU7J23QQL,100,"3980"
D10251,10,1/30/2023,RAU2J2ENY0,100,"3880"
D10251,10,2/3/2023,RB36TKCSZM,300,"3580"
D10251,10,2/8/2023,RB887B6XQK,100,"3480"
D10251,10,2/8/2023,RB857BIOGJ,100,"3380"
D10251,10,2/15/2023,RBF5P8WEKV,100,"3280"
D10251,10,2/15/2023,RBF5P94H7N,100,"3180"
D10251,10,2/20/2022,RBK84EVRPW,200,"2980"
D10252,1,3/20/2022,QCK4YN2UVY,5700,"6600"
D10252,1,3/25/2022,QCP59RIB5Z,5000,"1600"
D10252,1,3/25/2022,QCP09R8Z8S,1600,0
D10252,2,4/11/2022,QDB98K11VD,11500,0
D10252,3,1/5/2023,RA52PIZ8CY,13600,0
D10253,1,3/12/2022,QCC6L9JAE8,3250,"9750"
D10253,1,3/20/2022,QCK2YJP2O8,3250,"6500"
D10253,1,3/26/2022,QCQ4CF7CT4,3250,"3250"
D10253,1,4/1/2022,QD13MJZAIT,3250,0
D10253,2,4/9/2022,QD97504LD9,3250,"10350"
D10253,2,4/16/2022,QDG0ICL7CU,2200,"8150"
D10253,2,4/20/2022,QDK8NZZQ68,1050,"7100"
D10253,2,4/24/2022,QDO2WKI7KA,3250,"3850"
D10253,2,4/30/2022,QDU77U3MJL,3850,0
D10253,3,5/6/2022,QE64KNIPO4,2200,"10800"
D10253,3,5/7/2022,QE73L6AF6F,1050,"9750"
D10253,3,5/13/2022,QED6YBNOOU,2100,"7650"
D10253,3,5/14/2022,QEE419W5J8,1150,"6500"
D10253,3,5/21/2022,QEL1CZITXJ,2200,"4300"
D10253,3,5/23/2022,QEN3HIIHMV,4300,0
D10253,4,6/2/2022,QF202M0FRO,3250,"9150"
D10253,4,6/15/2022,QFF9RIB7F1,6500,"2650"
D10253,4,6/18/2022,QFI7XLU8Q9,2650,0
D10253,5,6/27/2022,QFR5H4G4M7,2250,"10750"
D10253,5,7/15/2022,QGF6I4ZG4Y,10750,0
D10253,6,8/4/2022,QH43MTKZ25,12100,0
D10253,7,9/2/2022,QI248PQSQG,1450,"12150"
D10253,7,9/3/2022,QI39AIQLWH,2450,"9700"
D10253,7,9/6/2022,QI64GYIFYW,3000,"6700"
D10253,7,9/7/2022,QI71K802OR,2450,"4250"
D10253,7,9/8/2022,QI248PQSQG_D2,1100,"3150"
D10253,7,9/9/2022,QI90N86C56,3200,50
D10254,1,3/8/2022,QC80BU9ZXW,450,"12550"
D10254,1,3/9/2022,QC90EUVOOC,450,"12100"
D10254,1,3/10/2022,QCA4H5BPDI,450,"11650"
D10254,1,3/12/2022,QCC8JIE2ZK,450,"11200"
D10254,1,3/12/2022,QCC8KWPG1E,450,"10750"
D10254,1,3/14/2022,QCE1OU9M3N,900,"9850"
D10254,1,3/29/2022,QCT8HOPFCA,1000,"8850"
D10254,1,3/30/2022,QCU7JQAQKB,500,"8350"
D10254,1,4/1/2022,QD10NTRUFG,1000,"7350"
D10254,1,4/2/2022,QD39RV9S5J,1000,"6350"
D10254,1,4/4/2022,QD42SGGQC4,6350,0
D10254,2,4/5/2022,QD50UCJESC,450,"12550"
D10254,2,4/8/2022,QD8215566Y,500,"12050"
D10254,2,4/11/2022,QDB98P61LN,1000,"11050"
D10254,2,4/13/2022,QDD2CL8MHC,500,"10550"
D10254,2,4/15/2022,QDF3GC9O3T,500,"10050"
D10254,2,4/20/2022,QDK6PANF3U,1000,"9050"
D10254,2,4/25/2022,QDP0YB29VS,2000,"7050"
D10254,2,4/26/2022,QDQ21FJFVG,600,"6450"
D10254,2,4/30/2022,QDU594U5QB,2000,"4450"
D10254,2,5/1/2022,QE17AUP75Z,2000,"2450"
D10254,2,5/2/2022,QE20B9ZP3C,2450,0
D10254,3,5/6/2022,QE63KJTX7F,1000,"12000"
D10254,3,5/9/2022,QE95QEGTXH,1000,"11000"
D10254,3,5/11/2022,QEB6U8894W,1000,"10000"
D10254,3,5/15/2022,QEF323CK9H,1500,"8500"
D10254,3,5/17/2022,QEH66T0QZ0,500,"8000"
D10254,3,5/19/2022,QEJ2AKLI4Y,450,"7550"
D10254,3,5/21/2022,QEL0EIR9ZC,400,"7150"
D10254,3,5/24/2022,QEO2K4ZRWO,600,"6550"
D10254,3,5/26/2022,QEQ7O0OF81,450,"6100"
D10254,3,5/31/2022,QEV2WN64R0,6100,0
D10254,4,6/27/2022,QFR7FKUIAJ,13000,0
D10254,5,7/25/2022,QGP52D9XPN,19500,0
D10254,6,8/17/2022,QHH2DI4NUO,650,"18700"
D10254,6,8/22/2022,QHM3LM9P15,18700,0
D10254,7,9/19/2022,QIJ1992DCV,19500,150
D10254,8,9/19/2022,QIJ1992DCV_D2,150,"18900"
D10254,8,10/15/2022,QJF1XQKTAX,18900,0
D10254,9,10/26/2022,QJQ2MMGRBY,16800,0
D10255,1,3/10/2022,QCA0FYFU60,134,"12866"
D10255,1,3/10/2022,QCA4FYBJ0K,350,"12516"
D10255,1,3/18/2022,QC17VOX76L,1500,"11016"
D10255,1,3/22/2022,QCM83CNRWQ,270,"10746"
D10255,1,3/23/2022,QCN55TS9E5,300,"10446"
D10255,1,3/25/2022,QCP89HV8NK,350,"10096"
D10255,1,3/28/2022,QCS3EHRZKF,500,"9596"
D10255,1,4/6/2022,QD63X74MO3,9596,0
D10255,2,5/5/2022,QE51GVMN13,13000,0
D10255,3,5/28/2022,QES9QWDJM7,12700,0
D10255,4,6/25/2022,QFP8BW6GFI,11300,"1700"
D10255,4,6/25/2022,QFP6C30A3S,1700,0
D10255,5,7/23/2022,QGN6XLXPJA,13000,0
D10255,6,8/15/2022,QHF18QH1XL,12500,0
D10255,7,9/26/2022,QIQ6OPUQMY,3000,"12800"
D10255,7,9/28/2022,QIS1TFONTL,270,"12530"
D10255,7,10/8/2022,QJ82I11R6Y,100,"12430"
D10255,7,10/8/2022,QJ89I1CU99,100,"12330"
D10255,7,10/11/2022,QJB5OH4BQ3,1000,"11330"
D10255,7,10/17/2022,QJH02N96NM,400,"10930"
D10255,7,10/21/2022,QJL5B98LK1,450,"10480"
D10255,7,10/29/2022,QJT2TKN1OU,300,"10180"
D10255,7,11/3/2022,QK33673K3T,300,"9880"
D10255,7,11/8/2022,QK83J0SH0J,300,"9580"
D10255,7,11/10/2022,QKA3NHAH5V,300,"9280"
D10255,7,11/21/2022,QKL4CPXVWQ,200,"9080"
D10255,7,11/21/2022,QKL4CQ13NE,100,"8980"
D10255,7,3/6/2023,RC6766P1YP,200,"8780"
D10255,7,3/11/2023,RCB5JESTCN,100,"8680"
D10255,7,3/14/2023,RCE5RRPKW9,100,"8580"
D10255,7,3/16/2023,RCG5XIA6VR,300,"8280"
D10255,7,3/17/2023,RCH71FKWIL,100,"8180"
D10256,1,3/10/2022,QCA2FOAQ3Y,260,"7060"
D10256,1,3/11/2022,QCB9HNS9HF,260,"6800"
D10256,1,3/12/2022,QCD5ML47VF,260,"6540"
D10256,1,3/13/2022,QCC9JPO8GR,260,"6280"
D10256,1,3/14/2022,QCE5OF9MY1,260,"6020"
D10256,1,3/15/2022,QCF6QLBOOA,260,"5760"
D10256,1,3/16/2022,QCG6SJFT28,260,"5500"
D10256,1,3/17/2022,QCH4UEWDQ4,260,"5240"
D10256,1,3/18/2022,QCI8WDKPDK,260,"4980"
D10256,1,3/19/2022,QCJ3YBE5K9,260,"4720"
D10256,1,3/20/2022,QCK2ZWFGK4,260,"4460"
D10256,1,3/21/2022,QCL22W3EG0,260,"4200"
D10256,1,3/22/2022,QCM04R5IV0,260,"3940"
D10256,1,3/23/2022,QCN36JTK5J,260,"3680"
D10256,1,3/24/2022,QCO78GNWM1,260,"3420"
D10256,1,3/25/2022,QCP2A7ZW3U,260,"3160"
D10256,1,3/26/2022,QCQ0C66YKW,260,"2900"
D10256,1,3/27/2022,QCR9DYB2H7,260,"2640"
D10256,1,3/28/2022,QCS2FXR9G2,260,"2380"
D10256,1,3/29/2022,QCT0HQMK9G,260,"2120"
D10256,1,3/30/2022,QCU3INM5F5,2120,0
D10256,2,4/5/2022,QD55VIZZLF,1950,"5650"
D10256,2,4/12/2022,QDC3979YGD,1950,"3700"
D10256,2,4/19/2022,QDJ5N4510H,1950,"1750"
D10256,2,4/23/2022,QDN3TGA3BJ,1750,0
D10256,3,5/6/2022,QE64IWPB12,1950,"5610"
D10256,3,4/28/2022,QDS03VK8AI,1950,"3660"
D10256,3,5/12/2022,QEC5VS4B5,1950,"1710"
D10256,3,5/17/2022,QEH25DEV7M,1650,60
D10256,3,5/17/2022,QEH05G20N4,60,0
D10256,4,5/25/2022,QEP1LOLDL1,3250,"9750"
D10256,4,6/13/2022,QFD3NXY1ZR,6500,"3250"
D10256,4,6/7/2022,QF76C3JX54,3250,0
D10256,5,7/8/2022,QG81491GND,13000,0
D10256,6,8/19/2022,QHJ7FSF1HV,500,"14100"
D10256,6,8/27/2022,QHR5VVP0HL,5000,"9100"
D10256,6,9/22/2022,QIM7FVPHY5,300,"8800"
D10256,6,9/29/2022,QIT4VGU0TI,500,"8300"
D10256,6,10/19/2022,QJJ46UM85I,200,"8100"
D10256,6,10/27/2022,QJR3OLCKJ7,200,"7900"
D10257,1,3/11/2022,QCB3J5WTVH,350,"10530"
D10257,1,3/13/2022,QCD9MUED0P,700,"9830"
D10257,1,3/14/2022,QCE6OUBPRE,350,"9480"
D10257,1,3/16/2022,QCG7SLGY0N,570,"8910"
D10257,1,3/21/2022,QCL32SJHU7,1750,"7160"
D10257,1,3/22/2022,QCM54W5Z6D,350,"6810"
D10257,1,4/3/2022,QD35RX1K4P,4200,"2610"
D10257,1,4/10/2022,QDA96TFNQP,2130,480
D10258,1,3/22/2022,QCM64W8L88,500,"12140"
D10258,1,3/25/2022,QCP397BO43,500,"11640"
D10258,1,3/26/2022,QCQ6ASSVEA,500,"11140"
D10258,1,3/27/2022,QCR8E2B808,1000,"10140"
D10258,1,4/1/2022,QD17M28D9N,1050,"9090"
D10258,1,4/4/2022,QD45TFNFIZ,250,"8840"
D10258,1,4/5/2022,QD57VX4J91,300,"8540"
D10258,1,4/6/2022,QD63XYUHPT,300,"8240"
D10258,1,4/8/2022,QD8631CW6C,300,"7940"
D10258,1,4/11/2022,QDB16ZLNVZ,300,"7640"
D10258,1,4/19/2022,QDJ1LRB2MX,300,"7340"
D10258,1,4/25/2022,QDP5WVZHFZ,300,"7040"
D10259,1,3/12/2022,QCC3JR70A5,34,"8366"
D10259,1,3/12/2022,QCC3JRB5RT,304,"8062"
D10259,1,3/13/2022,QCD7MQTV0J,304,"7758"
D10259,1,3/14/2022,QCE6OKUUYI,304,"7454"
D10259,1,3/15/2022,QCF7QM1KX5,304,"7150"
D10259,1,3/16/2022,QCG1SA7H7R,304,"6846"
D10259,1,3/17/2022,QCH9UEPSIJ,304,"6542"
D10259,1,3/18/2022,QCI7W4F5W9,304,"6238"
D10259,1,3/19/2022,QCJ2XN40HA,304,"5934"
D10259,1,3/20/2022,QCK4ZVO44Q,304,"5630"
D10259,1,3/21/2022,QCL32HP56X,304,"5326"
D10259,1,3/22/2022,QCM44OS5FI,304,"5022"
D10259,1,3/23/2022,QCN95QZILT,304,"4718"
D10259,1,3/24/2022,QCP2A33QDM,608,"4110"
D10259,1,3/28/2022,QCS8FATK9U,9012,"4902"
D10260,1,3/12/2022,QCC7JCPL7D,100,"12900"
D10260,1,3/12/2022,QCC7JCQ9MJ,100,"12800"
D10260,1,3/12/2022,QCC6JCQTMS,100,"12700"
D10260,1,3/12/2022,QCC2JCRCQ6,100,"12600"
D10260,1,3/12/2022,QCC0JCRFNE,34,"12566"
D10260,1,3/12/2022,QCC3LAWMWL,100,"12466"
D10260,1,3/12/2022,QCC1LAXQPB,100,"12366"
D10260,1,3/12/2022,QCC3LAYTVX,100,"12266"
D10260,1,3/13/2022,QCD5LC1H5J,100,"12166"
D10260,1,3/13/2022,QCD4LC1CA8,34,"12132"
D10260,1,3/14/2022,QCE5N30HDJ,434,"11698"
D10260,1,3/15/2022,QCF3OYTOXT,434,"11264"
D10260,1,3/16/2022,QCG7QV39U3,100,"11164"
D10260,1,3/16/2022,QCG8QV3JZO,100,"11064"
D10260,1,3/16/2022,QCG4QV3YPK,100,"10964"
D10260,1,3/16/2022,QCG7QV5ECJ,100,"10864"
D10260,1,3/16/2022,QCG1QV653P,34,"10830"
D10260,1,3/17/2022,QCH6SSNB2O,434,"10396"
D10260,1,3/18/2022,QCI6UOHERY,434,"9962"
D10260,1,3/18/2022,QCJ4WM92AY,434,"9528"
D10260,1,3/20/2022,QCK4YK1KHC,434,"9094"
D10260,1,3/21/2022,QCL618FZ6Q,100,"8994"
D10260,1,3/21/2022,QCL318GDJ1,100,"8894"
D10260,1,3/21/2022,QCL618G9AC,100,"8794"
D10260,1,3/21/2022,QCL018GP7I,100,"8694"
D10260,1,3/21/2022,QCL118H2YJ,34,"8660"
D10260,1,3/22/2022,QCM73324JV,434,"8226"
D10260,1,3/23/2022,QCN54X8Y5V,434,"7792"
D10260,1,3/24/2022,QCO06SEAOS,434,"7358"
D10260,1,3/25/2022,QCP58N2OL7,434,"6924"
D10260,1,3/26/2022,QCQ2AKLVIW,434,"6490"
D10260,1,3/27/2022,QCR6CHI04A,434,"6056"
D10260,1,3/28/2022,QCS7E5E8BZ,434,"5622"
D10260,1,3/29/2022,QCT5G29I73,434,"5188"
D10260,1,3/30/2022,QCU1I06PJN,434,"4754"
D10260,1,3/31/2022,QCV0JXJWDE,434,"4320"
D10260,1,4/1/2022,4/1/2022,434,"3886"
D10260,1,4/2/2022,QD26O3JJCE,434,"3452"
D10260,1,4/3/2022,QD38Q6TJBW,434,"3018"
D10260,1,4/4/2022,QD49RZD16H,434,"2584"
D10260,1,4/5/2022,QD57TYENTD,434,"2150"
D10260,1,4/6/2022,QD61VZQSI3,434,"1716"
D10260,1,4/7/2022,QD72Y1L2GI,434,"1282"
D10260,1,4/8/2022,QD86130RX2,434,848
D10260,1,4/9/2022,QD9134SXT9,434,414
D10260,1,4/10/2022,QDA755RUQ9,434,20
D10260,2,4/14/2022,QDE7CQ6U9J,434,"12566"
D10260,2,4/15/2022,QDF8EOLVXU,434,"12132"
D10260,2,4/16/2022,QDG7GKFEQB,434,"11698"
D10260,2,4/17/2022,QDH7IEK0P5,434,"11264"
D10260,2,4/18/2022,QDI9K0U92X,434,"10830"
D10260,2,4/19/2022,QDJ1LQD3WL,434,"10396"
D10260,2,4/20/2022,QDK4NKTW50,434,"9962"
D10260,2,4/21/2022,QDL1PG00YV,434,"9528"
D10260,2,4/22/2022,QDM0R9OMYE,434,"9094"
D10260,2,4/23/2022,QDN9T5ICAP,434,"8660"
D10260,2,4/24/2022,QDO4V2OH4Q,434,"8226"
D10260,2,4/25/2022,QDPWUFA7D,434,"7792"
D10260,2,4/26/2022,QDQ1YOFWFV,434,"7358"
D10260,2,4/27/2022,QDR41M4Z3E,434,"6924"
D10260,2,4/28/2022,QDS83I8QTE,434,"6490"
D10260,2,4/29/2022,QDT35EOUCD,434,"6056"
D10260,2,4/30/2022,QDU77APXA7,434,"5622"
D10260,2,5/1/2022,QE1499LN70,434,"5188"
D10260,2,5/2/2022,QE23B0CWS5,434,"4754"
D10260,2,5/3/2022,QE37CZPLD1,434,"4320"
D10260,2,5/4/2022,QE41EOPNTV,434,"3886"
D10260,2,5/5/2022,QE59GNO475,434,"3452"
D10260,2,5/6/2022,QE68IW391U,434,"3018"
D10260,2,5/7/2022,QE74KP3MHW,434,"2584"
D10260,2,5/8/2022,QE80MRF3V2,434,"2150"
D10260,2,5/9/2022,QE99OKDVP1,434,"1716"
D10260,2,5/10/2022,QEA0QKNU9W,434,"1282"
D10260,2,5/11/2022,QEB9SIKEXV,1202,80
D10260,2,5/11/2022,QEB7UEAVS9,80,0
D10260,3,5/14/2022,QEE3YEQZV3,434,"12566"
D10260,3,5/15/2022,QEF11EE4O9,434,"12132"
D10260,3,5/16/2022,QEG3359KPV,434,"11698"
D10260,3,5/17/2022,QEH551YWXP,434,"11264"
D10260,3,5/18/2022,QEI06XES0E,434,"10830"
D10260,3,5/19/2022,QEJ78SOX59,434,"10396"
D10260,3,5/20/2022,QEK0AORWES,434,"9962"
D10260,3,5/21/2022,QEL9CVNOQN,434,"9528"
D10260,3,5/22/2022,QEM4EMOV76,434,"9094"
D10260,3,5/23/2022,QEN4GEH642,434,"8660"
D10260,3,5/24/2022,QEO7IBWQKP,434,"8226"
D10260,3,5/25/2022,QEP6K8F67U,434,"7792"
D10260,3,5/26/2022,QEQ2M6KZ1S,434,"7358"
D10260,3,5/27/2022,QER9O662X3,434,"6924"
D10260,3,5/28/2022,QES7QL74OF,434,"6490"
D10260,3,5/29/2022,QET4S8PU2G,434,"6056"
D10260,3,5/30/2022,QEU7TZOIPV,434,"5622"
D10260,3,5/31/2022,QEV0VZOED8,434,"5188"
D10260,3,6/1/2022,QF14YB6ET0,434,"4754"
D10260,3,6/2/2022,QF21ZZD4UJ,434,"4320"
D10260,3,6/3/2022,QF322YOYPI,434,"3886"
D10260,3,6/4/2022,QF49510I37,434,"3452"
D10260,3,6/6/2022,QF658YD037,434,"3018"
D10260,3,6/6/2022,QF648YK4MQ,434,"2584"
D10260,3,6/7/2022,QF71BA00W3,434,"2150"
D10260,3,6/8/2022,QF81D1NL71,434,"1716"
D10260,3,6/10/2022,QFA7H12ABV,868,848
D10260,3,6/11/2022,QFB8J4BO78,850,2
D10260,4,6/13/2022,QFD9MXDDIZ,650,"19750"
D10260,4,6/15/2022,QFF7QW3KMJ,1300,"18450"
D10260,4,6/17/2022,QFH5UWZPXF,1300,"17150"
D10260,4,6/19/2022,QFJ81LOALG,1300,"15850"
D10260,4,6/20/2022,QFL83OEE08,650,"15200"
D10260,4,6/22/2022,QFM85MWJF0,1300,"13900"
D10260,4,6/23/2022,QFN67KUOG4,650,"13250"
D10260,4,6/25/2022,QFP1BI9VRP,1300,"11950"
D10260,4,6/26/2022,QFR1F7X0WJ,1300,"10650"
D10260,4,6/29/2022,QFT5JD00HB,1000,"9650"
D10260,4,7/1/2022,QG16NIHR3S,1300,"8350"
D10260,4,7/5/2022,QG51VPQC43,800,"7550"
D10260,4,7/6/2022,QG68YQ6D86,1500,"6050"
D10260,4,7/8/2022,QG8441C3F4,1300,"4750"
D10260,4,7/10/2023,QGA896X60O,1300,"3450"
D10260,4,7/12/2022,QGC3BBERI7,2550,900
D10260,4,7/12/2022,QGC1DC9FKR,900,0
D10260,5,7/15/2022,QGF4HFLBVE,900,"17400"
D10260,5,7/16/2022,QGG9JI9RZB,900,"16500"
D10260,5,7/17/2022,QGH6LJ402U,900,"15600"
D10260,5,7/17/2022,QGH7N9XZGL,900,"14700"
D10260,5,7/19/2022,QGJ6R5YCZI,900,"13800"
D10260,5,7/20/2022,QGK7T5I3GV,900,"12900"
D10260,5,7/23/2022,QGN8YZPXW4,1800,"11100"
D10260,5,7/27/2022,QGR55QZ99L,900,"10200"
D10260,5,7/28/2022,QGS47R1SA6,1800,"8400"
D10260,5,7/31/2022,QGV2E0U69I,900,"7500"
D10260,5,8/1/2022,QH17FWY5OH,900,"6600"
D10260,5,8/3/2022,QH30LKIM8G,6600,0
D10260,6,8/6/2022,QH60QOFTO2,900,"18300"
D10260,6,8/8/2022,QH87UPJPRB,900,"17400"
D10260,6,8/9/2022,QH90WTWJFS,900,"16500"
D10260,6,8/11/2022,QHB52I954H,1800,"14700"
D10260,6,8/16/2022,QHG9AMZ85T,1800,"12900"
D10260,6,8/23/2022,QHN5O9TAGH,900,"12000"
D10260,6,8/29/2022,QHT81QOL56,900,"11100"
D10260,6,,,11100,0
D10260,7,9/26/2022,QIQ7OMGP8H,2000,"18400"
D10260,7,9/29/2022,QIT4W6PY0W,1300,"17100"
D10260,7,9/30/2022,QIU5Y3V92L,17100,0
D10261,1,3/12/2022,QCC2L4XYV4,260,"6580"
D10261,1,3/13/2022,QCD2MR14GC,260,"6320"
D10261,1,3/14/2022,QCE6OVEHBE,260,"6060"
D10261,1,3/16/2022,QCG8SCXNV6,260,"5800"
D10261,1,3/19/2022,QCJ1YBI71F,300,"5500"
D10261,1,3/21/2022,QCL830O2WC,150,"5350"
D10261,1,3/23/2022,QCN15V02WB,5290,60
D10261,1,3/23/2022,QCCN7650033,60,0
D10261,2,3/26/2022,QCQ8CB8CUA,300,"7500"
D10261,2,3/29/2022,QCT9HG74D7,300,"7200"
D10261,2,3/30/2022,QCU4JIKNSG,300,"6900"
D10261,2,4/2/2022,QD24Q0DRDA,300,"6600"
D10261,2,4/7/2022,QD73ZJNWJP,500,"6100"
D10261,2,4/10/2022,QDA46LSNNI,500,"5600"
D10261,2,4/13/2022,QDD8B3RDGS,500,"5100"
D10261,2,4/17/2022,QDH1JYDTKL,1000,"4100"
D10261,2,4/19/2022,QDJ7N6EUNL,1000,"3100"
D10261,2,4/20/2022,QDK0P4ANL2,1000,"2100"
D10261,2,4/21/2022,QDL5QHY477,2100,0
D10261,3,5/2/2022,QE28CMFCHU,500,"7660"
D10261,3,5/10/2022,QEA3RS32AD,500,"7160"
D10261,3,5/15/2022,QEF2314NOC,500,"6660"
D10261,3,5/24/2022,QEO8K5ZL2A,900,"5760"
D10261,3,5/25/2022,QEP4M17P6I,500,"5260"
D10261,3,5/26/2022,QEQ4NYQ6B4,2000,"3260"
D10261,3,5/27/2022,QER7OZYDVP,3260,0
D10261,4,6/4/2022,QF496VNIY7,300,"7500"
D10261,4,6/13/2022,QFD4OS9RBU,700,"6800"
D10261,4,6/22/2022,QFM47BZJB6,2000,"4800"
D10261,4,6/24/2022,QFO6AHWM9G,4800,0
D10261,5,7/24/2022,QGO91QGPZV,2700,"5460"
D10261,5,7/26/2022,QGQ94NX91J,2000,"3460"
D10261,5,7/28/2022,QGS88TIJ22,2000,"1460"
D10261,5,7/29/2022,QGT1AUH0FT,1460,0
D10261,6,8/11/2022,QHB12CDP4F,200,"7960"
D10261,6,9/7/2022,QI75IYLC91,1850,"6110"
D10261,6,9/8/2022,QI85MNWETZ,600,"5510"
D10261,6,9/12/2022,QIC7TE5937,5510,0
D10261,7,9/28/2022,QIS2ST9AEM,300,"7500"
D10261,7,10/4/2022,QJ4797SXFZ,500,"7000"
D10261,7,10/11/2022,QJB3O3ZYRF,7000,0
D10261,8,11/10/2022,QKA1N31P63,2000,"6160"
D10261,8,11/13/2022,QKD4TPAG22,600,"5560"
D10261,8,11/16/2022,QKG41F2M90,600,"4960"
D10261,8,11/16/2022,QKG92HMCAB,4960,0
D10261,9,15/12/2022,QLF79L1D5D,1900,"6860"
D10261,9,27/12/2022,QLR84DA5G0,1260,"5600"
D10261,9,1/1/2023,RA15HIC1MP,1000,"4600"
D10261,9,1/6/2023,RA67SXXY1D,200,"4400"
D10261,9,1/9/2023,RA92Z3QWJ2,1500,"2900"
D10261,9,1/13/2022,RADOB9172A,2900,0
D10262,1,3/14/2022,QCE5N5QITT,220,"6280"
D10262,1,3/17/2022,QCH8T6J8RO,100,"6180"
D10262,1,3/17/2022,QCH7T6M8HP,100,"6080"
D10262,1,3/17/2022,QCH0T6PKR8,20,"6060"
D10262,1,3/29/2022,QCT0GYEWGS,450,"5610"
D10262,1,4/1/2022,QD10MOAQBC,217,"5393"
D10262,1,4/8/2022,QD801N5H7W,5393,0
D10262,2,5/4/2022,QE47F42MK9,4000,"2450"
D10262,2,5/5/2022,QE59H2JGXH,2450,0
D10263,1,3/19/2022,QCJ9X9X6ZD,3400,"8500"
D10263,1,3/27/2022,QCR4DDK3LE,3250,"5250"
D10263,1,3/30/2022,QCU8IO9R8W,5250,0
D10263,2,4/7/2022,QD71ZY60A1,3300,"8800"
D10263,2,4/15/2022,QDF2GIM42U,3250,"5550"
D10263,2,4/19/2022,QDJ6M6TJKK,5550,0
D10263,3,4/26/2022,QDQ218T4IC,3250,"8950"
D10263,3,5/5/2022,QE51HJPASR,2000,"6950"
D10263,3,5/9/2022,QE99P6DIWF,6150,800
D10263,3,5/9/2022,QE94PJ89I0,800,0
D10263,4,5/16/2022,QEG446W7D2,2250,"10750"
D10263,4,6/5/2022,QF538UZ6U9,9700,"1050"
D10263,4,6/6/2022,QF649N7FPU,1050,0
D10263,5,6/20/2022,QFK22MSVYK,11500,0
D10263,6,7/18/2022,QGI3ODUNHL,13000,0
D10263,7,8/16/2022,QHG5ARW713,1000,"12600"
D10263,7,8/22/2022,QHM8MGYV6E,500,"12100"
D10264,1,3/15/2022,QCF4PGGIEU,6500,"2460"
D10264,1,3/25/2022,QCP393Q15T,2460,0
D10264,1,11/30/2022,QKU7ZNT4CT,100,100
D10264,2,4/8/2022,QD801HU3DQ,600,"9800"
D10264,2,4/9/2022,QD934Z4GIB,600,"9200"
D10264,2,4/13/2022,QDD5AYCGC1,400,"8800"
D10264,2,4/13/2022,QDD6COA816,400,"8400"
D10264,2,4/14/2022,QDE4EGU3IS,300,"8100"
D10264,2,4/15/2022,QDF4GFHA7Y,300,"7800"
D10264,2,4/18/2022,QDI6LJSVKC,300,"7500"
D10264,2,4/20/2022,QDK4OP38OU,300,"7200"
D10264,2,4/21/2022,QDL1R799U9,300,"6900"
D10264,2,4/22/2022,QDM7T0OL67,300,"6600"
D10264,2,4/24/2022,QDO8WK7S06,300,"6300"
D10264,2,4/25/2022,QDP1YLE5GB,300,"6000"
D10264,2,4/26/2022,QDQ81E78FS,300,"5700"
D10264,2,4/27/2022,QDR335BM3J,300,"5400"
D10264,2,4/28/2022,QDS95BAN8H,300,"5100"
D10264,2,4/29/2022,QDT4774YMK,300,"4800"
D10264,2,4/30/2022,QDU88QYS0W,300,"4500"
D10264,2,5/1/2022,QE16ALQYAK,300,"4200"
D10264,2,5/2/2022,QE24C4C9IE,700,"3500"
D10264,2,5/4/2022,QE41F1C4XB,3500,0
D10264,3,5/11/2022,QEB9UD6Q31,300,"8820"
D10264,3,5/12/2022,QEC2WB7LMY,300,"8520"
D10264,3,5/14/2022,QEE11977GL,200,"8320"
D10264,3,5/15/2022,QEF9300Z83,200,"8120"
D10264,3,5/17/2022,QEH25F2KLE,200,"7920"
D10264,3,5/19/2022,QEJ8AF92V6,250,"7670"
D10264,3,5/23/2022,QEN3H1ATO7,7670,0
D10264,4,6/11/2022,QFB6KW3KP6,200,"10150"
D10264,4,6/14/2022,QFE7QQ6E1T,200,"9950"
D10264,4,6/17/2022,QFH7WWLROL,200,"9750"
D10264,4,6/20/2022,QFK83DBYFC,200,"9550"
D10264,4,6/21/2022,QFL15HIXDF,100,"9450"
D10264,4,6/22/2022,QFM07EI34O,150,"9300"
D10264,4,6/25/2022,QFP8DAM0JO,200,"9100"
D10264,4,6/26/2022,QFQ9F1S6CR,200,"8900"
D10264,4,6/27/2022,QFR1H4BBXZ,200,"8700"
D10264,4,6/29/2022,QFT9L4DT7F,150,"8550"
D10264,4,6/30/2022,QFU8LKP4VW,8550,0
D10264,5,7/11/2022,QGB3B79DDF,100,"10780"
D10264,5,7/17/2022,QGH1N6617X,100,"10680"
D10264,5,7/20/2022,QGK2T15WLO,150,"10530"
D10264,5,7/21/2022,QGL5UY96H9,100,"10430"
D10264,5,7/23/2022,QGN0YW0TYG,100,"10330"
D10264,5,7/25/2022,QGP93MENJD,100,"10230"
D10264,5,7/27/2022,QGR67NAV96,100,"10130"
D10264,5,7/30/2022,QGU9DMTT5B,150,"9980"
D10264,5,8/1/2022,QH15HO0847,100,"9880"
D10264,5,8/2/2022,QH24JTLMSU,250,"9630"
D10264,5,8/3/2022,QH35L25VLZ,9150,480
D10264,6,8/7/2022,QH71UL85FH,100,"11580"
D10264,6,8/9/2022,QH93YD7AD1,100,"11480"
D10264,6,8/13/2022,QHD469KTTQ,100,"11380"
D10264,6,8/14/2022,QHE181JIB9,100,"11280"
D10264,6,8/15/2022,QHF39T8RFF,100,"11180"
D10264,6,8/17/2022,QHH7DGYV4T,100,"11080"
D10264,6,8/19/2022,QHJ5H9ZT69,100,"10980"
D10264,6,8/20/2022,QHK2JALOBC,100,"10880"
D10264,6,8/22/2022,QHM3LEBGLZ,100,"10780"
D10264,6,8/22/2022,QHM6MWX1WG,100,"10680"
D10264,6,8/24/2022,QHO1QSRIVV,100,"10580"
D10264,6,8/25/2022,QHP2SONRV4,100,"10480"
D10264,6,8/25/2022,QHP3SOY4LH,100,"10380"
D10264,6,8/27/2022,QHR3WQNLNX,100,"10280"
D10264,6,8/27/2022,QHS9YJ51Q9,100,"10180"
D10264,6,8/29/2022,QHT71LZ9YH,100,"10080"
D10264,6,8/30/2022,QHU93QCVCZ,100,"9980"
D10264,6,8/31/2022,QHV84YK09Q,500,"9480"
D10264,6,8/31/2022,QHV65TUVLK,150,"9330"
D10264,6,9/1/2022,QI137YB7AT,150,"9180"
D10264,6,9/2/2022,QI258JYZ0T,400,"8780"
D10264,6,9/2/2022,QI2391MN4J,130,"8650"
D10264,6,9/4/2022,QI40D8WOWG,700,"7950"
D10264,6,9/5/2022,QI53GBTBFB,900,"7050"
D10264,6,9/6/2022,QI67I2DOJV,500,"6550"
D10264,6,9/7/2022,QI72KJ8Z3C,200,"6350"
D10264,6,9/8/2022,QI85MPKBOD,150,"6200"
D10264,6,9/9/2022,QI93ORLBDH,150,"6050"
D10264,6,9/11/2022,QIB3SUAUY1,150,"5900"
D10264,6,9/13/2022,QID7X1EP0T,150,"5750"
D10264,6,9/15/2022,QIF51EQNK1,400,"5350"
D10264,6,9/18/2022,QII48JE2RY,150,"5200"
D10264,6,9/19/2022,QIJ29SJT8E,450,"4750"
D10264,6,9/20/2022,QIK6CNSJFO,150,"4600"
D10264,6,9/21/2022,QIL7F4MN4T,150,"4450"
D10264,6,9/22/2022,QIM9HCY939,150,"4300"
D10264,6,9/25/2022,QIP1N9A847,200,"4100"
D10264,6,9/26/2022,QIQ2Q55WHW,150,"3950"
D10264,6,9/28/2022,QIS0T74MS0,500,"3450"
D10264,6,9/29/2022,QIT5WOQUY9,150,"3300"
D10264,6,9/30/2022,QIU0Z5GWXO,150,"3150"
D10264,6,10/2/2022,QJ214P5J67,150,"3000"
D10264,6,10/3/2022,QJ3174PMN5,150,"2850"
D10264,6,10/5/2022,QJ55AGS605,150,"2700"
D10264,6,10/6/2022,QJ64DIWDJY,1900,800
D10264,6,10/7/2022,QJ72GDAY2C,100,700
D10264,6,10/9/2022,QJ95KWQRMN,100,600
D10264,6,10/10/2022,QJA4NCA5KY,100,500
D10264,6,10/11/2022,QJB8PNK9YC,100,400
D10264,6,10/13/2022,QJD9U9JZOH,100,300
D10264,6,10/17/2022,QJH629BBZS,300,0
D10264,7,10/17/2022,QJH548ADMD,150,"5650"
D10264,7,10/21/2022,QJL9D30O63,200,"5450"
D10264,7,10/23/2022,QJN6HD12QW,100,"5350"
D10264,7,10/24/2022,QJO7JO32O5,100,"5250"
D10264,7,10/25/2022,QJP0LWD8C4,100,"5150"
D10264,7,10/26/2022,QJQ7O3V8ZL,150,"5000"
D10264,7,10/27/2022,QJR5QF3VAP,100,"4900"
D10264,7,10/28/2022,QJS4SV3FIY,100,"4800"
D10264,7,10/30/2022,QJU1XCLLN1,100,"4700"
D10264,7,10/31/2022,"QJV9ZL,9V5N",4000,700
D10264,7,11/1/2022,QK18ZX9REK,650,50
D10264,7,11/1/2022,QK1115HRYR,50,0
D10264,8,11/3/2022,QK366UU2IA,5600,0
D10264,9,11/21/2022,QKL1EGWJ0F,100,"6400"
D10264,9,11/23/2022,QKN0J8M2R2,100,"6300"
D10264,9,11/24/2022,QKO7LQ58LL,100,"6200"
D10264,9,11/25/2022,QKP8NYX3O6,100,"6100"
D10264,9,11/26/2022,QKQ4QIW35U,100,"6000"
D10264,9,11/27/2022,QKR4SP7GSA,100,"5900"
D10264,9,11/28/2022,QKS4UZD1GO,100,"5800"
D10264,9,12/1/2022,QL1942AHTR,100,"5700"
D10264,9,12/2/2022,QL2576OV1V,100,"5600"
D10264,9,12/3/2022,QL30A97JCI,100,"5500"
D10264,9,12/4/2022,QL40DM49RK,100,"5400"
D10264,9,12/6/2022,QL63JRFOKN,100,"5300"
D10264,9,12/7/2022,QL76MSDE3Q,100,"5200"
D10264,9,12/8/2022,QL89Q1KIOZ,100,"5100"
D10264,9,12/10/2022,QLA2VQCANK,100,"5000"
D10264,9,12/11/2022,QLB9XXGDXL,100,"4900"
D10264,9,12/12/2022,QLC11IYTIB,100,"4800"
D10264,9,12/13/2022,QLD94FG63P,100,"4700"
D10264,9,11/30/2022,QKU7ZNT4CT_D2,100,"4600"
D10264,9,12/15/2022,QLF284OIM6,4600,0
D10264,10,12/16/2022,QLG3CL813N,100,"6350"
D10264,10,12/19/2022,QLJ8KB12IG,100,"6250"
D10264,10,12/20/2022,QLK2MPTX1C,100,"6150"
D10264,10,12/23/2022,QLN7VA5WDV,100,"6050"
D10264,10,12/24/2022,QLO6Y858WE,100,"5950"
D10264,10,12/25/2022,QLP217OWLM,100,"5850"
D10264,10,12/26/2022,QLQ33O6CB7,100,"5750"
D10264,10,12/27/2022,QLQ33O6CB7_D2,100,"5650"
D10264,10,12/28/2022,QLS78C4XEB,100,"5550"
D10264,10,12/30/2022,QLU6CYUO0Q,100,"5450"
D10264,10,1/1/2023,RA10I4E28E,100,"5350"
D10264,10,1/2/2023,RA29K4TD49,150,"5200"
D10264,10,1/3/2023,RA39MSEZMX,150,"5050"
D10264,10,1/5/2023,RA56RN51JQ,150,"4900"
D10264,10,1/6/2023,RA68UBHDQQ,100,"4800"
D10264,10,1/7/2023,RA72WT11LS,100,"4700"
D10264,10,1/8/2023,RA88YS1LE0,100,"4600"
D10264,10,1/10/2023,RAA04XY14E,100,"4500"
D10264,10,1/11/2023,RAB078WA62,100,"4400"
D10264,10,1/12/2023,RAC68CL3LG,4400,0
D10264,11,1/13/2023,RAD6CAI3EO,100,"6400"
D10264,11,1/14/2023,RAE9ETCGQH,100,"6300"
D10264,11,1/15/2023,RAF2GWI470,100,"6200"
D10264,11,1/16/2023,RAG6JNCA0M,100,"6100"
D10264,11,1/20/2023,RAK8RAG7DA,150,"5950"
D10264,11,1/20/2023,RAK5TQGRYD,100,"5850"
D10264,11,1/22/2023,RAM7YLA4KX,100,"5750"
D10264,11,1/24/2023,RAO94SL1ZZ,100,"5650"
D10264,11,1/26/2023,RAQ79SRF67,100,"5550"
D10264,11,1/27/2023,RAR1C78YMN,100,"5450"
D10264,11,1/29/2023,RAT9HBSSIR,100,"5350"
D10264,11,1/30/2023,RAU3JVM8T9,150,"5200"
D10264,11,1/31/2023,RAV3MHR7IR,150,"5050"
D10264,11,2/2/2023,RB27PIKJ2X,150,"4900"
D10264,11,2/3/2023,RB31S7P3OT,150,"4750"
D10264,11,2/5/2023,RB51ZR34HP,250,"4500"
D10264,11,2/6/2023,RB643FUTDE,150,"4350"
D10264,11,2/8/2023,RB897Y4HDJ,150,"4200"
D10264,11,2/9/2023,RB90B9O9PM,100,"4100"
D10264,11,2/10/2023,RBA8CBFGAE,4100,0
D10264,12,2/11/2023,RBB1GG7WTB,100,"4800"
D10264,12,2/14/2023,RBE8O0QYUO,100,"4700"
D10264,12,2/15/2023,RBF1PEY14N,100,"4600"
D10264,12,2/16/2023,RBG0TFQPS2,100,"4500"
D10264,12,2/17/2023,RBH6W4LJO6,100,"4400"
D10264,12,2/18/2023,RBI1YFWYRJ,100,"4300"
D10264,12,2/20/2023,RBK12K9TK1,100,"4200"
D10264,12,2/21/2023,RBL172SFUJ,100,"4100"
D10264,12,2/22/2023,RBM79X4ZUV,100,"4000"
D10264,12,2/23/2023,RBN5CCKW6X,100,"3900"
D10264,12,2/24/2023,RBO1F2SOKR,100,"3800"
D10264,12,2/26/2023,RBQ5IP07FZ,100,"3700"
D10264,12,2/28/2023,RBS2P8U036,100,"3600"
D10264,12,3/2/2023,RC29USP5ZV,100,"3500"
D10264,12,3/3/2023,RC39Y1X4UH,3400,100
D10264,12,3/3/2023,RC35XKIXMJ,100,0
D10264,13,4/25/2023,RDP31LKTJ3,100,"3800"
D10264,13,4/27/2023,RDR27DRX2K,100,"3700"
D10264,13,4/28/2023,RDS7A0QE1B,100,"3600"
D10264,13,5/2/2023,RE24KZ229G,100,"3500"
D10264,13,5/4/2023,RE49QJQBP7,100,"3400"
D10264,13,,,,"3400"
D10264,13,5/6/2023,RE62W8HL5E,100,"3300"
D10264,13,4/8/2023,RE833E7LN5,100,"3200"
D10264,13,5/11/2023,REB5BVIPCX,100,"3100"
D10264,13,5/12/2023,REC4EKPV9A,100,"3000"
D10264,13,5/13/2023,RED2HR0NPA,50,"2950"
D10264,13,5/15/2023,REF7MNVXRL,50,"2900"
D10264,13,5/17/2023,REH9SNEGDP,100,"2800"
D10264,13,5/18/2023,REI4VIHHOC,100,"2700"
D10264,13,5/19/2023,REJ0XY4ME8,100,"2600"
D10264,13,5/20/2023,REK121PJNB,100,"2500"
D10264,13,5/21/2023,REL44PUEMO,50,"2450"
D10264,13,5/22/2023,REM17A6QUR,100,"2350"
D10264,13,5/23/2023,REN3A100AR,100,"2250"
D10264,13,5/24/2023,REO7BBYTTD,2250,0
D10264,14,18-06-2023 22:03:53,RFI8EG70JC,100,"5100"
D10264,14,16-06-2023 20:53:02,RFG38QTG31,100,"5000"
D10264,14,15-06-2023 21:13:30,RFF55W2Y0H,100,"4900"
D10264,14,14-06-2023 21:26:08,RFE8329IYC,100,"4800"
D10264,14,13-06-2023 22:41:09,RFD1ZEORI3,100,"4700"
D10264,14,12/6/23 22:46,RFC5WL6KP1,100,"4600"
D10264,14,11/6/23 20:19,RFB6TE7Y3E,100,"4500"
D10264,14,9/6/23 21:33,RF99NVJPJR,100,"4400"
D10264,14,8/6/23 22:43,RF84L074IY,100,"4300"
D10264,14,7/6/23 20:12,RF79HMV89R,100,"4200"
D10264,14,6/6/23 22:01,RF64F1BTIU,100,"4100"
D10264,14,5/6/23 20:56,RF59BWNVV1,100,"4000"
D10264,14,3/6/23 21:22,RF336A3MOD,100,"3900"
D10264,14,2/6/23 21:35,RF283AERFO,50,"3850"
D10264,14,1/6/23 21:54,RF16ZCNPVU,100,"3750"
D10264,14,31-05-2023 20:54:05,REV2WABNO2,100,"3650"
D10264,14,29-05-2023 22:09:04,RET4QS0W9E,100,"3550"
D10264,14,27-05-2023 21:52:09,RER0LDCUSQ,50,"3500"
D10264,14,25-05-2023 22:31:03,REP8FOOLK4,50,"3450"
D10264,14,24-05-2023 21:21:43,REO9CRX25Z,100,"3350"
D10264,14,19-06-2023,RFJ6GZ37JG,100,"3250"
D10264,14,20-06-2023,RFK2K3EZGE,100,"3150"
D10264,14,6/22/2023,RFM1PTWZU5,100,"3050"
D10264,14,6/23/2023,RFN6QRYU90,3050,0
D10264,15,6/28/2023,RFS781C1FZ,100,"3410"
D10264,15,6/29/2023,RFT8B03Y64,100,"3310"
D10264,15,7/1/2023,RG16H1WB1O,100,"3210"
D10264,15,7/2/2023,RG28JP2H4G,100,"3110"
D10264,15,7/3/2023,RG40PWJD9W,100,"3010"
D10264,15,7/6/2023,RG68VX2QAQ,50,"2960"
D10264,15,7/8/2023,RG882RUZR2,100,"2860"
D10264,15,7/9/2023,RG9355U2I3,100,"2760"
D10264,15,7/11/2023,RGB3BBHK9Z,100,"2660"
D10264,15,7/12/2023,RGC3E4K0RD,100,"2560"
D10264,15,7/13/2023,RGD1GTE60B,100,"2460"
D10264,15,7/14/2023,RGE5ITXG9Z,2460,0
D10264,16,29-07-2023 21:48:15,RGT3RC5THX,50,"6000"
D10264,16,28-07-2023 21:13:41,RGS4O9YAES,100,"5900"
D10264,16,27-07-2023 22:45:15,RGR2LJ24Q0,50,"5850"
D10264,16,24-07-2023 22:18:14,RGO2CUUE4M,100,"5750"
D10264,16,23-07-2023 22:40:17,RGN2A2TJ84,50,"5700"
D10264,16,22-07-2023 22:01:59,RGM57F8EZB,50,"5650"
D10264,16,20-07-2023 23:04:29,RGK61T2ZNG,50,"5600"
D10264,16,19-07-2023 22:28:25,RGJ0Y1VUI6,100,"5500"
D10264,16,18-07-2023 21:38:50,RGI6VCLM78,50,"5450"
D10264,16,17-07-2023 20:39:47,RGH2S9U8PM,50,"5400"
D10264,16,16-07-2023 21:29:34,RGG5PIL1GT,100,"5300"
D10264,16,8/1/2023,RH11ZXLCBT,50,"5250"
D10264,16,8/3/2023,RH346Q4NG4,100,"5150"
D10264,16,8/4/2023,RH4180SKHN,5100,50
D10264,16,8/4/2023,RH48861Z2Q,50,0
D10264,17,7/8/23 22:02,RH77J0X8KR,50,"10350"
D10264,17,6/8/23 21:59,RH63FZFUNF,100,"10250"
D10264,17,5/8/23 23:27,RH55DB2ZOP,100,"10150"
D10264,17,4/8/23 23:16,RH41A6MEZ9,100,"10050"
D10264,17,10/8/23 22:59,RHA3S8AIJ5,50,"10000"
D10264,17,8/8/23 22:14,RH89M38763,50,"9950"
D10264,17,14-08-2023 22:38:22,RHE55488O1,100,"9850"
D10264,17,13-08-2023 21:00:52,RHD41XQ8Z6,100,"9750"
D10264,17,11/8/23 22:00,RHB2V92WPS,50,"9700"
D10264,17,8/17/2023,RHH2DX2X5Q,50,"9650"
D10264,17,8/21/2023,RHL2PJU8Z0,100,"9550"
D10264,17,8/23/2023,RHN1VE8QZ7,100,"9450"
D10264,17,8/24/2023,RHO4YHLMOQ,100,"9350"
D10265,1,3/23/2022,QCN15EENNH,500,"6000"
D10265,1,3/23/2022,QCN95EIIRH,500,"5500"
D10265,1,4/3/2022,QD35RT8WZT,2700,"2800"
D10265,1,4/3/2022,QD34RTHL32,500,"2300"
D10265,1,4/5/2022,QD50UYLTQ0,2300,0
D10265,2,4/23/2022,QDN4UWYYCW,3500,"3000"
D10265,2,5/5/2022,QE59HCWGKH,3000,0
D10265,3,5/31/2022,QEV8WN7IKI,6500,0
D10265,4,7/1/2022,QG18O39AF2,600,"6200"
D10265,4,7/1/2022,QG10O3FI4G,500,"5700"
D10265,4,7/1/2022,QG13O4FGZJ,500,"5200"
D10265,4,7/1/2022,QG18O8N8XC,5400,200
D10266,1,3/23/2022,QCN66OFGC8,2600,"7800"
D10266,1,4/3/2022,QD32RUXKN4,2600,"5200"
D10266,1,4/13/2022,QDD1AY6VL9,3200,"2000"
D10266,1,4/13/2022,QDD3BIWS3L,2000,0
D10266,2,5/5/2022,QE55IHL9QJ,10400,0
D10266,3,6/8/2022,QF83EZMR6J,9000,"1400"
D10266,3,6/9/2022,QF94F883M8,1400,0
D10266,4,7/6/2022,QG64Z21FPQ,10400,0
D10266,5,8/3/2022,QH31LC8T2T,10400,0
D10266,6,9/7/2022,QI77J3HR1Z,2000,"10640"
D10266,6,9/19/2022,QIJ89Y9QQY,100,"10540"
D10266,6,9/19/2022,QIJ89YDPES,100,"10440"
D10266,6,10/3/2022,QJ306D3BOI,2000,"8440"
D10266,6,11/3/2022,QK375PU7ZP,2000,"6440"
D10267,1,3/24/2022,QCO68K2TMA,1250,"11750"
D10267,1,3/24/2022,QCO68KGUT8,1000,"10750"
D10267,1,3/25/2022,QCP39GN4KB,500,"10250"
D10267,1,3/25/2022,QCP49HXV9A,500,"9750"
D10267,1,3/25/2022,QCP29MMXVU,500,"9250"
D10267,1,4/1/2022,QD12O1BWXQ,1250,"8000"
D10267,1,4/2/2022,QD27Q1BIXD,500,"7500"
D10267,1,4/11/2022,QDB375C4WN,3000,"4500"
D10267,1,4/12/2022,QDC5989Z1N,2000,"2500"
D10267,1,4/12/2022,QDC6A2NGQO,2500,0
D10267,2,5/10/2022,QEA8R23FW4,1600,"11400"
D10267,2,5/10/2022,QEA9R27O3V,1100,"10300"
D10267,2,5/10/2022,QEA3R5VI75,500,"9800"
D10267,2,5/10/2022,QEA7R6382V,1900,"7900"
D10267,2,5/10/2022,QEA9R677NJ,5000,"2900"
D10267,2,5/10/2022,QEA1R70HJB,2900,0
D10267,3,6/6/2022,QF6495I7O6,850,"12750"
D10267,3,6/6/2022,QF6495L720,350,"12400"
D10267,3,6/7/2022,QF76C082SQ,1000,"11400"
D10267,3,6/8/2022,QF81D9PX8D,3000,"8400"
D10267,3,6/8/2022,QF89DEEY59,1500,"6900"
D10267,3,6/8/2022,QF86E0CEDS,2400,"4500"
D10267,3,6/9/2022,QF97G1LC07,750,"3750"
D10267,3,6/9/2022,QF97G1PZUP,750,"3000"
D10267,3,6/9/2022,QF97G2BRQ5,1100,"1900"
D10267,3,6/9/2022,QF95G2NMDT,450,"1450"
D10267,3,6/9/2022,QF94G48HYU,1000,450
D10267,3,6/9/2022,QF92G4T8FU,450,0
D10267,4,6/16/2022,QFG5U9ZGLJ,500,"13100"
D10267,4,7/4/2022,QG45UQ1Y8V,1500,"11600"
D10267,4,7/8/2022,QG804GLRBG,3000,"8600"
D10267,4,7/8/2022,QG884KN8Y4,3000,"5600"
D10267,4,7/11/2022,QGB1A3D9OH,2800,"2800"
D10267,4,7/14/2022,QGE3GSQ4VX,1000,"1800"
D10267,4,7/14/2022,QGE9H2QM0R,1800,0
D10268,1,4/12/2022,QDC19GD4OF,12800,0
D10268,2,5/6/2022,QE69J3902L,12500,0
D10268,3,6/3/2022,QF313C2RFR,12900,0
D10268,4,6/27/2022,QFR9FIY8T5,12600,0
D10268,5,7/25/2022,QGP12A487Z,19500,0
D10268,6,8/20/2022,QHK2JC6R4E,19050,0
D10268,7,10/6/2022,QJ68CHYRVC,5000,"10800"
D10268,7,10/12/2022,QJC6RWWMBC,1500,"9300"
D10268,7,11/2/2022,QK254MIHDV,300,"9000"
D10269,1,3/24/2022,QCO68B4AYO,1950,"5850"
D10269,1,4/4/2022,QD42SAHZSO,1950,"3900"
D10269,1,4/14/2022,QDE1E75TE7,3900,0
D10270,1,3/30/2022,QCU8JPQDC8,100,"10780"
D10270,1,4/3/2022,QD37RX8ZKJ,1000,"9780"
D10270,1,4/5/2022,QD52UE2FPQ,500,"9280"
D10270,1,4/19/2022,QDJ5MJ6S2N,3000,"6280"
D10270,1,4/19/2022,QDJ8MNL282,1000,"5280"
D10270,1,4/19/2022,QDJ1MQ3MCL,470,"4810"
D10270,1,4/22/2022,QDM5SMDL97,4810,0
D10271,1,3/26/2022,QCQ5B04IC5,2250,"7190"
D10271,1,4/2/2022,QD24OKPC6M,2600,"4590"
D10271,1,4/4/2022,QD49SOYJOF,4550,40
D10271,1,4/4/2022,QD41SYACDT,40,0
D10271,2,4/16/2022,QDG7H5NQSD,2600,"6760"
D10271,2,4/19/2022,QDJ2MKFPIW,6600,160
D10271,2,4/19/2022,QDJ2MNNEDW,160,0
D10271,3,5/10/2022,QEA9R0LFE7,9920,0
D10271,4,5/23/2022,QEN5GXLQDV,11500,0
D10271,5,6/22/2022,QFM96FZ2GP,1500,"14300"
D10271,5,8/4/2022,QH40OE6128,500,"13800"
D10272,1,24/03/2022,QCO4721WWA,80,"5060"
D10272,1,24/03/2022,QCO171YZLX,100,"4960"
D10272,1,23/03/2022,QCN25202EO,80,"4880"
D10272,1,23/03/2022,QCN451XD5M,100,"4780"
D10272,1,22/03/2022,QCM236QBQU,80,"4700"
D10272,1,22/03/2022,QCM036NIRS,100,"4600"
D10272,1,21/03/2022,QCL01C09V2,80,"4520"
D10272,1,20/03/2022,QCK616ZRCA,100,"4420"
D10272,1,19/03/2022,QCJ2YH9B9M,180,"4240"
D10272,1,3/28/2022,QCS2EANUSM,540,"3700"
D10272,1,4/8/2022,QD8823VYTO,500,"3200"
D10272,1,4/11/2022,QDB884AG28,3200,0
D10272,2,4/26/2022,QDQ3YU3GUP,100,"4900"
D10272,2,4/26/2022,QDQ7YU8HKN,50,"4850"
D10272,2,4/28/2022,QDS44NJJA4,70,"4780"
D10272,2,5/5/2022,QE56HPAPS6,4780,0
D10272,3,5/9/2022,QE91Q7OGNZ,100,"5060"
D10272,3,6/2/2022,QF291AQMGJ,560,"4500"
D10272,3,6/2/2022,QF201B7Y5C,4500,0
D10272,4,7/1/2022,QG13NM0L89,5200,0
D10272,5,7/4/2022,QG42VLT07Y,100,"6300"
D10272,5,7/18/2022,QGI3NC4EL9,100,"6200"
D10272,5,7/18/2022,QGI4NES5ZY,100,"6100"
D10272,5,7/18/2022,QGI7NEXGHJ,100,"6000"
D10272,5,7/18/2022,QGI4NF18AW,100,"5900"
D10272,5,7/20/2022,QGK2R8WDPW,100,"5800"
D10272,5,7/21/2022,QGL3T7V5ZL,100,"5700"
D10272,5,7/28/2022,QGS18FOM7P,5700,0
D10272,6,8/25/2022,QHP0RG86CG,6450,0
D10272,7,9/26/2022,QIQ1O7KJSD,100,"7800"
D10272,7,9/26/2022,QIQ4O7NY9W,100,"7700"
D10272,7,9/28/2022,QIS2SSGREO,100,"7600"
D10272,7,10/3/2022,QJ38597LTM,100,"7500"
D10272,7,10/11/2022,QJB5NTF643,100,"7400"
D10272,7,10/11/2022,QJB7NTMZ2B,100,"7300"
D10272,7,7/5/2023,RG55Q5IPLZ,50,"7250"
D10272,7,7/8/2023,RG89ZFPYQT,50,"7200"
D10273,1,3/24/2022,QCO972320Z,1500,"3700"
D10273,1,4/10/2022,QDA76EL77H,1100,"2600"
D10273,1,4/12/2022,QDC199LIL3,1300,"1300"
D10273,1,4/16/2022,QDG7HI9BNJ,1300,0
D10273,2,4/25/2022,QDP4WTHJSY,1500,"3500"
D10273,2,5/1/2022,QE16ASUOMC,1100,"2400"
D10273,2,5/9/2022,QE98Q96R78,1300,"1100"
D10273,2,5/12/2022,QEC1VFEJ8T,1100,0
D10273,3,5/29/2022,QES3S2Y77P,1300,"3900"
D10273,3,6/5/2022,QF598S4F27,1300,"2600"
D10273,3,6/9/2022,QF93FM0RTF,1300,"1300"
D10273,3,6/10/2022,QFA3HV5THJ,1300,0
D10273,4,6/19/2022,QFJ01KF1IU,1300,"3800"
D10273,4,7/4/2022,QG43U61DTJ,2600,"1200"
D10273,4,7/6/2022,QG68YCQF7O,1200,0
D10273,5,7/17/2022,QGH6N1P6LA,1400,"3800"
D10273,5,8/2/2022,QH24IB6U5Y,3800,0
D10273,6,8/29/2022,QHT4ZUDLXIM,5160,0
D10273,7,9/26/2022,QIQ1P6J8VR,5200,0
D10273,8,10/25/2022,QJP8KVFPWK,5200,240
D10273,8,10/26/2022,QJQ7MYFTI9,240,0
D10273,9,11/23/2022,QKN1I5FYW7,5200,0
D10273,10,12/21/2022,QLL6OQBNBG,5200,0
D10273,11,1/21/2022,RAL5URPVKH,5440,0
D10273,12,2/18/2023,RBI6X0E7GQ,700,"4740"
D10273,12,2/22/2023,,4800,60
D10273,13,3/6/2023,RC6952I7ZH,500,"5820"
D10274,1,4/3/2022,QD37R4XN0P,1500,"12100"
D10274,1,4/13/2022,QDD4ASRMDY,1000,"11100"
D10274,1,4/15/2022,QDF2EODUME,500,"10600"
D10274,1,4/18/2022,QDI5JZYQDN,1300,"9300"
D10274,1,4/18/2022,QDI6KYATY4,5600,"3700"
D10274,1,4/18/2022,QDI8LP9DN2,4600,900
D10274,2,5/13/2022,QED8XCWGY6,13000,0
D10275,1,3/25/2022,QCP2A2CH92,217,"5883"
D10275,1,3/26/2022,QCQ7C06IDD,217,"5666"
D10275,1,3/27/2022,QCR7DXNKHL,217,"5449"
D10275,1,3/28/2022,QCS7FRUMXZ,217,"5232"
D10275,1,3/29/2022,QCT3HPU5NX,217,"5015"
D10275,1,3/30/2022,QCU1JNC89Z,217,"4798"
D10275,1,3/31/2022,QCV5LONDHR,217,"4581"
D10275,1,4/1/2022,QD10NSMSNG,217,"4364"
D10275,1,4/2/2022,QD23PXDKJN,100,"4264"
D10275,1,4/2/2022,QD27PXGIUZ,100,"4164"
D10275,1,4/2/2022,QD29PXKGMD,17,"4147"
D10275,1,4/3/2022,QD33RSMY9N,100,"4047"
D10275,1,4/3/2022,QD37RSQ3YT,100,"3947"
D10275,1,4/3/2022,QD35RSSOR1,17,"3930"
D10275,1,4/4/2022,QD46TPLRUO,100,"3830"
D10275,1,4/4/2022,QD47TQ9FWL,100,"3730"
D10275,1,4/4/2022,QD46TQFYRK,17,"3713"
D10275,1,4/5/2022,QD53VR75E9,100,"3613"
D10275,1,4/5/2022,QD53VRAXWZ,100,"3513"
D10275,1,4/5/2022,QD51VRGN2H,17,"3496"
D10275,1,4/6/2022,QD69XUDTBN,100,"3396"
D10275,1,4/6/2022,QD66XUIBLI,100,"3296"
D10275,1,4/6/2022,QD60XUO8L4,17,"3279"
D10275,1,4/7/2022,QD7610PKO6,100,"3179"
D10275,1,4/7/2022,QD7110S359,17,"3162"
D10275,1,4/7/2022,QD7010UY78,100,"3062"
D10275,1,4/8/2022,QD862VWSAI,100,"2962"
D10275,1,4/8/2022,QD842X5LM6,100,"2862"
D10275,1,4/8/2022,QD812X8R3N,17,"2845"
D10275,1,4/10/2022,QDA36LPVAF,100,"2745"
D10275,1,4/10/2022,QDA16LWH6J,100,"2645"
D10275,1,4/10/2022,QDA66MDBNQ,17,"2628"
D10275,1,4/9/2022,QD973BGSU9,100,"2528"
D10275,1,4/9/2022,QD953BJDG3,100,"2428"
D10275,1,4/9/2022,QD933BO3UR,17,"2411"
D10275,1,4/11/2022,QDB08QIPLM,100,"2311"
D10275,1,4/11/2022,QDB78QM8ET,100,"2211"
D10275,1,4/11/2022,QDB98QRWBF,17,"2194"
D10275,1,4/12/2022,QDC3ALF01V,100,"2094"
D10275,1,4/12/2022,QDC3ALMDEN,100,"1994"
D10275,1,4/12/2022,QDC7ALSJRRQD,17,"1977"
D10275,1,4/13/2022,QDD3B4TFOP,2000,23
D10275,2,4/14/2022,QDE9EFADM5,100,"6200"
D10275,2,4/14/2022,QDE4EFF0WS,100,"6100"
D10275,2,4/14/2022,QDE3EFJE6Z,17,"6083"
D10275,2,4/15/2022,QDF0G8HJ9Q,100,"5983"
D10275,2,4/15/2022,QDF3G8L61V,100,"5883"
D10275,2,4/15/2022,QDF5G93MJ1,17,"5866"
D10275,2,4/16/2022,QDG2I7FZ2U,100,"5766"
D10275,2,4/16/2022,QDG2I7MJ5Q,100,"5666"
D10275,2,4/16/2022,QDG5I7PGIB,17,"5649"
D10275,2,4/17/2022,QDH7JVYLYX,100,"5549"
D10275,2,4/17/2022,QDH3JW27A3,100,"5449"
D10275,2,4/17/2022,QDH9JW4I0V,17,"5432"
D10275,2,4/18/2022,QDI7LLT6JB,100,"5332"
D10275,2,4/18/2022,QDI6LLVJEU,100,"5232"
D10275,2,4/18/2022,QDI3LLYKNJ,17,"5215"
D10275,2,4/19/2022,QDJ2NFX6F0,100,"5115"
D10275,2,4/19/2022,QDJ3NFZC71,100,"5015"
D10275,2,4/19/2022,QDJ1NG22CB,17,"4998"
D10275,2,4/21/2022,QDL9PIC1LH,100,"4898"
D10275,2,4/21/2022,QDL8PIE22W,100,"4798"
D10275,2,4/21/2022,QDL5PIG0NX,17,"4781"
D10275,2,4/21/2022,QDL4R6TEOO,100,"4681"
D10275,2,4/21/2022,QDL1R6WXEJ,100,"4581"
D10275,2,4/21/2022,QDL2R6Y08W,17,"4564"
D10275,2,4/23/2022,QDN6UW85BK,100,"4464"
D10275,2,4/23/2022,QDN2UWAELK,100,"4364"
D10275,2,4/23/2022,QDN0UWEZT0,17,"4347"
D10275,2,4/24/2022,QDO5WPI9VZ,100,"4247"
D10275,2,4/24/2022,QDO8WPJ5M0,100,"4147"
D10275,2,4/24/2022,QDO5WPKKVH,17,"4130"
D10275,2,4/25/2022,QDP4YJ9FIY,100,"4030"
D10275,2,4/25/2022,QDP7YJBSFP,100,"3930"
D10275,2,4/25/2022,QDP5YJDOFF,17,"3913"
D10275,2,4/27/2022,QDR93CI6KP,434,"3479"
D10275,2,4/30/2022,QDU88TLM5I,100,"3379"
D10275,2,4/30/2022,QDU38TPGB9,100,"3279"
D10275,2,4/30/2022,QDU98TUNPT,100,"3179"
D10275,2,4/30/2022,QDU08TZCPQ,100,"3079"
D10275,2,4/30/2022,QDU38U3MX7,34,"3045"
D10275,2,5/1/2022,QE13AUD5QT,100,"2945"
D10275,2,5/1/2022,QE11AUGX4N,100,"2845"
D10275,2,5/1/2022,QE13AUKYWH,17,"2828"
D10275,2,5/1/2022,QE11APPIPN,100,"2728"
D10275,2,5/1/2022,QE17APPYAN,17,"2711"
D10275,2,5/1/2022,QE13APVY49,100,"2611"
D10275,2,5/4/2022,QE40GIBJ7O,100,"2511"
D10275,2,5/4/2022,QE45GIDKLH,100,"2411"
D10275,2,5/4/2022,QE45GIG52N,100,"2311"
D10275,2,5/4/2022,QE46GIISBU,100,"2211"
D10275,2,5/4/2022,QE43GITCRV,100,"2111"
D10275,2,5/4/2022,QE47GIV9SP,100,"2011"
D10275,2,5/5/2022,QE56GO6X48,51,"1960"
D10275,2,5/5/2022,QE56IFLZ7K,1960,0
D10275,3,5/7/2022,QE75MKA1F7,100,"6400"
D10275,3,5/7/2022,QE76MKD15K,100,"6300"
D10275,3,5/7/2022,QE75MKI663,17,"6283"
D10275,3,5/11/2022,QEB7TZI8ON,434,"5849"
D10275,3,5/14/2022,QEE5ZYD03P,100,"5749"
D10275,3,5/14/2022,QEE1ZZJPHZ,100,"5649"
D10275,3,5/14/2022,QEE4ZZV9RW,17,"5632"
D10275,3,5/14/2022,QEE81909AY,100,"5532"
D10275,3,5/14/2022,QEE81909AY_D2,100,"5432"
D10275,3,5/14/2022,QEE919853X,17,"5415"
D10275,3,5/15/2022,QEF22VQO22,100,"5315"
D10275,3,5/16/2022,QEG2361ACK,100,"5215"
D10275,3,5/16/2022,QEG8361DNM,17,"5198"
D10275,3,5/16/2022,QEG74XGIJ7,100,"5098"
D10275,3,5/16/2022,QEG84XN5I0,100,"4998"
D10275,3,5/16/2022,QEG74XQM75,17,"4981"
D10275,3,5/18/2022,QEI58Q72IT,100,"4881"
D10275,3,5/18/2022,QEI78Q8TUL,100,"4781"
D10275,3,5/18/2022,QEI98QAAZ5,100,"4681"
D10275,3,5/18/2022,QEI88QB8OQ,100,"4581"
D10275,3,5/18/2022,QEI88QDEP2,34,"4547"
D10275,3,5/22/2022,QEM3EQ74LB,100,"4447"
D10275,3,5/22/2022,QEM7EQ8E87,100,"4347"
D10275,3,5/22/2022,QEM3EQANIH,100,"4247"
D10275,3,5/22/2022,QEM8EQDWBC,100,"4147"
D10275,3,5/22/2022,QEM7EQFZ9D,100,"4047"
D10275,3,5/22/2022,QEM5EQKA3H,100,"3947"
D10275,3,5/25/2022,QEP2M04JLG,868,"3079"
D10275,3,5/27/2022,QER2Q0PXNU,434,"2645"
D10275,3,5/29/2022,QET0TTXPLS,100,"2545"
D10275,3,5/29/2022,QET4TU1KJU,100,"2445"
D10275,3,5/29/2022,QET2TU54ZE,100,"2345"
D10275,3,5/29/2022,QET7TU8PRX,100,"2245"
D10275,3,5/29/2022,QET9TUBZOP,34,"2211"
D10275,3,6/3/2022,QF364T4C7A,2150,61
D10275,3,6/4/2022,QF405TU8QM,65,4
D10275,4,6/5/2022,QF518QAILN,100,"6400"
D10275,4,6/5/2022,QF518QFSNV,100,"6300"
D10275,4,6/5/2022,QF558QK3Y9,17,"6283"
D10275,4,6/9/2022,QF92GVL1C6,434,"5849"
D10275,4,6/13/2022,QFD8OOZ4QK,434,"5415"
D10275,4,6/17/2022,QFH4WPB7ZO,220,"5195"
D10275,4,6/21/2022,QFL75G8YNB,100,"5095"
D10275,4,6/21/2022,QFL25GD32S,100,"4995"
D10275,4,6/21/2022,QFL45GGSA4,17,"4978"
D10275,4,6/23/2022,QFN99A5KPP,434,"4544"
D10275,4,6/24/2022,QFO4BDS3VI,100,"4444"
D10275,4,6/24/2022,QFO4BE1VWK,100,"4344"
D10275,4,6/24/2022,QFO8BE500S,17,"4327"
D10275,4,6/30/2022,QFU0N5GQ5K,1000,"3327"
D10275,4,6/30/2022,QFU8N5KVJA,70,"3257"
D10275,4,7/1/2022,QG13PG6RVN,100,"3157"
D10275,4,7/1/2022,QG12PG8WE2,100,"3057"
D10275,4,7/1/2022,QG16PGC1KM,17,"3040"
D10275,4,7/2/2022,QG20QOX782,1000,"2040"
D10275,4,7/3/2022,QG39RZ190R,2040,0
D10275,5,7/5/2022,QG51XN9AKL,100,"6400"
D10275,5,7/5/2022,QG52XNE0QQ,100,"6300"
D10275,5,7/5/2022,QG59XNHELB,17,"6283"
D10275,5,7/6/2022,QG63ZXR2GP,100,"6183"
D10275,5,7/6/2022,QG68ZXSLTW,100,"6083"
D10275,5,7/6/2022,QG61ZXU3AF,17,"6066"
D10275,5,7/7/2022,QG7232BH0O,100,"5966"
D10275,5,7/7/2022,QG7832ER9I,100,"5866"
D10275,5,7/7/2022,QG7232H1F4,17,"5849"
D10275,5,7/8/2022,QG88577JSC,100,"5749"
D10275,5,7/8/2022,QG8157A487,100,"5649"
D10275,5,7/8/2022,QG8657CESU,17,"5632"
D10275,5,7/9/2022,QG927C6F4I,100,"5532"
D10275,5,7/9/2022,QG937C880X,100,"5432"
D10275,5,7/9/2022,QG977CA6V1,17,"5415"
D10275,5,7/10/2022,QGA494T0TS,100,"5315"
D10275,5,7/10/2022,QGA994WQ1H,100,"5215"
D10275,5,7/10/2022,QGA89506FS,17,"5198"
D10275,5,7/11/2022,QGB0B45FUA,217,"4981"
D10275,5,7/12/2022,QGC0D5YOEK,100,"4881"
D10275,5,7/12/2022,QGC4D61X3S,100,"4781"
D10275,5,7/12/2022,QGC5D68BHF,17,"4764"
D10275,5,7/13/2022,QGD3F6ANDL,100,"4664"
D10275,5,7/13/2022,QGD0F6CFMK,17,"4647"
D10275,5,7/13/2022,QGD6F6HULW,100,"4547"
D10275,5,7/14/2022,QGE8H4FFUM,100,"4447"
D10275,5,7/14/2022,QGE5H4KLTJ,100,"4347"
D10275,5,7/14/2022,QGE0H4PHQG,17,"4330"
D10275,5,7/15/2022,QGF2J84394,100,"4230"
D10275,5,7/15/2022,QGF7J84O93,17,"4213"
D10275,5,7/15/2022,QGF4J8A1T2,100,"4113"
D10275,5,7/16/2022,QGG9LAFOSB,100,"4013"
D10275,5,7/16/2022,QGG5LAGFUD,17,"3996"
D10275,5,7/16/2022,QGG7LAJP61,100,"3896"
D10275,5,7/17/2022,QGH4MXBWN8,100,"3796"
D10275,5,7/17/2022,QGH5MX5V1X,100,"3696"
D10275,5,7/17/2022,QGH9MX6CEH,17,"3679"
D10275,5,7/18/2022,QGI5P3A705,100,"3579"
D10275,5,7/18/2022,QGI7P3B0NZ,17,"3562"
D10275,5,7/18/2022,QGI5P3DX9H,100,"3462"
D10275,5,7/21/2022,QGL5UVA4UF,100,"3362"
D10275,5,7/21/2022,QGL4UVBGRO,17,"3345"
D10275,5,7/21/2022,QGL2UVJ26E,100,"3245"
D10275,5,7/22/2022,QGM8WSQHKA,100,"3145"
D10275,5,7/22/2022,QGM5WSUWPN,100,"3045"
D10275,5,7/22/2022,QGM2WSYI96,100,"2945"
D10275,5,7/22/2022,QGM3WT54CB,100,"2845"
D10275,5,7/22/2022,QGM3WTADRH,34,"2811"
D10275,5,7/24/2022,QGO31LR76B,100,"2711"
D10275,5,7/24/2022,QGO91LV3YT,100,"2611"
D10275,5,7/24/2022,QGO41LY6T8,17,"2594"
D10275,5,7/24/2022,QGO61M21LY,100,"2494"
D10275,5,7/24/2022,QGO91M5BFP,100,"2394"
D10275,5,7/24/2022,QGO01MIDBU,17,"2377"
D10275,5,7/25/2022,QGP43KO476,100,"2277"
D10275,5,7/25/2022,QGP53KU9ZN,100,"2177"
D10275,5,7/25/2022,QGP83KY6FK,17,"2160"
D10275,5,7/26/2022,QGQ35OVZ35,100,"2060"
D10275,5,7/26/2022,QGQ45OYSX0,100,"1960"
D10275,5,7/26/2022,QGQ25P0LDI,17,"1943"
D10275,5,7/29/2022,QGT8BC458I,1943,0
D10275,6,8/1/2022,QH11HUEPKZ,100,"6400"
D10275,6,8/1/2022,QH18HUNO0Y,100,"6300"
D10275,6,8/1/2022,QH14HURCP8,100,"6200"
D10275,6,8/2/2022,QH24K48UNE,100,"6100"
D10275,6,8/2/2022,QH27K49OAZ,100,"6000"
D10275,6,8/2/2022,QH20K4B30M,100,"5900"
D10275,6,8/3/2022,QH34MA1XV2,100,"5800"
D10275,6,8/3/2022,QH38MA318E,100,"5700"
D10275,6,8/3/2022,QH32MA3RNC,100,"5600"
D10275,6,8/4/2022,QH42OB6V3M,100,"5500"
D10275,6,8/4/2022,QH47OBC4HJ,100,"5400"
D10275,6,8/4/2022,QH43OBF6BV,17,"5383"
D10275,6,8/5/2022,QH54QDLTC8,100,"5283"
D10275,6,8/5/2022,QH58QDQ5A8,100,"5183"
D10275,6,8/5/2022,QH57QDVBFL,100,"5083"
D10275,6,8/6/2022,QH64SO9OK4,100,"4983"
D10275,6,8/6/2022,QH62SOD3DG,100,"4883"
D10275,6,8/6/2022,QH60SOFV0M,100,"4783"
D10275,6,8/7/2022,QH70ULM2Y6,100,"4683"
D10275,6,8/7/2022,QH73ULOUXP,100,"4583"
D10275,6,8/7/2022,QH72ULR518,100,"4483"
D10275,6,8/9/2022,QH99X0Q2PD,100,"4383"
D10275,6,8/9/2022,QH94X14B0A,100,"4283"
D10275,6,8/9/2022,QH96X0V0PC,100,"4183"
D10275,6,8/9/2022,QH91Y91BBZ,100,"4083"
D10275,6,8/9/2022,QH94Y93HBA,50,"4033"
D10275,6,8/9/2022,QH93Y95T6P,50,"3983"
D10275,6,8/9/2022,QH92Y96YW2,100,"3883"
D10275,6,8/11/2022,QHB52NT5N3,100,"3783"
D10275,6,8/11/2022,QHB92O1OJ9,100,"3683"
D10275,6,8/11/2022,QHB72O4YI5,100,"3583"
D10275,6,8/11/2022,QHB62OOEFC,100,"3483"
D10275,6,8/11/2022,QHB82OQQDM,100,"3383"
D10275,6,8/13/2022,QHD76JDT5Z,600,"2783"
D10275,6,8/16/2022,QHG4BMIWC4,100,"2683"
D10275,6,8/16/2022,QHG2BMKYXM,100,"2583"
D10275,6,8/16/2022,QHG6BMMXBM,100,"2483"
D10275,6,8/16/2022,QHG0BN6Y8I,100,"2383"
D10275,6,8/16/2022,QHG7BN7Y2P,100,"2283"
D10275,6,8/16/2022,QHG9BN9ERF,1234,"1049"
D10275,6,8/21/2022,QHL2L36566,100,949
D10275,6,8/21/2022,QHL0L3BDMU,100,849
D10275,6,8/21/2022,QHL8L3DFB0,100,749
D10275,6,8/22/2022,QHM0N1BCVW,100,649
D10275,6,8/22/2022,QHM9N1DXCR,100,549
D10275,6,8/22/2022,QHM6N1H8GQ,100,449
D10275,6,8/24/2022,QHO0QTG8ME,600,151
D10275,7,8/28/2022,QHS2YOKZ4K,300,"6200"
D10275,7,8/29/2022,QHT91M9J8Z,300,"5900"
D10275,7,8/31/2022,QHV75N2EP3,580,"5320"
D10275,7,9/1/2022,QI117T36O7,300,"5020"
D10275,7,9/3/2022,QI33CBBBLR,590,"4430"
D10275,7,9/4/2022,QI45DVVNOD,100,"4330"
D10275,7,9/4/2022,QI41DW0DLH,100,"4230"
D10275,7,9/4/2022,QI49DW5UC7,100,"4130"
D10275,7,9/6/2022,QI64IFDKZI,590,"3540"
D10275,7,9/8/2022,QI86MJQXFQ,500,"3040"
D10275,7,9/11/2022,QIB0SVG91K,600,"2440"
D10275,7,9/15/2022,QIF322FXPL,650,"1790"
D10275,7,9/17/2022,QIH86S62SS,100,"1690"
D10275,7,9/17/2022,QIH26SDMWQ,100,"1590"
D10275,7,9/17/2022,QIH46SHGNY,70,"1520"
D10275,7,9/18/2022,QII98M2OJJ,100,"1420"
D10275,7,9/18/2022,QII98M7HUZ,100,"1320"
D10275,7,9/18/2022,QII48MDA2O,100,"1220"
D10275,7,9/19/2022,QIJ6AZMF9A,100,"1120"
D10275,7,9/19/2022,QIJ3AZP5PN,100,"1020"
D10275,7,9/19/2022,QIJ7AZQQOB,100,920
D10275,7,9/20/2022,QIK2CZOJEI,100,820
D10275,7,9/20/2022,QIK1CZSE2P,100,720
D10275,7,9/20/2022,QIK8CZVEGU,100,620
D10275,7,9/21/2022,QIL1F90JYT,100,520
D10275,7,9/21/2022,QIL0F92QDK,100,420
D10275,7,9/21/2022,QIL5F94XLD,100,320
D10275,7,9/22/2022,QIM4GLKEIA,100,220
D10275,7,9/22/2022,QIM3GLQ39N,100,120
D10275,7,9/22/2022,QIM0GLTRWA,100,20
D10275,7,9/22/2022,QIM8GLYUY8,20,0
D10275,8,9/23/2022,QIN6J5UVU6,304,"8796"
D10275,8,9/23/2022,QIN6J8V562,304,"8492"
D10275,8,9/25/2022,QIP7NLVU6L,304,"8188"
D10275,8,9/26/2022,QIQ1O0WI6V,304,"7884"
D10275,8,9/26/2022,QIQ4Q15ANE,100,"7784"
D10275,8,9/26/2022,QIQ0Q18YMY,100,"7684"
D10275,8,9/26/2022,QIQ7Q1TNQR,100,"7584"
D10275,8,9/26/2022,QIQ0Q1Z6ES,4,"7580"
D10275,8,9/27/2022,QIR2S4DJDA,100,"7480"
D10275,8,9/27/2022,QIR2S4JQYQ,100,"7380"
D10275,8,9/27/2022,QIR6S4QWI8,100,"7280"
D10275,8,9/27/2022,QIR5S4WBDR,4,"7276"
D10275,8,10/2/2022,QJ254H3XMB,930,"6346"
D10275,8,10/3/2022,QJ3975YGAR,100,"6246"
D10275,8,10/3/2022,QJ36760DJG,100,"6146"
D10275,8,10/3/2022,QJ357626Q3,100,"6046"
D10275,8,10/3/2022,QJ39762Z1D,4,"6042"
D10275,8,10/9/2022,QJ97J6YCDX,620,"5422"
D10275,8,10/14/2022,QJE6WMF4WQ,1300,"4122"
D10275,8,10/15/2022,QJF8YUOCH6,100,"4022"
D10275,8,10/15/2022,QJF0YURO7S,100,"3922"
D10275,8,10/15/2022,QJF5YV39L7,100,"3822"
D10275,8,10/15/2022,QJF3YV6WTB,4,"3818"
D10275,8,10/16/2022,QJG61T3FQW,100,"3718"
D10275,8,10/16/2022,QJG71TAV51,100,"3618"
D10275,8,10/16/2022,QJG41TN45M,100,"3518"
D10275,8,10/16/2022,QJG21TRB1S,4,"3514"
D10275,8,10/17/2022,QJH947J4LT,100,"3414"
D10275,8,10/17/2022,QJH047Q5SU,100,"3314"
D10275,8,10/17/2022,QJH347TBYN,100,"3214"
D10275,8,10/17/2022,QJH047ZO78,4,"3210"
D10275,8,10/18/2022,QJI868KCVG,100,"3110"
D10275,8,10/18/2022,QJI468QG7Q,100,"3010"
D10275,8,10/18/2022,QJI668W1PY,100,"2910"
D10275,8,10/18/2022,QJI3690GC5,100,"2810"
D10275,8,10/18/2022,QJI4696PVW,100,"2710"
D10275,8,10/18/2022,QJI469AX2E,4,"2706"
D10275,8,10/19/2022,QJJ28NSZ44,100,"2606"
D10275,8,10/19/2022,QJJ98NVAHF,100,"2506"
D10275,8,10/19/2022,QJJ48NY612,100,"2406"
D10275,8,10/19/2022,QJJ28O1RJI,100,"2306"
D10275,8,10/19/2022,QJJ98O4SUP,100,"2206"
D10275,8,10/19/2022,QJJ28OAYR4,4,"2202"
D10275,8,10/20/2022,QJK4AQDK82,100,"2102"
D10275,8,10/20/2022,QJK2AQHVL2,100,"2002"
D10275,8,10/20/2022,QJK9AQLNJ5,100,"1902"
D10275,8,10/20/2022,QJK9AQORWZ,100,"1802"
D10275,8,10/20/2022,QJK5AQT3HF,100,"1702"
D10275,8,10/20/2022,QJK4AQY1S0,5,"1697"
D10275,8,10/20/2022,QJK4ARN996,16,"1681"
D10275,8,10/21/2022,QJL2BBS3XG,1681,0
D10275,9,10/21/2022,QJL5CVV7DB,100,"9000"
D10275,9,10/21/2022,QJL1CW1BAZ,100,"8900"
D10275,9,10/21/2022,QJL4CW7N50,100,"8800"
D10275,9,10/21/2022,QJL4CWEPCE,4,"8796"
D10275,9,10/22/2022,QJM5FARRID,100,"8696"
D10275,9,10/22/2022,QJM0FB09A0,100,"8596"
D10275,9,10/22/2022,QJM7FB3A5N,100,"8496"
D10275,9,10/22/2022,QJM5FB6IFZ,100,"8396"
D10275,9,10/22/2022,QJM5FBMV2J,100,"8296"
D10275,9,10/23/2022,QJN1HF0DO7,100,"8196"
D10275,9,10/23/2022,QJN9HF2U55,100,"8096"
D10275,9,10/23/2022,QJN7HF5KGT,100,"7996"
D10275,9,10/23/2022,QJN6HFAY6O,100,"7896"
D10275,9,10/23/2022,QJN3HFH73T,100,"7796"
D10275,9,10/26/2022,QJQ8O625W4,1500,"6296"
D10275,9,11/2/2022,QK264R0WR6,2000,"4296"
D10275,9,11/2/2022,QK225ED25S,704,"3592"
D10275,9,11/3/2022,QK387V5SIE,100,"3492"
D10275,9,11/3/2022,QK387V9AME,400,"3092"
D10275,9,11/5/2022,QK58CWVKRG,100,"2992"
D10275,9,11/5/2022,QK51CWYC47,100,"2892"
D10275,9,11/5/2022,QK55CX0E8X,100,"2792"
D10275,9,11/5/2022,QK56CX0WHC,100,"2692"
D10275,9,11/5/2022,QK51CX25R7,100,"2592"
D10275,9,11/6/2022,QK69F4JSLR,500,"2092"
D10275,9,11/9/2022,QK91M39MUP,1500,592
D10275,9,11/10/2022,QKA4OAY9HU,100,492
D10275,9,11/10/2022,QKA5OB58JX,100,392
D10275,9,11/10/2022,QKA3OBCUQP,100,292
D10275,9,11/10/2022,QKA8OBHJD4,100,192
D10275,9,11/10/2022,QKA1OBOI3L,100,92
D10275,9,11/10/2022,QKA6OC29RW,92,0
D10275,10,11/12/2022,QKC9TEYEF3,100,"8370"
D10275,10,11/12/2022,QKC1TF0ET9,100,"8270"
D10275,10,11/12/2022,QKC8TF3A06,100,"8170"
D10275,10,11/12/2022,QKC0TF6I84,100,"8070"
D10275,10,11/12/2022,QKC1TF8KT5,100,"7970"
D10275,10,11/15/2022,QKF3ZXAQXV,1500,"6470"
D10275,10,11/16/2022,QKG739ONJT,100,"6370"
D10275,10,11/16/2022,QKG139SS8Z,100,"6270"
D10275,10,11/16/2022,QKG539Y43H,100,"6170"
D10275,10,11/16/2022,QKG73A2EWV,100,"6070"
D10275,10,11/16/2022,QKG53AB08X,100,"5970"
D10275,10,11/18/2022,QKI67Z8MVI,1000,"4970"
D10275,10,11/22/2022,QKM2H1KFQS,1000,"3970"
D10275,10,11/24/2022,QKO1LAQUBN,1000,"2970"
D10275,10,11/26/2022,QKQ8QO1278,900,"2070"
D10275,10,11/29/2022,QKT0XBU722,1500,570
D10275,10,11/30/2022,QKU7ZLK0FB,100,470
D10275,10,11/30/2022,QKU9ZLQQZ1,100,370
D10275,10,11/30/2022,QKU9ZM0UX9,100,270
D10275,10,11/30/2022,QKU6ZMALUS,100,170
D10275,10,11/30/2022,QKU2ZMKPGO,100,70
D10275,10,12/1/2022,QL12362SAI,70,0
D10275,11,12/3/2022,QL3683BIHE,250,"8150"
D10275,11,12/3/2022,QL31APK5E7,800,"7350"
D10275,11,12/5/2022,QL59H44JJV,1000,"6350"
D10275,11,12/9/2022,QL99SX8QVX,500,"5850"
D10275,11,12/9/2022,QL99S2Z78J,500,"5350"
D10275,11,12/12/2022,QLC1YREQVJ,500,"4850"
D10275,11,12/13/2022,QLD62I7FS6,500,"4350"
D10275,11,12/13/2022,QLD14AWDHZ,500,"3850"
D10275,11,12/13/2022,QLD34C7QYZ,100,"3750"
D10275,11,12/13/2022,QLD84CDN6U,100,"3650"
D10275,11,12/16/2022,QLG5CHGWLH,1000,"2650"
D10275,11,12/19/2022,QLJ6JB3F7G,1000,"1650"
D10275,11,12/19/2022,QLJ7K7EOFR,500,"1150"
D10275,11,12/20/2022,QLK1LCO1FD,380,770
D10275,11,12/20/2022,QLK0MHDKSA,770,0
D10275,12,12/22/2022,QLM1S94B09,100,"8090"
D10275,12,12/22/2022,QLM8S9AO6Q,100,"7990"
D10275,12,12/22/2022,QLM4S9H410,100,"7890"
D10275,12,12/22/2022,QLM0S9O7A2,100,"7790"
D10275,12,12/22/2022,QLM2S9XJEY,100,"7690"
D10275,12,12/23/2022,QLN9V3YRAT,100,"7590"
D10275,12,12/23/2022,QLN6V450S8,100,"7490"
D10275,12,12/23/2022,QLN5V48QXX,100,"7390"
D10275,12,12/23/2022,QLN2V4GZKQ,100,"7290"
D10275,12,12/23/2022,QLN9V4L5C1,100,"7190"
D10275,12,12/24/2022,QLO4Y1BEL8,100,"7090"
D10275,12,12/24/2022,QLO3Y1HCOF,100,"6990"
D10275,12,12/24/2022,QLO0Y1MBMU,100,"6890"
D10275,12,12/24/2022,QLO8Y1TKE0,100,"6790"
D10275,12,12/24/2022,QLO4Y1YFN2,100,"6690"
D10275,12,27/12/2022,QLR25OTGJO,520,"6170"
D10275,12,12/30/2022,QLU6CW9P6W,1020,"5150"
D10275,12,1/1/2023,RA11HKAIRJ,1020,"4130"
D10275,12,1/2/2023,RA28J3S1BQ,520,"3610"
D10275,12,1/3/2023,RA36L35RH8,520,"3090"
D10275,12,1/3/2023,RA38MNGO26,620,"2470"
D10275,12,1/4/2023,RA45P1EQ4F,520,"1950"
D10275,12,1/6/2023,RA63S3YNXR,1400,550
D10275,12,1/6/2023,RA67S42VWF,520,30
D10275,12,1/6/2023,RA66S4TDQQ,30,0
D10275,13,1/8/2023,RA88YPM5D4,500,"7830"
D10275,13,1/9/2023,RA97ZGJ4JJ,520,"7310"
D10275,13,1/10/2023,RAA54V6XUV,100,"7210"
D10275,13,1/10/2023,RAA64WGGIU,100,"7110"
D10275,13,1/10/2023,RAA94WKIWN,100,"7010"
D10275,13,1/10/2023,RAA24WN2MO,100,"6910"
D10275,13,1/10/2023,RAA54WOSYD,100,"6810"
D10275,13,1/11/2023,RAB77BWUZH,100,"6710"
D10275,13,1/11/2023,RAB87C0BVW,100,"6610"
D10275,13,1/11/2023,RAB37C57JN,100,"6510"
D10275,13,1/11/2023,RAB97CA3I9,100,"6410"
D10275,13,1/11/2023,RAB87CDPQA,100,"6310"
D10275,13,1/13/2023,RAD4ADC9SM,500,"5810"
D10275,13,1/15/2023,RAE3EV7PIN,500,"5310"
D10275,13,1/16/2023,RAG7JI1MRF,1000,"4310"
D10275,13,1/19/2023,RAJ9OWU71P,500,"3810"
D10275,13,1/20/2023,RAK7TL3I9H,1200,"2610"
D10275,13,1/22/2023,RAM4YEX0IU,1000,"1610"
D10275,13,1/24/2023,RAO32L8LUV,600,"1010"
D10275,13,1/24/2023,RAO74Q4QFR,1100,90
D10275,14,1/27/2023,RAR0C8POVU,1100,"7020"
D10275,14,1/30/2023,RAU4I2K7AW,600,"6420"
D10275,14,1/31/2022,RAV3KP8799,500,"5920"
D10275,14,1/31/2022,RAV7L9TCTH,600,"5320"
D10275,14,2/2/2023,RB24RQ945I_D2,1200,"4120"
D10275,14,2/4/2023,RB40X63GKC,600,"3520"
D10275,14,2/6/2023,RB661DFA0W,600,"2920"
D10275,14,2/7/2023,RB7055HNGY,1200,"1720"
D10275,14,2/9/2022,RB949P94BG,1720,0
D10275,15,2/11/2023,RBB3EP2UQ1,600,"7590"
D10275,15,2/13/2023,RBD2L3265K,1200,"6390"
D10275,15,2/16/2023,RBG8R4L75O,600,"5790"
D10275,15,2/18/2023,RBJ61ZSG5G,1200,"4590"
D10275,15,2/19/2023,RBJ61ZSG5G_D2,600,"3990"
D10275,15,2/19/2023,RBJ2213JNY,100,"3890"
D10275,15,2/20/2023,RBK83ZZHGC,600,"3290"
D10275,15,2/21/2023,RBL86XVSSM,600,"2690"
D10275,15,2/22/2023,RBM89ZGI5U,600,"2090"
D10275,15,2/23/2023,RBN1C6KHB5,600,"1490"
D10275,15,2/25/2023,RBP2G1CTHW,1490,0
D10275,16,2/28/2023,RBR9MUUP89,600,"7590"
D10275,16,2/28/2023,RBS1P7YKRX,100,"7490"
D10275,16,2/28/2023,RBS9P86HMB,100,"7390"
D10275,16,2/28/2023,RBS4P8EJZI,100,"7290"
D10275,16,2/28/2023,RBS3P8M41D,100,"7190"
D10275,16,2/28/2023,RBS2P8US92,100,"7090"
D10275,16,2/28/2023,RBS7P92JJN,100,"6990"
D10275,16,3/2/2023,RC28UXF406,1400,"5590"
D10275,16,3/4/2023,RC481MOHG8,600,"4990"
D10275,16,3/6/2023,RC627641YK,1300,"3690"
D10275,16,3/8/2023,RC84C8GDVY,600,"3090"
D10275,16,3/9/2023,RC90F3OU4O,600,"2490"
D10275,16,3/10/2023,RCA6I3ONMG,600,"1890"
D10275,16,3/11/2023,RCB1L3H8QV,600,"1290"
D10275,16,3/13/2023,RCD1O5FKGL,1390,100
D10275,17,3/15/2023,RCF6VL4A0U,1600,"6240"
D10275,17,3/18/2023,RCI825F5TM,800,"5440"
D10275,17,3/18/2023,RCI04UN9IG,800,"4640"
D10275,17,3/20/2023,RCK69V96LA,800,"3840"
D10275,17,3/21/2023,RCL5AGNI3F,800,"3040"
D10275,17,3/21/2023,RCL4AE2SWS,800,"2240"
D10275,17,3/21/2023,RCL8ADYNMQ,800,"1440"
D10275,17,3/21/2023,RCL5AA19OL,800,640
D10275,17,Overpayment,RCD1O5FKGL_D2,100,540
D10275,17,Overpayment,RAO74Q4QFR_D2,90,450
D10275,17,3/21/2023,RCL9BHT0WF,450,0
D10275,18,3/23/2023,RCN2FLLAYG,600,"8500"
D10275,18,3/23/2023,RCN9HLW2P7,600,"7900"
D10275,18,3/24/2023,RCO2K5H618,600,"7300"
D10275,18,3/25/2023,RCP0MW5HVS,100,"7200"
D10275,18,3/25/2023,RCP8MW93OS,100,"7100"
D10275,18,3/25/2023,RCP2MWIFZK,100,"7000"
D10275,18,3/25/2023,RCP3MWSUJR,100,"6900"
D10275,18,3/25/2023,RCP0MWYOSA,100,"6800"
D10275,18,3/25/2023,RCP5MX1YLT,100,"6700"
D10275,18,3/29/2023,RCS8TDLNDE,600,"6100"
D10275,18,3/28/2023,RCS8TDLNDE_D2,600,"5500"
D10275,18,3/30/2023,RCU911EU2L,600,"4900"
D10275,18,3/31/2023,RCV33K2HYR,1200,"3700"
D10275,18,4/2/2023,RD268W0FWY,600,"3100"
D10275,18,4/4/2023,RD44ESZQ3I,1200,"1900"
D10275,18,4/5/2023,RD52HVD6QE,600,"1300"
D10275,18,4/8/2023,RD80O7J0JQ,600,700
D10275,18,4/19/2023,RDJ8IQ3VZK,700,0
D10275,19,8/1/2023,RH14ZWT0B2,217,"6283"
D10275,19,8/2/2023,RH2642BC6G,217,"6066"
D10275,19,7/8/23 22:17,RH72J1Z11A,217,"5849"
D10275,19,6/8/23 20:33,RH61FQKJGF,217,"5632"
D10275,19,6/8/23 13:38,RH62EDP4QU,300,"5332"
D10275,19,4/8/23 20:49,RH489UX1BE,217,"5115"
D10275,19,8/8/2023,RH81LYXSJ1,217,"4898"
D10275,19,10/8/2023,RHA5S049WH,217,"4681"
D10275,19,15-08-2023 20:53:25,RHF97W0HIF,217,"4464"
D10275,19,14-08-2023 22:06:24,RHE7526O1T,217,"4247"
D10275,19,14-08-2023 12:25:38,RHE535IJFZ,217,"4030"
D10275,19,12/8/23 21:17,RHC0Y7ZU1I,217,"3813"
D10275,19,11/8/23 20:56,RHB3V25WT9,217,"3596"
D10275,19,17-08-2023 21:42:38,RHH1DZBCCN,300,"3296"
D10275,19,16-08-2023 21:13:15,RHG0AXFNFY,217,"3079"
D10275,19,8/21/2023,RHL4PH96M0,217,"2862"
D10275,19,8/22/2023,RHM7SCMMMB,217,"2645"
D10275,19,8/24/2023,RHO5Y8KQ3J,217,"2428"
D10276,1,4/21/2022,QDL0Q7DK8Q,9100,0
D10276,2,5/19/2022,QEJ59XAZSZ,9100,0
D10277,1,4/4/2022,QD47TXPWK3,1500,"14300"
D10277,1,4/20/2022,QDK0PBNNKS,1000,"13300"
D10277,1,4/21/2022,QDL8QTTNY2,1100,"12200"
D10277,1,4/22/2022,QDM9RG66ZT,1500,"10700"
D10277,1,4/22/2022,QDM9SRG4MH,1000,"9700"
D10278,1,3/28/2022,QCS6FZ8KSK,500,"12500"
D10278,1,3/29/2022,QCT0HUCJYS,500,"12000"
D10278,1,4/13/2022,QDD1B2RK97,1000,"11000"
D10278,1,4/13/2022,QDD3CN5Q61,500,"10500"
D10278,1,4/20/2022,QDK5O0JBE7,990,"9510"
D10278,1,4/21/2022,QDL7PJ83Y3,810,"8700"
D10278,1,4/21/2022,QDL9Q0DY6P,8700,0
D10278,2,5/25/2022,QEP8LEBG6A,1100,"13500"
D10278,2,6/4/2022,QF4168WP41,500,"13000"
D10278,2,6/6/2022,QF68A5B67O,500,"12500"
D10278,2,6/14/2022,QFE0QJMQH0,100,"12400"
D10278,2,6/14/2022,QFE1QL8PQF,100,"12300"
D10278,2,6/15/2022,QFF0QZ2E3U,100,"12200"
D10278,2,6/15/2022,QFF4QZ7J9I,100,"12100"
D10278,2,6/16/2022,QFG4UVAJBS,100,"12000"
D10278,2,6/16/2022,QFG2UVC31U,100,"11900"
D10278,2,6/16/2022,QFG9UVDGA9,100,"11800"
D10278,2,6/17/2022,QFH0WVIPKY,100,"11700"
D10278,2,6/17/2022,QFH5WVLP5V,100,"11600"
D10278,2,6/17/2022,QFH8WVNTYY,50,"11550"
D10278,2,7/12/2022,QGC4BJ67H4,500,"11050"
D10278,2,7/12/2022,QGC4CXIRZ4,300,"10750"
D10278,2,7/13/2022,QGD7FABBZP,100,"10650"
D10278,2,7/13/2022,QGD9FAGOJF,100,"10550"
D10278,2,7/13/2022,QGD8FAP058,100,"10450"
D10278,2,7/14/2022,QGE6H3IX5K,100,"10350"
D10278,2,7/14/2022,QGE9H47BY1,250,"10100"
D10278,2,7/15/2022,QGF0J91XOO,300,"9800"
D10278,2,7/16/2022,QGG4L7EBHO,300,"9500"
D10278,2,7/19/2022,QGJ5R0M4GL,100,"9400"
D10278,2,7/19/2022,QGJ2R0RZ1W,100,"9300"
D10278,2,7/19/2022,QGJ1R0YY3X,100,"9200"
D10278,2,7/21/2022,QGL5UWMY0R,300,"8900"
D10278,2,7/22/2022,QGM6X0O9JQ,100,"8800"
D10278,2,7/22/2022,QGM8X0SUES,100,"8700"
D10278,2,7/29/2022,QGT7B67Z5D,300,"8400"
D10278,2,7/31/2022,QGV3FR3KNF,100,"8300"
D10278,2,7/31/2022,QGV6FR8H2C,100,"8200"
D10278,2,8/2/2022,QH27IZ3UH9,300,"7900"
D10278,2,8/3/2022,QH35KM4OZ5,300,"7600"
D10278,2,8/3/2022,QH39M9MZND,100,"7500"
D10278,2,8/3/2022,QH31M9NVIN,100,"7400"
D10278,2,8/3/2022,QH39M9PD8R,100,"7300"
D10278,2,8/3/2022,QH34M9RBBE,90,"7210"
D10278,2,8/5/2022,QH51P3TEOV,450,"6760"
D10278,2,8/10/2022,QHA0ZJ1KFA,500,"6260"
D10278,2,8/24/2022,QHO7Q8S5HD,400,"5860"
D10278,2,8/29/2022,QHT8153FL8,200,"5660"
D10278,2,8/31/2022,QHV95SRLYT,100,"5560"
D10278,2,8/31/2022,QHV75T41V7,100,"5460"
D10278,2,9/1/2022,QI197VWPGX,100,"5360"
D10278,2,9/1/2022,QI107W0MUY,100,"5260"
D10278,2,9/7/2022,QI76IQH938,400,"4860"
D10278,2,9/8/2022,QI83KS3J1H,200,"4660"
D10278,2,9/12/2022,QIC9ULJLAD,500,"4160"
D10278,2,9/17/2022,QIH355P9NB,480,"3680"
D10278,2,9/21/2022,QIL6E6BWD0,350,"3330"
D10278,2,9/22/2022,QIM1FEPWGT,200,"3130"
D10278,2,9/24/2022,QIO6KB6V7Q,350,"2780"
D10278,2,9/27/2022,QIR8QELOLC,500,"2280"
D10278,2,9/29/2022,QIT5VHWOUV,500,"1780"
D10278,2,10/3/2022,QJ325AKB0G,500,"1280"
D10278,2,10/4/2022,QJ428RJ1DO,300,980
D10278,2,10/12/2022,QJC3PXJYOD,380,600
D10278,2,10/19/2022,QJJ56WLWGN,100,500
D10278,2,10/19/2022,QJJ66WOJ46,100,400
D10278,2,10/20/2022,QJK19B8C0B,100,300
D10278,2,10/29/2022,QJT8UVZIG8,100,200
D10278,2,10/31/2022,QJV1XK55FN,100,100
D10278,2,11/1/2022,QK162YOLD2,100,0
D10279,1,5/13/2022,QED5WRIT9Z,4100,0
D10280,1,4/27/2022,QDR01YLB58,12800,0
D10280,2,5/23/2022,QEN1H1IZCD,12700,0
D10280,3,6/20/2022,QFK92DRQ1F,12900,0
D10280,4,7/18/2022,QGI2NQMFK6,12900,0
D10280,5,8/15/2022,QHF793ULY5,19500,0
D10280,6,9/14/2022,QIE4Y52382,20400,0
D10280,7,10/13/2022,QJD9SJ5E8Z,19500,0
D10280,8,11/11/2022,QKB3PQP5AH,22100,0
D10280,9,1/10/2023,RAA82Z2B90,22100,"2720"
D10280,9,1/10/2023,RAA23HUQCY,2720,0
D10281,1,4/25/2022,QDP7X39FYN,12500,0
D10282,1,4/12/2022,QDC49QMK6G,2500,"5970"
D10282,1,4/19/2022,QDJ6M7XEG4,2300,"3670"
D10282,1,4/25/2022,QDP4X2DRU4,3670,0
D10282,2,5/4/2022,QE46F1STGW,2275,"6825"
D10282,2,5/9/2022,QE99PM62HH,2275,"4550"
D10282,2,5/16/2022,QEG94ANCSR,4550,0
D10282,3,5/26/2022,QEQ0N5XPNG,2500,"6600"
D10282,3,6/5/2022,QF557BR3B1,3000,"3600"
D10282,3,6/13/2022,QFD8NWYRZM,3600,0
D10282,4,6/24/2022,QFO2BDLWT6,2500,"6600"
D10282,4,7/8/2022,QG8856KKOS,2500,"4100"
D10282,4,7/9/2022,QG9460MRRC,4100,0
D10282,5,8/2/2022,QH24JQ7GHO,2500,"6390"
D10282,5,8/4/2022,QH42MQ1KJ4,6390,0
D10282,6,8/24/2022,QHO0PIRHTY,3000,"5820"
D10282,6,8/29/2022,QHT5Z0T75T,5000,820
D10282,6,8/29/2022,QHT6Z1M4MM,820,0
D10282,7,9/21/2022,QIL3D9UX6H,8500,250
D10282,7,9/21/2022,QIL8DFR274,250,0
D10282,8,10/14/2022,QJE6VZYEQ6,4000,"4820"
D10282,8,10/15/2022,QJF0XG015K,4820,0
D10282,9,11/15/2022,QKF6Y9VPMU,500,"9020"
D10282,9,11/18/2022,QKI9761B4Z,4000,"5020"
D10282,9,11/19/2022,QKJ38GTN4D,5020,0
D10282,10,12/7/2022,QL75MP2PMT,500,"9020"
D10282,10,12/22/2022,QLM1RQ73SZ,3000,"6020"
D10282,10,12/28/2022,QLS06POMG2,200,"5820"
D10282,10,1/17/2023,RAH7JQHCA3,500,"5320"
D10282,10,1/28/2023,RAS5DA0ULV,120,"5200"
D10282,10,2/10/2023,RBA8DWIZP0,400,"4800"
D10282,10,2/13/2023,RBD4J93MVA,100,"4700"
D10283,1,4/21/2022,QDL2QWBWJM,1500,"14300"
D10283,1,4/23/2022,QDN8UIBJDW,1000,"13300"
D10285,1,5/4/2022,QE43EYL0YP,2000,"11600"
D10285,1,5/9/2022,QE99Q0D5N7,4000,"7600"
D10285,1,5/10/2022,QEA4QL1JUM,3500,"4100"
D10285,1,5/10/2022,QEA2QPKQXW,3500,600
D10285,1,,,600,0
D10285,2,5/23/2022,QEN8GZ1YNO,11500,0
D10285,3,6/2/2022,QF291SHMR9,11200,0
D10286,1,5/7/2022,QE71L2AQQB,12600,100
D10286,1,5/7/2022,QE73L5G5Y7,100,0
D10286,2,5/30/2022,QEU7U8O9F1,12400,0
D10286,3,6/20/2022,QFK62J5BDG,12300,0
D10286,4,8/1/2022,QH17GUVA2N,2000,"19900"
D10287,1,4/25/2022,QDP3YJXUD9,1950,"10350"
D10287,1,4/26/2022,QDQ0ZPWG0W,5000,"5350"
D10287,1,5/3/2022,QE30DAXXNS,4900,450
D10287,1,5/3/2022,QE34ELJFUA,250,200
D10287,1,5/4/2022,QE48F3ZDXO,100,100
D10287,1,5/4/2022,QE43F45WJD,100,0
D10287,2,5/20/2022,QEK8B3LD28,4000,"9000"
D10287,2,5/27/2022,QER2OLXYFK,2000,"7000"
D10287,2,5/31/2022,QEV4XUZ67I,7000,0
D10287,3,7/1/2022,QG17NP40K5,3000,"11600"
D10287,3,7/6/2022,QG63YLVDXB,2000,"9600"
D10287,3,7/12/2022,QGC8D5E5ZQ,3950,"5650"
D10287,3,7/13/2022,QGD8F4RXM2,2000,"3650"
D10287,3,7/17/2022,QGH3N69Z55,3650,0
D10287,4,8/13/2022,QHD55BHIWR,4000,"8900"
D10287,4,8/14/2022,QHE084VZWA,8900,0
D10287,5,10/1/2022,QJ141AYM48,500,"15300"
D10287,5,10/12/2022,QJC1QNZZT3,500,"14800"
D10287,5,11/7/2022,QK79GRC8IX,500,"14300"
D10287,5,11/19/2022,QKJ08UKAX4,200,"14100"
D10288,1,4/21/2022,QDL9R3Z5J5,3250,"9650"
D10288,1,5/9/2022,QE92PI4NFC,9650,0
D10288,2,6/6/2022,QF6699LLMO,13000,0
D10288,3,7/4/2022,QG41UGY6QJ,13000,0
D10288,4,8/1/2022,QH13G0OY81,13000,0
D10288,5,8/15/2022,QHF48G1SX8,11600,0
D10288,6,9/3/2022,QI39AIK90H,12100,0
D10288,7,10/1/2022,QJ16ZF3UK8,15600,0
D10288,8,10/31/2022,QJV6XODO5C,16320,0
D10288,9,12/8/2022,QL82NHDF04,5000,"13960"
D10288,9,1/25/2023,RAP05GXYUM,500,"13460"
D10289,1,4/14/2022,QDE3DBG3E1,110,"3100"
D10289,1,4/15/2022,QDF5FK6JBT,110,"2990"
D10289,1,4/17/2022,QDH4IJLSSA,100,"2890"
D10289,1,4/17/2022,QDH0IJPHQK,100,"2790"
D10289,1,4/17/2022,QDH9IK1PNR,20,"2770"
D10289,1,4/18/2022,QDI6KM4V5E,100,"2670"
D10289,1,4/18/2022,QDI3KM9XEZ,10,"2660"
D10289,1,4/19/2022,QDJ7N0LOHR,100,"2560"
D10289,1,4/19/2022,QDJ9N0UT7Z,10,"2550"
D10289,1,4/20/2022,QDK0P4VS1G,100,"2450"
D10289,1,4/20/2022,QDK6P54JTE,100,"2350"
D10289,1,4/22/2022,QDM1SJ7T99,150,"2200"
D10289,1,4/24/2022,QDO2VG7VJI,220,"1980"
D10289,1,4/26/2022,QDQ01ICQT4,110,"1870"
D10289,1,4/27/2022,QDR62OIR00,100,"1770"
D10289,1,4/27/2022,QDR92ONOB5,20,"1750"
D10289,1,4/28/2022,QDS54P4YEJ,100,"1650"
D10289,1,4/28/2022,QDS24PDHR6,10,"1640"
D10289,1,4/30/2022,QDU492C9U2,100,"1540"
D10289,1,4/30/2022,QDU892GJIY,10,"1530"
D10289,1,5/3/2022,QE33DDOW47,100,"1430"
D10289,1,5/3/2022,QE32DDSQRK,10,"1420"
D10289,1,5/4/2022,QE48G8PF3G,100,"1320"
D10289,1,5/4/2022,QE47G8VENZ,10,"1310"
D10289,1,5/6/2022,QE62JYVG0M,100,"1210"
D10289,1,5/6/2022,QE68JZ26HE,10,"1200"
D10289,1,5/9/2022,QE90OT12D6,1200,0
D10289,2,5/10/2022,QEA2RQR9AI,100,"3150"
D10289,2,5/10/2022,QEA3RQXIPJ,10,"3140"
D10289,2,5/12/2022,QEC1VH0X69,100,"3040"
D10289,2,5/12/2022,QEC7VH8HDL,10,"3030"
D10289,2,5/13/2022,QED3XTYUTD,80,"2950"
D10289,2,5/17/2022,QEH166KAAJ,100,"2850"
D10289,2,5/20/2022,QEK0AY30TY,100,"2750"
D10289,2,5/20/2022,QEK4AY6ZSQ,10,"2740"
D10289,2,5/21/2022,QEL5EBYBS7,100,"2640"
D10289,2,5/25/2022,QEP7LLT83F,100,"2540"
D10289,2,5/25/2022,QEP2LM0C0M,40,"2500"
D10289,2,5/28/2022,QES9RPWAM3,100,"2400"
D10289,2,5/28/2022,QES1RQ46RL,40,"2360"
D10289,2,5/30/2022,QEU6VI0O80,100,"2260"
D10289,2,5/30/2022,QEU2VN3DS4,50,"2210"
D10289,2,5/31/2022,QEV5XVPDFX,100,"2110"
D10289,2,5/31/2022,QEV9XVUCF3,50,"2060"
D10289,2,6/7/2022,QF73C1Z8YD,2060,0
D10289,3,6/19/2022,QFJ7ZGHWLB,100,"3150"
D10290,1,5/15/2022,QEF91F7C6D,7000,"6600"
D10290,1,5/17/2022,QEH763575L,6000,600
D10290,1,5/17/2022,PENALTIES W/OFF,600,0
D10291,1,4/28/2022,QDS63L2FXW,1000,"10060"
D10291,1,4/29/2022,QDT35H0WCH,1275,"8785"
D10292,1,4/21/2022,QDL3R2592X,610,"8350"
D10292,1,4/23/2022,QDN9UJH4UT,610,"7740"
D10292,1,4/25/2022,QDP2YLJNDW,610,"7130"
D10292,1,5/5/2022,QE51GVC0KH,305,"6825"
D10292,1,5/6/2022,QE60KKCOG8,100,"6725"
D10292,1,5/6/2022,QE60KKHVIO,100,"6625"
D10292,1,5/6/2022,QE68KKN5WS,100,"6525"
D10292,1,5/8/2022,QE85OHCUMZ,610,"5915"
D10292,1,5/11/2022,QEB1SKH8JT,900,"5015"
D10292,1,5/13/2022,QED5WN1WJX,490,"4525"
D10292,1,5/16/2022,QEG13GC8A7,4525,0
D10292,2,5/15/2022,QEG950CNIL,305,"10755"
D10292,2,5/18/2022,QEI275D4N0,305,"10450"
D10292,2,5/19/2022,QEJ3ADZCAN,305,"10145"
D10292,2,6/13/2022,QFD6OADPTU,585,"9560"
D10292,2,6/14/2022,QFE5QH0H91,500,"9060"
D10292,2,7/15/2022,QGF2JG685I,420,"8640"
D10293,1,4/21/2022,QDL3PU63H7,100,"5994"
D10293,1,4/21/2022,QDL2PUUGPG,100,"5894"
D10293,1,4/21/2022,QDL7Q0ECCN,17,"5877"
D10293,1,4/22/2022,QDM4RPJ1WA,100,"5777"
D10293,1,4/22/2022,QDM7RPP7WL,100,"5677"
D10293,1,4/23/2022,QDN9T95P7T,100,"5577"
D10293,1,4/27/2022,QDR33FEFI3,100,"5477"
D10293,1,4/27/2022,QDR13FJ5IB,100,"5377"
D10293,1,4/27/2022,QDR33FOR8V,17,"5360"
D10293,1,5/9/2022,QE92PCC6WK,300,"5060"
D10293,1,5/10/2022,QEA6RJPJYC,5060,0
D10293,2,5/11/2022,QEB9TW4DQZ,434,"7466"
D10293,2,5/12/2022,QEC7V72K9D,100,"7366"
D10293,2,5/12/2022,QEC6V78334,17,"7349"
D10293,2,5/12/2022,QEC5V7C3D9,100,"7249"
D10293,2,5/13/2022,QED4Y8YI0U,100,"7149"
D10293,2,5/13/2022,QED6Y90F7Q,100,"7049"
D10293,2,5/13/2022,QED2Y940QO,17,"7032"
D10293,2,5/14/2022,QEE318TVFJ,100,"6932"
D10293,2,5/14/2022,QEE918XIOF,100,"6832"
D10293,2,5/14/2022,QEE319CGO1,17,"6815"
D10293,2,5/15/2022,QEF12TU9PL,100,"6715"
D10293,2,5/15/2022,QEF42UANTK,100,"6615"
D10293,2,5/15/2022,QEF92UOPVH,17,"6598"
D10293,2,5/16/2022,QEG24VV1U0,100,"6498"
D10293,2,5/16/2022,QEG74W35YJ,100,"6398"
D10293,2,5/16/2022,QEG24XKVX6,17,"6381"
D10293,2,5/18/2022,QEI88DUC78,100,"6281"
D10293,2,5/18/2022,QEI08DZAQI,100,"6181"
D10293,2,5/18/2022,QEI18E5199,17,"6164"
D10293,2,5/20/2022,QEK0CAGP98,1302,"4862"
D10294,1,4/26/2022,QDQ1ZRY9DX,2250,"10750"
D10294,1,4/26/2022,QDQ2ZSVXZU,1000,"9750"
D10294,1,5/3/2022,QE38E9RTDG,3250,"6500"
D10294,1,5/12/2022,QEC9UUJQ9Z,3250,"3250"
D10294,1,5/16/2022,QEG0443GZS,3250,0
D10294,2,6/6/2022,QF66A2D4GQ,3250,"9750"
D10294,2,6/11/2022,QFB7JFYPEZ,3250,"6500"
D10294,2,5/23/2022,QEN1GULHZH,3250,"3250"
D10294,2,6/11/2022,QFB0JOL3RQ,3250,0
D10294,3,6/19/2022,QFJ31BCVS5,3250,"9750"
D10294,3,7/8/2022,QG82414N14,9750,0
D10294,4,8/5/2022,QH53P3R5ET,13000,0
D10294,5,9/2/2022,QI289DUTYS,4000,"9600"
D10294,5,9/3/2022,QI35AL8SAD,9600,0
D10294,6,10/1/2022,QJ19ZXRVCL,13000,0
D10294,7,10/28/2022,QJS8R5QFP0,12900,0
D10294,8,11/24/2022,QKO0K8IHQ6,13000,0
D10294,9,12/19/2022,QLJ7J8FQQN,12000,700
D10294,9,12/19/2022,QLJ3J8JP5H,700,0
D10294,10,1/16/2023,RAG8IE8PLM,13000,0
D10294,11,2/13/2023,QLJ3J8JP5H_D2,13000,0
D10294,12,03/08/2023,RC85B3OYIZ,12500,0
D10294,13,4/19/2023,RDJ7IIVRO9,2000,"11600"
D10294,13,4/24/2023,RDO1XIKL3L,500,"11100"
D10294,13,4/25/2023,RDP61FTOYI,500,"10600"
D10294,13,4/26/2023,RDQ12RDXAB,10600,0
D10295,1,4/20/2022,QDK5OY697P,175,"4505"
D10295,1,4/21/2022,QDL9Q51L3N,175,"4330"
D10295,1,4/22/2022,QDM8RZYRQ4,175,"4155"
D10295,1,4/23/2022,QDN6TZHFYQ,175,"3980"
D10295,1,4/24/2022,QDO8WD8ZKU,175,"3805"
D10295,1,4/26/2022,QDQ8ZR41P6,175,"3630"
D10295,1,4/26/2022,QDQ2ZWJ5ZG,175,"3455"
D10295,1,4/27/2022,QDR42XD61E,175,"3280"
D10295,1,4/29/2022,QDT65TY26A,175,"3105"
D10295,1,4/29/2022,QDT060AGNA,175,"2930"
D10295,1,5/1/2022,QE119SEYV5,175,"2755"
D10295,1,5/4/2022,QE47FUKQ6P,175,"2580"
D10295,1,5/4/2022,QE43FUPC0V,175,"2405"
D10295,1,5/4/2022,QE45FUUSL1,175,"2230"
D10295,1,5/5/2022,QE50HQ3RE8,175,"2055"
D10295,1,5/6/2022,QE60IT6PAM,175,"1880"
D10295,1,5/6/2022,QE67JE8UC9,1880,0
D10295,2,5/6/2022,QE62JI6L9O,175,"4345"
D10295,2,5/7/2022,QE72LFZO8O,175,"4170"
D10295,2,5/8/2022,QE84N8F2AQ,175,"3995"
D10295,2,5/9/2022,QE98P47F8O,175,"3820"
D10295,2,5/10/2022,QEA6R3V866,175,"3645"
D10295,2,5/11/2022,QEB1T4IFCD,175,"3470"
D10295,2,5/13/2022,QED5X2RZPX,175,"3295"
D10295,2,5/14/2022,QEE2Z80LA8,175,"3120"
D10295,2,5/14/2022,QEE71157TJ,175,"2945"
D10295,2,5/15/2022,QEF92SJKL9,175,"2770"
D10295,2,5/17/2022,QEH865FL6K,175,"2595"
D10295,2,5/17/2022,QEH36ETC4X,175,"2420"
D10295,2,5/18/2022,QEI77PVT73,2420,0
D10295,3,5/21/2022,QEL5DNBEMR,175,"6145"
D10296,1,5/6/2022,QE68IVN4DO,2000,"7100"
D10296,1,5/12/2022,QEC7V3T99V,2000,"5100"
D10296,1,5/13/2022,QED0WSDX0O,5100,0
D10296,2,6/1/2022,QF12Y9NFCE,1000,"8000"
D10296,2,6/3/2022,QF384YBSYC,400,"7600"
D10296,2,6/6/2022,QF67AU5M87,4500,"3100"
D10296,2,6/7/2022,QF70BBGKRU,3100,0
D10296,3,7/4/2022,QG41TZ1VZP,9100,0
D10296,4,8/1/2022,QH17H4HZ4P,5500,"3600"
D10296,4,8/1/2022,QH14H84NGQ,3600,0
D10296,5,8/27/2022,QHR6V1V2Q0,9100,0
D10296,6,9/24/2022,QIO1L7X8YD,500,"9020"
D10296,6,10/5/2022,QJ54A4A172,9020,0
D10297,1,5/4/2022,QE45GJ2QRZ,2275,"7245"
D10298,1,4/24/2022,QDO1WO33VN,217,"6233"
D10298,1,4/25/2022,QDP3YLU49P,217,"6016"
D10298,1,4/26/2022,QDQ21HPAG8,217,"5799"
D10298,1,4/27/2022,QDR73DO6XX,217,"5582"
D10298,1,4/28/2022,QDS357ABNH,217,"5365"
D10298,1,4/29/2022,QDT774J633,217,"5148"
D10298,1,4/30/2022,QDU593MXHB,217,"4931"
D10298,1,5/1/2022,QE16AVB1EE,217,"4714"
D10298,1,5/2/2022,QE22CS2IRU,217,"4497"
D10298,1,5/3/2022,QE38EL3EQK,217,"4280"
D10298,1,5/5/2022,QE55HLAM0P,432,"3848"
D10298,1,5/7/2022,QE71MN0XU3,432,"3416"
D10298,1,5/8/2022,QE88OJ5ZBO,100,"3316"
D10298,1,5/9/2022,QE90OLMTYA,100,"3216"
D10298,1,5/9/2022,QE96OLNY3Q,17,"3199"
D10298,1,5/10/2022,QEA7RRGB83,435,"2764"
D10298,1,5/16/2022,QEG8425FKC,700,"2064"
D10298,1,5/19/2022,QEJ5AFEVHD,600,"1464"
D10298,1,5/20/2022,QEK8BNI66O,1464,0
D10298,2,5/30/2022,QEU0U5NFSE,1000,"4850"
D10298,2,5/30/2022,QEU7U5S7WP,550,"4300"
D10298,2,6/4/2022,QF425DDHPY,4300,0
D10298,3,6/25/2022,QFP7BWNR0T,5680,0
D10298,4,7/22/2022,QGM9VJF4YV,10240,0
D10298,5,8/27/2022,QHR7V1YVFP,1700,"10940"
D10298,5,8/31/2022,QHV04D7YRU,500,"10440"
D10298,5,9/9/2022,QI98NW2MPY,1000,"9440"
D10298,5,9/19/2022,QIJ29JVQPC,600,"8840"
D10298,5,9/29/2022,QIT3VPTGCP,200,"8640"
D10298,5,9/29/2022,QIT9VQ3UI1,50,"8590"
D10298,5,9/29/2022,QIT9VRERBJ,230,"8360"
D10298,5,10/3/2022,QJ3052E2IY,600,"7760"
D10298,5,10/5/2022,QJ599RRWYZ,500,"7260"
D10298,5,10/11/2022,QJB1O5YE77,500,"6760"
D10298,5,10/17/2022,QJH43JT9XG,1000,"5760"
D10298,5,10/26/2022,QJQ9MHG0KJ,700,"5060"
D10298,5,11/1/2022,QK181HS2I2,700,"4360"
D10298,5,11/9/2022,QK96KGXJI0,600,"3760"
D10298,5,11/16/2022,QKG21SF7K6,500,"3260"
D10298,5,11/24/2022,QKO8K3NOYE,400,"2860"
D10298,5,12/7/2022,QL71L26KQB,400,"2460"
D10298,5,1/23/2023,RAN8ZKP1SE,500,"1960"
D10299,1,4/26/2022,QDQ4ZSIP30,2000,"11000"
D10299,1,4/29/2022,QDT66BHZJI,1350,"9650"
D10299,1,5/4/2022,QE45G4HV1B,2350,"7300"
D10299,1,5/6/2022,QE63K15K0H,1000,"6300"
D10299,1,5/12/2022,QEC4VU1EE4,1600,"4700"
D10299,1,5/13/2022,QED5Y467OZ,1400,"3300"
D10299,1,5/18/2022,QEI97NZIA1,3500,200
D10299,2,5/26/2022,QEQ3NLP1XF,1500,"11500"
D10299,2,5/27/2022,QER2PF0GBK,1000,"10500"
D10299,2,6/4/3033,QF415KV2UN,3000,"7500"
D10299,2,6/7/2022,QF75CD4VEV,3000,"4500"
D10299,2,6/14/2022,QFE0P2VB9W,1500,"3000"
D10299,2,6/16/2022,QFG6UW0RZC,1000,"2000"
D10299,2,6/17/2022,QFH3W99GMF,1000,"1000"
D10299,2,6/18/2022,QFI0XZF4PI,1000,0
D10299,3,7/15/2022,QGF8IMN82K,2000,"11000"
D10299,3,7/22/2022,QGM3WSK3MX,1500,"9500"
D10299,3,7/27/2022,QGR5667XRV,2000,"7500"
D10299,3,8/2/2022,QH21JF8WRF,3000,"4500"
D10299,3,8/3/2022,QH32LN5GIO,1000,"3500"
D10299,3,8/5/2022,QH51OVVIED,2500,"1000"
D10299,3,8/5/2022,QH51QB4X5R,1000,0
D10299,4,8/26/2022,QHQ9UTJEUH,3500,"3000"
D10299,4,9/1/2022,QI197J0BB1,2000,"1000"
D10299,4,9/2/2022,QI289HWJM4,1000,0
D10299,5,9/24/2022,QIO2KQ6HY4,2000,"11000"
D10299,5,9/29/2022,QIT4VSSSHM,3000,"8000"
D10299,5,10/2/2022,QJ252UFUB7,2000,"6000"
D10299,5,10/4/2022,QJ498RD8LR,2000,"4000"
D10299,5,10/5/2022,QJ55BG3G13,2500,"1500"
D10299,5,10/6/2022,QJ64EAK01Y,500,"1000"
D10299,5,10/7/2022,QJ76FZE3P4,1000,0
D10299,6,11/8/2022,QK88I76XMW,5000,"8000"
D10299,6,11/17/2022,QKH84UYBDQ,5000,"3000"
D10299,6,11/21/2022,QKL3ERAAJX,2000,"1000"
D10299,6,11/24/2022,QKO9KWGZFV,1000,0
D10299,7,12/2/2022,QL235AI0SR,4000,"9000"
D10299,7,12/13/2022,QLD63M7WRU,2000,"7000"
D10299,7,12/16/2022,QLG49YWO4G,2000,"5000"
D10299,7,12/19/2022,QLJ4JAU3U2,2000,"3000"
D10299,7,12/25/2022,QLO7X0WPWF,1500,"1500"
D10299,7,12/26/2022,QLQ93QAZG9,1500,0
D10299,8,1/14/2023,RAE0D6ZJ52,2500,"4000"
D10299,8,1/18/2023,RAI2NDBBRW,2000,"2000"
D10299,8,1/23/2023,RAN016E2KC,1000,"1000"
D10299,8,1/25/2023,RAP94VBRE7,500,500
D10299,8,1/25/2023,RAP460QE0I,500,0
D10299,9,2/6/2023,RB671PP5Z1,1500,"12100"
D10299,9,2/6/2023,RB691PWS67,1500,"10600"
D10299,9,2/16/2023,RBG7ST588J,4000,"6600"
D10299,9,2/23/2023,RBN7AVNOQN,5000,"1600"
D10299,9,2/28/2023,RBS9OFDCD7,1600,0
D10299,10,3/17/2023,RCH2ZBUXC6,200,"12800"
D10299,10,3/17/2023,RCH0ZC5KA8,3800,"9000"
D10299,10,3/18/2023,RCI24D5HDU,2000,"7000"
D10299,10,3/20/2023,RCK29EMXEU,2000,"5000"
D10299,10,3/22/2023,RCM4F5W94Y,1000,"4000"
D10299,10,3/25/2023,RCP4MGN51W,1000,"3000"
D10299,10,3/28/2023,RCS9TKHV6L,3000,0
D10299,11,4/18/2023,RDI3GXE9DX,3000,"10000"
D10299,11,4/20/2023,RDK3LRQP09,3000,"7000"
D10299,11,4/28/2023,RDS298LANQ,2000,"5000"
D10299,11,4/30/2023,RDU8FBD2CU,2000,"3000"
D10299,11,5/2/2023,RE24JS05ES,2000,"1000"
D10299,11,5/2/2023,RE26KAX07G,1000,0
D10299,12,5/14/2023,REE4J3OGXO,10000,"9500"
D10299,12,5/18/2023,REI9VFQ51L,2000,"7500"
D10299,12,5/22/2023,REM14YKRTR,2000,"5500"
D10299,12,5/26/2023,REQ2GNM45W,2500,"3000"
D10299,12,5/30/2023,REU7T9R36D,1000,"2000"
D10299,12,6/1/2023,RF16WQMC72,1000,"1000"
D10299,12,6/2/2023,RF202LKJHQ,1000,0
D10299,13,6/13/2023,RFD8XDZGNI,100,"12900"
D10299,13,6/13/2023,RFD4XE3R2A,2900,"10000"
D10299,13,6/16/2023,RFG977QH9D,2000,"8000"
D10299,13,6/23/2023,RFN4S00VI2,3000,"5000"
D10299,13,6/28/2023,RFS65MD3XK,1000,"4000"
D10299,13,6/28/2023,RFS66VY01O,2000,"2000"
D10299,13,6/30/2023,RFU2BNDOYC,1000,"1000"
D10300,1,4/26/2022,QDQ81C7JTA,450,"5850"
D10300,1,4/27/2022,QDR62LDA28,210,"5640"
D10300,1,4/28/2022,QDS558S7FR,230,"5410"
D10300,1,4/29/2022,QDT276SOUM,204,"5206"
D10300,1,4/30/2022,QDU193G0BH,217,"4989"
D10300,1,5/2/2022,QE22B4FAKC,217,"4772"
D10300,1,5/3/2022,QE37EDO60F,317,"4455"
D10300,1,5/5/2022,QE52HA3D90,325,"4130"
D10300,1,5/6/2022,QE67KN3J1L,389,"3741"
D10300,1,5/9/2022,QE95OZB8CZ,375,"3366"
D10300,1,5/13/2022,QED6WMZQ06,434,"2932"
D10300,1,5/15/2022,QEF133XMV9,534,"2398"
D10300,1,5/20/2022,QEK6BA1YF0,2398,0
D10300,2,5/21/2022,QEL7DWAVQP,434,"6066"
D10300,2,5/24/2022,QEO3JMPC1J,434,"5632"
D10300,2,6/4/2022,QF485J1KKS,250,"5382"
D10300,2,6/6/2022,QF65AZ209J,234,"5148"
D10300,2,6/18/2022,QFI5MBZPJ,5148,0
D10300,3,7/16/2022,QGG6K0BTT2,6500,0
D10300,4,8/13/2022,QHD253PMJI,6500,0
D10300,5,9/10/2022,QIA2PDT5RS,6500,0
D10301,1,4/26/2022,QDQ91D4GRD,180,"4488"
D10301,1,4/27/2022,QDR42TSKIM,174,"4314"
D10301,1,4/28/2022,QDS94YWQYT,174,"4140"
D10301,1,4/29/2022,QDT26TD3ZG,174,"3966"
D10301,1,4/30/2022,QDU58QF42F,174,"3792"
D10301,1,5/1/2022,QE16ALQZPO,174,"3618"
D10301,1,5/2/2022,QE21CKXYCP,174,"3444"
D10301,1,5/3/2022,QE35EIQL0V,174,"3270"
D10301,1,5/4/2022,QE46GGNTFW,174,"3096"
D10301,1,5/5/2022,QE53I7A4FJ,174,"2922"
D10301,1,5/6/2022,QE69KJEEZ7,174,"2748"
D10301,1,5/7/2022,QE79M3ZIJ7,174,"2574"
D10301,1,5/8/2022,QE86OEG98K,174,"2400"
D10301,1,5/9/2022,QE90OTRUN2,2400,0
D10301,2,5/9/2022,QE92QAQK0K,174,"4978"
D10301,2,5/10/2022,QEA7S00F13,174,"4804"
D10301,2,5/12/2022,QEC4WB7BUI,348,"4456"
D10301,2,5/13/2022,QED0Y90OE4,174,"4282"
D10301,2,5/14/2022,QEE816S648,174,"4108"
D10301,2,5/20/2022,QEK5BRF25P,500,"3608"
D10301,2,5/21/2022,QEL2DPKFOA,370,"3238"
D10301,2,05/22/0202,QEM2G739KM,174,"3064"
D10301,2,5/23/2022,QEN2HZ596K,174,"2890"
D10301,2,5/24/2022,QEO1K3AM65,174,"2716"
D10301,2,5/25/2022,QEP5KSH7SZ,2716,0
D10301,3,6/7/2022,QF78BQE0JS,4600,0
D10301,4,6/24/2022,QFO9A696IZ,8330,0
D10301,5,7/30/2022,QGU3CR6TF9,900,"10160"
D10301,5,8/8/2022,QH80VCJUS0,1000,"9160"
D10302,1,5/6/2022,QE60KKU1SG,3500,"9300"
D10302,1,5/13/2022,QED8Y5OJ7Y,3500,"5800"
D10302,1,5/18/2022,QEI86ZAQDI,5800,0
D10302,2,1/31/2023,RAV2LY253C,3250,"9450"
D10302,2,2/17/2023,RBH4UXJYS0,9450,0
D10302,3,3/13/2023,RCD9OLG69N,12600,0
D10302,4,4/10/2023,RDA8URFXHG,13000,0
D10302,5,5/11/2023,REB29MJHS2,13600,0
D10302,6,6/6/2023,RF67EBZJD5,12700,0
D10302,7,7/6/2023,RG67UCT317,13600,0
D10302,8,8/21/2023,RHL9OXCR35,13000,"1600"
D10303,1,5/5/2022,QE50HZ3FQE,3250,"9750"
D10303,1,5/24/2022,QEO6IZA6JI,6800,"2950"
D10303,1,5/24/2022,QEO2JY7VQA,2950,0
D10303,2,6/22/2022,QFM66LMU3Y,13000,0
D10303,3,7/20/2022,QGK8SE0TPW,12900,0
D10303,4,8/24/2022,QHO8PQM7Y4,1000,"19400"
D10303,4,8/29/2022,QHT5ZRX1OZ,530,"18870"
D10304,1,5/20/2022,QEK2CCFBC0,4550,"4970"
D10304,1,5/24/2022,QEO0JFFDX0,1500,"3470"
D10304,1,5/25/2022,QEP3KMD6ON,2000,"1470"
D10304,1,5/25/2022,QEP4L5BEQM,500,970
D10304,1,5/26/2022,QEQ0MITSNA,550,420
D10304,1,6/14/2022,QFE9QDIGBZ,420,0
D10305,1,5/24/2022,QEO9J3RQ3B,250,"7650"
D10305,1,5/25/2022,QEP2KV9JIA,3250,"4400"
D10305,1,5/26/2022,QEQ1NH7H3J,550,"3850"
D10305,1,6/16/2022,QFG3U5LIQN,500,"3350"
D10306,1,5/5/2022,QE51IDTGUZ,347,"12293"
D10306,1,5/6/2022,QE64KC3OAK,347,"11946"
D10306,1,5/7/2022,QE74MDVSE6,347,"11599"
D10306,1,5/8/2022,QE88OBDRU8,347,"11252"
D10306,1,5/9/2022,QE90QD739C,347,"10905"
D10306,1,5/20/2022,QEK2B2R296,350,"10555"
D10306,1,5/21/2022,QEL7EJ1715,350,"10205"
D10306,1,5/22/2022,QEM6GAR508,350,"9855"
D10306,1,5/23/2022,QEN2I6X46A,350,"9505"
D10306,1,5/25/2022,QEP3LYPPIZ,694,"8811"
D10306,1,5/26/2022,QEQ2O2FFEC,347,"8464"
D10306,1,5/27/2022,QER8Q4F1K2,347,"8117"
D10306,1,5/28/2022,QES5S54Z5N,347,"7770"
D10306,1,5/29/2022,QET7TXCOCH,347,"7423"
D10306,1,5/30/2022,QEU3VV6ARN,347,"7076"
D10306,1,5/31/2022,QEV6XYM77S,347,"6729"
D10306,1,6/1/2022,QF14ZXO4BC,347,"6382"
D10306,1,6/2/2022,QF212VPD3H,347,"6035"
D10306,1,6/3/2022,QF324ZUTRC,400,"5635"
D10306,1,6/4/2022,QF446ZXYF6,347,"5288"
D10306,1,6/5/2022,QF588SUL0G,347,"4941"
D10306,1,6/6/2022,QF69AWGAQP,347,"4594"
D10306,1,7/12/2022,QGC0CM2G4Y,800,"3794"
D10306,1,8/26/2022,QHQ8T5TXES,300,"3494"
D10307,1,5/10/2022,QEA0SFWOWO,305,"8545"
D10307,1,5/11/2022,QEB5UEDUJT,305,"8240"
D10307,1,05/12/2022,QEC0W8U2QW,305,"7935"
D10307,1,5/13/2022,QED1Y91KHZ,305,"7630"
D10307,1,5/16/2022,QEG33KA4E7,915,"6715"
D10307,1,5/20/2022,QEK9BAGKY3,915,"5800"
D10307,1,5/30/2022,QEU7UR3YRL,5800,0
D10307,2,6/23/2022,QFN888KXI,8750,0
D10307,3,7/19/2022,QGJ7Q3ETFP,8890,0
D10307,4,8/16/2022,QHG3AOVODL,9100,0
D10307,5,9/1/2022,QHV64HOY4I,500,"8600"
D10307,5,9/10/2022,QIA6PDBPV6,1000,"7600"
D10307,5,9/15/2022,QIF71BTS0N,7600,0
D10307,6,10/17/2022,QJH631893C,9100,0
D10307,7,11/16/2022,QKG32RVSZP,300,"9920"
D10307,7,11/18/2022,QKI667OOG4,300,"9620"
D10307,7,11/22/2022,QKM9GFZUDP,300,"9320"
D10307,7,11/25/2022,QKP9O2X8LL,500,"8820"
D10307,7,11/29/2022,QKT5XBF3LH,700,"8120"
D10307,7,12/2/2022,QL2468RH0Q,300,"7820"
D10307,7,12/5/2022,QL56EQGQD6,800,"7020"
D10307,7,12/8/2022,QL84NXWHNQ,350,"6670"
D10307,7,12/16/2022,QLG4ALIKRI,500,"6170"
D10307,7,12/21/2022,QLL9ODSWST,350,"5820"
D10307,7,12/22/2022,QLM8SHPFQW,200,"5620"
D10307,7,12/24/2022,QLO1WB6601,300,"5320"
D10307,7,1/3/2023,RA39MRQIJH,250,"5070"
D10308,1,5/13/2022,QED1XDXPRP,600,"5900"
D10308,1,6/4/2022,QF485UVBTW,250,"5650"
D10308,1,6/5/2022,QF598XW03N,900,"4750"
D10308,1,6/7/2022,QF79C4WF15,4750,0
D10308,2,6/28/2022,QFS9HP7HNZ,500,"6000"
D10308,2,7/3/2022,QG39T4JWHD,700,"5300"
D10308,2,7/5/2022,QG55WDFY6Z,5300,0
D10308,3,7/7/2022,QG742G306C,217,"5533"
D10308,3,7/18/2022,QGI7O4F8J7,1500,"4033"
D10308,3,7/19/2022,QGJ0PONX8C,3300,733
D10308,3,7/19/2022,QGJ1PQEF0V,733,0
D10308,4,8/12/2022,QHC147A5N7,100,"6400"
D10308,4,8/17/2022,QHH9CJEN1F,6400,0
D10309,1,5/10/2022,QEA7S5P5FT,350,"10050"
D10309,1,5/11/2022,QEB7U3ZIVZ,350,"9700"
D10309,1,5/12/2022,QEC0W0PPCG,350,"9350"
D10309,1,5/13/2022,QED4Y71R0U,300,"9050"
D10309,1,5/14/2022,QEE4174XKO,390,"8660"
D10309,1,5/15/2022,QEF02PAWCO,335,"8325"
D10309,1,5/16/2022,QEG34XYVMT,330,"7995"
D10309,1,5/20/2022,QEK9CE2A0B,880,"7115"
D10309,1,5/24/2022,QEO8JYX3AO,440,"6675"
D10309,1,6/7/2022,QF71BR9IDD,1350,"5325"
D10309,1,6/7/2022,QF71C0RSBD,5325,0
D10309,2,6/30/2022,QFU0LMPERG,9920,0
D10309,3,7/13/2022,QGD9EINOR3,9120,0
D10309,4,8/19/2022,QHJ0GXYALG,500,"11180"
D10310,1,5/17/2022,QEH66PMG6G,100,"3800"
D10310,1,5/17/2022,QEH36PSKY5,30,"3770"
D10310,1,5/10/2022,QEA1RVVIJF,130,"3640"
D10310,1,5/11/2022,QEB5U6EZ3H,130,"3510"
D10310,1,5/12/2022,QEC0W7FISK,100,"3410"
D10310,1,5/12/2022,QEC9W7WVWZ,30,"3380"
D10310,1,5/13/2022,QED1Y924EN,100,"3280"
D10310,1,5/13/2022,QED3Y9KQDV,30,"3250"
D10310,1,5/14/2022,QEE0111VCE,100,"3150"
D10310,1,5/14/2022,QEE91473D1,30,"3120"
D10310,1,5/15/2022,QEF52ZMU83,100,"3020"
D10310,1,5/15/2022,QEF82ZSSSC,30,"2990"
D10310,1,5/16/2022,QEG24UIE06,100,"2890"
D10310,1,5/16/2022,QEG44UP370,30,"2860"
D10310,1,5/18/2022,QEI68OZL4O,100,"2760"
D10310,1,5/18/2022,QEI88P4EY8,30,"2730"
D10310,1,5/20/2022,QEK4APKJAA,30,"2700"
D10310,1,5/20/2022,QEK0CKN9D8,100,"2600"
D10310,1,5/20/2022,QEK0CKR0XI,30,"2570"
D10310,1,5/21/2022,QEL7EESXUX,100,"2470"
D10310,1,5/21/2022,QEL3EEXRAP,30,"2440"
D10310,1,5/22/2022,QEM3G9FIPZ,100,"2340"
D10310,1,5/22/2022,QEM8G9IC9O,30,"2310"
D10310,1,5/24/2022,QEO2ICJK94,30,"2280"
D10310,1,5/24/2022,QEO7K4Y0Z9,100,"2180"
D10310,1,5/24/2022,QEO9K526JR,30,"2150"
D10310,1,5/25/2022,QEP1M1080Z,100,"2050"
D10310,1,5/25/2022,QEP6M14KCW,30,"2020"
D10310,1,5/26/2022,QEQ0NXH0QG,100,"1920"
D10310,1,5/26/2022,QEQ6NYU62Q,30,"1890"
D10310,1,5/28/2022,QES7S2TL61,100,"1790"
D10310,1,5/28/2022,QES6S31AP4,30,"1760"
D10310,1,5/30/2022,QEU9U4SHTL,100,"1660"
D10310,1,5/30/2022,QEU6U4WETM,30,"1630"
D10310,1,6/6/2022,QF629WMRQQ,100,"1530"
D10310,1,6/6/2022,QF699WYI9H,30,"1500"
D10310,1,6/8/2022,QF81ET9MCZ,1500,0
D10310,2,6/9/2022,QF94GRWGA8,100,"3800"
D10310,2,6/9/2022,QF90GSTSWC,30,"3770"
D10310,2,6/11/2022,QFB7KTOJSR,100,"3670"
D10310,2,6/11/2022,QFB5KU4NOT,30,"3640"
D10310,2,6/13/2022,QFD7OQLTGL,100,"3540"
D10310,2,7/4/2022,QG48TP4P0U,2000,"1540"
D10310,2,7/6/2022,QG62ZYMB9G,100,"1440"
D10310,2,7/6/2022,QG69ZYOZVF,100,"1340"
D10310,2,7/6/2022,QG68ZYSG00,100,"1240"
D10310,2,7/6/2022,QG64ZYXVII,100,"1140"
D10310,2,7/6/2022,QG64ZZ04FA,100,"1040"
D10310,2,7/7/2022,QG7610UECE,100,940
D10310,2,7/7/2022,QG7810UZ1G,100,840
D10310,2,7/7/2022,QG7510VPNF,100,740
D10310,2,7/7/2022,QG771ADYS1,740,0
D10310,3,8/4/2022,QH45MM48G3,2900,"1000"
D10310,3,8/4/2022,QH41OCJZW9,1000,0
D10310,4,9/6/2022,QI679GJMJ,1900,"2180"
D10310,4,9/6/2022,QI63HJ3KJF,1190,990
D10310,4,9/7/2022,QI74IO62WW,600,390
D10310,4,9/7/2022,QI70JFNKBW,100,290
D10310,4,9/7/2022,QI78JFW5NY,100,190
D10310,4,9/7/2022,QI73JGB6SD,100,90
D10310,4,9/7/2022,QI78JGTY1O,90,0
D10310,5,10/5/2022,QJ50BWPQVK,3000,900
D10310,5,10/6/2022,QJ61E47F1P,900,0
D10310,6,10/29/2022,QJU0WWPALA,300,"3780"
D10310,6,10/31/2022,QJV8ZO8FFG,350,"3430"
D10310,6,11/1/2022,QK142T65LQ,400,"3030"
D10310,6,11/2/2022,QK2557ICLR,450,"2580"
D10310,6,11/3/2022,QK327OZY84,500,"2080"
D10310,6,11/5/2022,QK50C1CXY8,500,"1580"
D10310,6,11/5/2022,QK57CVXOL1,750,830
D10310,6,11/6/2022,QK64EWGYSK,650,180
D10310,6,11/7/2022,QK76FITUFY,100,80
D10310,6,11/7/2022,QK74FIYKI4,80,0
D10310,7,12/2/2022,QL2555YIJ9,3900,0
D10310,8,12/31/2022,QLV1FTOE09,2500,"1400"
D10310,8,1/1/2023,RA10I8HKHK,1400,0
D10310,9,2/3/2023,RB36T6P178,3000,900
D10310,9,2/3/2023,RB36UC63OG,900,0
D10310,10,3/4/2023,RC45YCHZRZ,3900,0
D10310,11,4/2/2023,RD34B6A0PW,4080,0
D10310,12,5/3/2023,RE38NXMZXW,4000,100
D10310,13,5/6/2023,RE67WDD2TX,130,"3770"
D10310,13,5/7/2023,RE77Z69T0X,130,"3640"
D10310,13,5/8/2023,RE803F6GP0,130,"3510"
D10310,13,5/9/2023,RE936CRYR7,130,"3380"
D10310,13,5/10/2023,REA5943X7T,130,"3250"
D10310,13,5/11/2023,REB5B61HZ5,130,"3120"
D10310,13,5/12/2023,REC4EFYL1Y,130,"2990"
D10310,13,5/18/2023,REI1V5KLJZ,130,"2860"
D10310,13,6/1/2023,RF15ZDJL11,1000,"1860"
D10310,13,6/4/2023,RF458XH73H,1860,0
D10310,14,7/26/2023,RGQ2GNGCC8,440,"4300"
D10311,1,6/16/2022,QFG6U5MYNC,500,"15300"
D10311,1,6/20/2022,QFK32ZAEMZ,375,"14925"
D10311,1,6/21/2022,QFL74X1D1P,300,"14625"
D10311,1,6/26/2022,QFQ6F3D6D6,600,"14025"
D10311,1,6/29/2022,QFT0JFF3JY,500,"13525"
D10311,1,7/3/2022,QG34TGHKWU,500,"13025"
D10311,1,7/14/2022,QGE5GRO26P,100,"12925"
D10311,1,7/14/2022,QGE6GRXWXK,100,"12825"
D10311,1,7/17/2022,QGH9N3P1MP,1000,"11825"
D10311,1,7/23/2022,QGN0X8MQ06,800,"11025"
D10311,1,7/26/2022,QGQ03XPV7Q,500,"10525"
D10311,1,8/1/2022,QH14H3IGLY,700,"9825"
D10311,1,8/2/2022,QH22JMU0AG,700,"9125"
D10311,1,8/3/2022,QH32LSEJN2,700,"8425"
D10311,1,8/19/2022,QHJ2GR7AW0,300,"8125"
D10311,1,9/2/2022,QI248IHCT0,500,"7625"
D10311,1,9/9/2022,QI98N36LBE,200,"7425"
D10311,1,9/17/2022,QIH653ZN82,500,"6925"
D10311,1,9/20/2022,QIK8D0TSGC,80,"6845"
D10311,1,9/21/2022,QIL3EUJKVJ,100,"6745"
D10311,1,9/21/2022,QIL6EUPSZE,100,"6645"
D10311,1,9/26/2022,QIQ4OFMSQO,300,"6345"
D10311,1,9/28/2022,QIS8SONJB8,200,"6145"
D10311,1,9/29/2022,QIT6VR3W9Y,20,"6125"
D10311,1,9/30/2022,QIU6X29J94,200,"5925"
D10311,1,10/12/2022,QJC7QJLGPP,470,"5455"
D10311,1,10/25/2022,QJP8K9YXX4,200,"5255"
D10311,1,1/12/2023,RAC88CFX0A,200,"5055"
D10311,1,1/23/2023,RAN6ZLZ8FC,200,"4855"
D10311,1,1/30/2023,RAU9IE2OEH,200,"4655"
D10312,1,5/26/2022,QEQ0N0E5DU,6500,0
D10312,2,6/22/2022,QFM26I2ZK6,6500,0
D10312,3,7/21/2022,QGL6TSRKHA,6500,0
D10312,4,8/19/2022,QHJ8G59RCE,6500,300
D10312,4,8/19/2022,QHJ6GCICE4,300,0
D10312,5,9/16/2022,QIG53EO667,6500,0
D10313,1,6/2/2022,QF232WPN83,500,"6300"
D10313,1,6/8/2022,QF82EZ2LQY,1500,"4800"
D10313,1,6/9/2022,QF96GZNG3S,1000,"3800"
D10313,1,6/10/2022,QFA7J25RGX,2500,"1300"
D10313,1,6/11/2022,QFB3KZ82Z3,1300,0
D10313,2,7/3/2022,QG33TJTOON,3500,"2750"
D10313,2,7/6/2022,QG63ZXVH43,1700,"1050"
D10313,2,7/7/2022,QG721VHCQ0,1050,0
D10313,3,8/4/2022,QH42NDILP2,1000,"5800"
D10313,3,8/4/2022,QH42OBKEYY,1000,"4800"
D10313,3,8/5/2022,QH50PTRSJW,3500,"1300"
D10313,3,8/5/2022,QH58Q1HVR6,1300,0
D10313,4,9/7/2022,QI71K13BRT,1000,"6900"
D10313,4,9/9/2022,QI96N1B1HI,1000,"5900"
D10313,4,9/17/2022,QIH05GVZNU,800,"5100"
D10313,4,9/21/2022,QIL6FAP7WC,500,"4600"
D10314,1,5/17/2022,QEH36PM4DN,130,"3950"
D10314,1,5/27/2022,QER3P83R1J,1350,"2600"
D10314,1,6/15/2022,QFF2SCR3M0,2350,250
D10314,1,6/22/2022,QFM77GUQN5,70,180
D10314,1,6/25/2022,QFP8BN4QMC,180,0
D10315,1,6/2/2022,QF271ONE9L,770,"5730"
D10315,1,6/4/2022,QF455TYCS7,470,"5260"
D10315,1,6/14/2022,QFE3P7PR8V,5260,0
D10315,2,7/4/2022,QG46TNNX4Y,4000,"2250"
D10315,2,7/7/2022,QG791D7CR9,2250,0
D10315,3,7/26/2022,QGQ2470GBE,3250,"3200"
D10315,3,8/2/2022,QH21K3MQZP,3200,0
D10315,4,8/28/2022,QHS3YNALXR,6400,0
D10315,5,9/26/2022,QIQ0OCJ78K,6500,0
D10315,6,10/25/2022,QJP7K5HJZV,6800,0
D10315,7,12/10/2022,QLA1U9DN3X,485,"7415"
D10315,7,12/15/2022,QLF67JLM2A,200,"7215"
D10315,7,12/16/2022,QLG5AGZX0B,200,"7015"
D10315,7,12/19/2022,QLJ4I2GCTC,100,"6915"
D10315,7,12/19/2022,QLJ3I29PEZ,100,"6815"
D10315,7,12/29/2022,QLT78T5T33,300,"6515"
D10315,7,1/3/2023,RA33LBA461,500,"6015"
D10315,7,1/4/2023,RA49PAJOJ7,200,"5815"
D10315,7,1/8/2023,RA86Z0HN6A,250,"5565"
D10315,7,1/12/2023,RAC89WHUNW,300,"5265"
D10315,7,1/15/2023,RAF4H5MH3K,200,"5065"
D10315,7,1/16/2023,RAG2JNA618,150,"4915"
D10315,7,1/19/2023,RAJ6R6H0CY,150,"4765"
D10315,7,1/20/2023,RAK0TSGA3E,150,"4615"
D10315,7,1/24/2023,RAO03QYNSQ,200,"4415"
D10315,7,1/28/2023,RAS6D8S2M8,100,"4315"
D10315,7,1/31/2022,RAV3KHXDRX,100,"4215"
D10315,7,2/4/2023,RB49V6CGYF,200,"4015"
D10315,7,2/9/2023,RB959803W3,150,"3865"
D10315,7,2/20/2023,RBK53A7JN3,100,"3765"
D10315,7,2/20/2023,RBK33AF4J7,100,"3665"
D10315,7,2/27/2023,RBR7L2KNWT,200,"3465"
D10315,7,3/3/2023,RC38W4SC02,100,"3365"
D10315,7,3/3/2023,RC39W54E3V,100,"3265"
D10315,7,3/6/2023,RC6550M283,200,"3065"
D10315,7,3/13/2023,RCD8O6HL0U,200,"2865"
D10316,1,5/26/2022,QEQ6N775QI,1625,"4875"
D10316,1,6/2/2022,QF282T6K9W,1625,"3250"
D10316,1,6/12/2022,QFC8MUS8B4,1625,"1625"
D10316,1,6/16/2022,QFG2TYQYRW,1625,0
D10316,2,6/23/2022,QFN79EOZ91,1625,"4875"
D10316,2,7/3/2022,QG38T37P40,1625,"3250"
D10316,2,7/10/2022,QGA786TCHZ,1625,"1625"
D10316,2,7/13/2022,QGD2DXI5VM,1625,0
D10316,3,7/24/2022,QGO81RGT0K,1625,"4875"
D10316,3,8/1/2022,QH13H5TF5R,1625,"3250"
D10316,3,8/7/2022,QH78TOPR4Y,1625,"1625"
D10316,3,8/7/2022,QH71UMDWTP,1625,0
D10317,1,6/21/2022,QFL13W3HGZ,3000,"3000"
D10317,1,6/23/2022,QFN78J5W3F,100,"3100"
D10317,1,6/23/2022,QFN48J84KA,100,"3200"
D10317,1,6/23/2022,QFN28JAKLY,100,"3300"
D10318,1,6/22/2022,QFM86OXNJI,13000,0
D10318,2,7/18/2022,QGI3NQEPX7,12700,0
D10319,1,5/28/2022,QES9RXIEQB,217,"6183"
D10319,1,5/29/2022,QET6TC7C24,217,"5966"
D10319,1,5/30/2022,QEU1VMC8CL,217,"5749"
D10319,1,5/31/2022,QEV7XFD7CH,217,"5532"
D10319,1,6/1/2022,QF13ZJPYRD,217,"5315"
D10319,1,6/2/2022,QF202KZ1X4,217,"5098"
D10319,1,6/3/2022,QF354PVLFJ,217,"4881"
D10319,1,6/4/2022,QF416QC8OP,217,"4664"
D10319,1,6/5/2022,QF568JSCHW,217,"4447"
D10319,1,6/8/2022,QF74CWDCFU,217,"4230"
D10319,1,6/8/2022,QF84ERDU4Q,217,"4013"
D10319,1,6/9/2022,QF92GWLREM,217,"3796"
D10319,1,6/10/2022,QFA8IWDM9E,217,"3579"
D10319,1,6/14/2022,QFE2QG8WOG,1085,"2494"
D10319,1,6/15/2022,QFF2STV6ZI,217,"2277"
D10319,1,6/17/2022,QFH4WRXXFE,434,"1843"
D10319,1,6/19/2022,QFJ41HUIUI,434,"1409"
D10319,1,6/22/2022,QFM16BJE9H,1409,0
D10319,2,7/7/2022,QG7031FB4G,217,"6283"
D10319,2,7/19/2022,QGJ7POYIUB,6283,0
D10319,3,7/23/2022,QGN4YZJ7A4,434,"6066"
D10319,3,7/24/2022,QGO21D8VSG,217,"5849"
D10319,3,7/27/2022,QGR65SPTOK,300,"5549"
D10319,3,8/16/2022,QHG8ACN80K,5549,0
D10319,4,9/15/2022,QIF81KRH5I,6500,0
D10319,5,10/11/2022,QJB9POK90L,5000,"1450"
D10319,5,10/12/2022,QJC0Q54QEU,1450,0
D10319,6,11/11/2022,QKB1QMYBPN,400,"7500"
D10320,1,6/2/2022,QF242MOE7K,434,"6066"
D10320,1,6/3/2022,QF354MJKM3,217,"5849"
D10320,1,6/6/2022,QF67ALTNAJ,434,"5415"
D10320,1,6/17/2022,QFH4WLHOH8,400,"5015"
D10320,1,6/20/2022,QFK73CIUQD,217,"4798"
D10320,1,6/22/2022,QFM47AFE9O,217,"4581"
D10320,1,6/27/2022,QFR1GXXYRX,1100,"3481"
D10320,1,6/28/2022,QFS8HQGT96,3481,0
D10320,2,7/25/2022,QGP62B2CN6,6400,0
D10320,3,8/19/2022,QHJ8FTLAA8,6300,0
D10320,4,9/6/2022,QI69I38RIF,6000,0
D10320,5,10/7/2022,QJ70GGCW7M,6000,500
D10320,5,10/8/2022,QJ83H1W07V,500,0
D10320,6,10/25/2022,QJP8LOWBYG,100,"8930"
D10320,6,11/5/2022,QK57BG9XUN,8930,0
D10320,7,27/12/2022,QLR34PBWYH,1100,"9120"
D10321,1,6/24/2022,QFO5AUSSBD,2000,"4500"
D10321,1,6/28/2022,QFS5HVGX03,500,"4000"
D10321,1,6/30/2022,QFU7MEUG1T,900,"3100"
D10321,1,7/1/2022,QG13OF0HYN,3100,0
D10321,2,7/29/2022,QGT4AU4LIQ,6500,0
D10321,3,8/23/2022,QHN6NYIWEA,450,"6050"
D10321,3,8/26/2022,QHQ8TT2KM6,6050,0
D10321,4,9/23/2022,QIN9ITSCE3,1500,"6400"
D10321,4,9/24/2022,QIO1KLCBF7,100,"6300"
D10321,4,9/24/2022,QIO5KLIQV9,100,"6200"
D10321,4,9/26/2022,QIQ6OGPLZ0,950,"5250"
D10321,4,10/5/2022,QJ51AMR91H,500,"4750"
D10321,4,10/17/2022,QJH92SN4EN,500,"4250"
D10321,4,11/8/2022,QK86I9TUJQ,200,"4050"
D10321,4,11/14/2022,QKE6WLEFTA,200,"3850"
D10321,4,11/22/2022,QKM4F3U4CA,100,"3750"
D10321,4,1/30/2023,RAU5IN9ZPF,200,"3550"
D10321,4,3/9/2023,RC93EEZQ81,400,"3150"
D10321,4,3/13/2023,RCD1PAOW3H,400,"2750"
D10322,1,6/5/2022,QF588SH1GI,420,"6080"
D10322,1,6/6/2022,QF69AV6XYZ,215,"5865"
D10322,1,6/13/2022,QFD8OTTQFK,1000,"4865"
D10322,1,6/21/2022,QFL33UNTM1,1200,"3665"
D10322,1,6/26/2022,QFQ5F59AKB,1000,"2665"
D10322,1,7/1/2022,QG18OXOW4Q,2665,0
D10322,2,7/22/2022,QGM5VCCX6V,1500,"4600"
D10322,2,7/28/2022,QGS18VJ7PL,4600,0
D10322,3,8/11/2022,QHB21NOU9K,1600,"4900"
D10322,3,8/15/2022,QHF59VU3OD,900,"4000"
D10322,3,8/25/2022,QHP8RXNFAA,4000,0
D10322,4,9/23/2022,QIN9ITNC9N,3000,"3800"
D10322,4,9/24/2022,QIO7JTJ1YZ,1300,"2500"
D10322,4,9/26/2022,QIQ4O2ZYJK,1950,550
D10322,4,9/26/2022,QIQ7OMR6GD,550,0
D10322,5,10/20/2022,QJK5AQZHGV,1500,"5000"
D10322,5,10/25/2022,QJP2KM1VJM,5000,0
D10322,6,11/24/2022,QKO6KJ2FCI,3500,"3300"
D10322,6,11/25/2022,QKP7M2MLJV,1500,"1800"
D10322,6,11/18/2022,QKS1TG34OP,1800,0
D10323,1,6/4/2022,QF406RNZUO,217,"6133"
D10323,1,6/5/2022,QF598TCQ6D,200,"5933"
D10323,1,6/8/2022,QF89E5I8HH,434,"5499"
D10323,1,6/12/2022,QFC2MI91PW,900,"4599"
D10323,1,6/17/2022,QFH9W2EQYB,2000,"2599"
D10323,1,6/21/2022,QFL5573QQX,1519,"1080"
D10323,1,6/28/2022,QFS6IMBWJY,1080,0
D10323,2,7/27/2022,QGR85YYRIK,6500,0
D10323,3,8/16/2022,QHG1A6B595,6100,0
D10323,4,9/14/2022,QIE1YJ8PXR,6500,0
D10323,5,10/12/2022,QJC6PVQU7M,6500,0
D10323,6,11/11/2022,QKB8PZRUFQ,6500,0
D10323,7,12/13/2022,QLD93STRR5,6800,0
D10324,1,6/9/2022,QF91G2HJMZ,217,"6283"
D10324,1,6/10/2022,QFA5IY8J2T,217,"6066"
D10324,1,6/12/2022,QFC8LF4C74,217,"5849"
D10324,1,6/12/2022,QFC1MDNK4T,217,"5632"
D10324,1,7/5/2022,QG51W2QFAB,400,"5232"
D10324,1,7/1/2022,QG15OSK9X1,500,"4732"
D10324,1,7/6/2022,QG60YFV3S4,4732,0
D10324,2,7/30/2022,QGU0CCQJEW,6250,0
D10324,3,8/27/2022,QHR1VNC5TB,1800,"4700"
D10324,3,8/27/2022,QHR7VPEDHR,200,"4500"
D10324,3,8/27/2022,QHR8VXZZCC,4500,0
D10325,1,6/23/2022,QFN27OI59E,1625,"4479"
D10325,1,6/28/2022,QFS0HP16WY,4479,0
D10325,2,7/21/2022,QGL8U64OCC,1625,"4779"
D10325,2,7/25/2022,QGP12XR0CR,4779,0
D10325,3,7/27/2022,QGR07NN03E,100,"6300"
D10325,3,7/27/2022,QGR07NQW8O,100,"6200"
D10325,3,7/29/2022,QGT2BAUIOE,100,"6100"
D10325,3,7/29/2022,QGT3BBEEFD,100,"6000"
D10325,3,7/29/2022,QGT6BBKJGO,36,"5964"
D10325,3,7/30/2022,QGU3DKTN3P,100,"5864"
D10325,3,7/30/2022,QGU5DL2DTR,100,"5764"
D10325,3,7/30/2022,QGU0DLGCP8,14,"5750"
D10325,3,8/2/2022,QH27ID13T3,17,"5733"
D10325,3,8/2/2022,QH24IDAGAW,100,"5633"
D10325,3,8/2/2022,QH21IDF933,100,"5533"
D10325,3,8/15/2022,QHF994K8T9,100,"5433"
D10325,3,8/15/2022,QHF194MWHH,100,"5333"
D10325,3,8/15/2022,QHF094WPM8,100,"5233"
D10325,3,8/15/2022,QHF4955TF6,100,"5133"
D10325,3,8/15/2022,QHF2964CQU,50,"5083"
D10325,3,8/18/2022,QHI2DVQKMU,100,"4983"
D10325,3,8/18/2022,QHI7DVYDYR,100,"4883"
D10325,3,8/18/2022,QHI6DWAC4U,100,"4783"
D10325,3,8/18/2022,QHI9DWFBM1,100,"4683"
D10325,3,8/22/2022,QHM3MDXI9D,4683,0
D10325,4,9/21/2022,QIL5DMLMKR,6500,300
D10325,4,9/23/2022,QIN9HRP7DP,100,200
D10325,4,9/23/2022,QIN3HRSB9B,100,100
D10325,4,9/27/2022,QIR6QQ1G7K,100,0
D10326,1,6/17/2022,QFH4WMAIRK,1625,"4875"
D10326,1,7/13/2022,QGD2F8PT64,3000,"1875"
D10326,1,7/15/2022,QGF8JB3XE8,1875,0
D10326,1,6/14/2022,QFE8QMX11K,217,"6283"
D10327,1,6/15/2022,QFF1SPW3CB,217,"6066"
D10327,1,6/17/2022,QFH7WK5K6T,217,"5849"
D10327,1,6/22/2022,QFM05XRVLS,200,"5649"
D10327,1,7/1/2022,QG15OSK9X1_D2,500,"5149"
D10327,1,07/01/20200,QG11ORGTEV,250,"4899"
D10327,1,7/2/2022,QG26RDUUIS,350,"4549"
D10327,1,7/4/2022,QG45V6625P,1000,"3549"
D10327,1,7/5/2022,QG59XM9FWD,500,"3049"
D10327,1,7/8/2022,QG854NCXBH,540,"2509"
D10327,1,7/10/2022,QGA490DYWQ,350,"2159"
D10327,1,7/11/2022,QGB59VF7H1,1450,709
D10327,1,7/11/2022,QGB69VM0G0,700,9
D10327,1,7/11/2022,QGB19XCFWP,100,91
D10327,2,7/28/2022,QGS282MK78,5850,0
D10327,3,8/26/2022,QHQ4TWF8RI,1050,"5450"
D10327,3,8/29/2022,QHT7Z77RZV,450,"5000"
D10327,3,8/30/2022,QHU5335Q1H,200,"4800"
D10327,3,9/2/2022,QI208KDEWS,500,"4300"
D10327,3,9/5/2022,QI53FMEB15,500,"3800"
D10327,3,9/6/2022,QI66GTZ0VA,500,"3300"
D10327,3,9/7/2022,QI73JBD7P3,500,"2800"
D10327,3,9/10/2022,QIA7PIRFTN,500,"2300"
D10327,3,9/12/2022,QIC2TOJUCI,500,"1800"
D10328,1,7/6/2022,QG61YGY3SV,6150,0
D10328,2,7/29/2022,QGT5A9ARRR,6200,0
D10328,3,8/18/2022,QHI1E0D0HR,6050,0
D10328,4,9/2/2022,QI218L6B4L,5850,0
D10329,1,6/26/2022,QFQ0DIEFKK,1625,"4875"
D10329,1,7/16/2022,QGG7KHK807,4875,0
D10329,2,8/2/2022,QH28IB0JYQ,1625,"4875"
D10329,2,8/4/2022,QH49OCC7SB,1625,"3250"
D10329,2,8/11/2022,QHB02N0R08,1625,"1625"
D10329,2,8/11/2022,QHC43JABNI,1625,0
D10329,3,11/23/2022,QKN7IDK2EP,1625,"4825"
D10329,3,12/9/2022,QL91R3Q47J,3200,"1625"
D10329,3,12/9/2022,QL92R5RHF6,1625,0
D10329,4,1/6/2022,RA61SJB071,6500,0
D10329,5,2/3/2023,RB38TN753Q,6500,0
D10329,6,3/4/2023,RC44ZDEFSO,6500,"1300"
D10329,6,3/30/2023,RCU7YIWTCR,1300,0
D10329,7,3/30/2023,RCU1YI8DGH,6400,0
D10329,8,4/28/2023,RDS585Z183,6500,"1300"
D10329,8,4/28/2023,RDS98NE4YL,1300,0
D10330,1,6/27/2022,QFR0FO9CBY,1625,"4875"
D10330,1,7/4/2022,QG42U222ZG,1625,"3250"
D10330,1,7/11/2022,QGB5A13PU1,1625,"1625"
D10330,1,7/18/2022,QGI5OFE93F,1625,0
D10330,2,7/27/2022,QGR76D9P0T,1625,"4875"
D10330,2,8/4/2022,QH43MDT8DD,1625,"3250"
D10330,2,8/10/2022,QHA3ZWFZWT,1625,"1625"
D10330,2,8/17/2022,QHH2CYF0MY,1625,0
D10331,1,6/30/2022,QFU4N9W61S,1000,"4850"
D10331,1,7/5/2022,QG54WA6NFI,4850,0
D10331,2,7/12/2022,QGC0BOW3DW,5600,0
D10331,3,8/12/2022,QHC13T3I8P,1160,"5640"
D10331,3,8/15/2022,QHF58YZZV7,5460,180
D10331,3,8/15/2022,QHF090FCRC,100,80
D10331,3,8/15/2022,QHF390Q4O5,80,0
D10332,1,6/28/2022,QFS1HIBBL3,3250,"9750"
D10332,1,7/5/2022,QG55X9NUNR,3250,"6500"
D10332,1,7/12/2022,QGC6D3ME2C,3250,"3250"
D10332,1,7/19/2022,QGJ5PQHZ2Z,3250,0
D10332,2,8/1/2022,QH16HPMBIS,3250,"3250"
D10332,2,8/8/2022,QH87WKAJ0V,3250,"6500"
D10332,2,8/15/2022,QHF49OYZ8O,3500,"10000"
D10332,2,8/22/2022,QHM3MONZ5T,3250,"13250"
D10332,3,10/12/2022,QJC5RODFBP,9520,0
D10333,1,7/19/2022,QGJ1Q7GBPB,6500,0
D10333,2,8/19/2022,QHJ7FV35VR,1000,"6300"
D10333,2,8/20/2022,QHK5JAG3L1,3000,"3300"
D10333,2,8/22/2022,QHM4MWOWUY,500,"2800"
D10333,2,8/24/2022,QHO0PY35QM,480,"2320"
D10333,2,8/28/2022,QHS8XA6F4A,1300,"1020"
D10333,2,8/28/2022,QHS0YONVXA,100,920
D10333,2,8/28/2022,QHS0YOTDUA,100,820
D10333,2,8/28/2022,QHS4YOW9NM,20,800
D10334,1,7/21/2022,WE GL1TSU17B,13000,0
D10334,2,8/20/2022,QHK5IA4KB7,1000,"14800"
D10334,2,8/24/2022,QHO4QQ3ZBI,100,"14700"
D10334,2,8/24/2022,QHO4QQBAA6,100,"14600"
D10334,2,8/24/2022,QHO1QQH467,50,"14550"
D10334,2,9/4/2022,QI48DXYFOO,750,"13800"
D10334,2,9/14/2022,QIE4YZBYEG,100,"13700"
D10334,2,9/14/2022,QIE0YZLBPE,40,"13660"
D10335,1,7/1/2022,QG19P637NZ,1000,"5250"
D10335,1,7/4/2022,QG43VMQMBB,500,"4750"
D10335,1,7/15/2022,QGF4JCTDEC,600,"4150"
D10335,1,7/19/2022,QGJ4Q51ZBG,4150,0
D10335,2,8/4/2022,QH41N7LNMP,1000,"5500"
D10335,2,8/6/2022,QH50QHY7RE,500,"5000"
D10335,2,8/16/2022,QHG0ANY5U8,5000,0
D10335,3,8/30/2022,QHU03QQ76W,1000,"5500"
D10335,3,9/5/2022,QI50GC37MU,500,"5000"
D10335,3,9/15/2022,QIF7ZMVBMB,5000,0
D10335,4,10/3/2022,QJ315E0CA5,2000,"4500"
D10335,4,10/14/2022,QJE9V6ISQ5,4500,0
D10335,5,11/12/2022,QKC0R392HM,7800,360
D10335,5,11/12/2022,QKC0RKCCLS,360,0
D10335,6,12/10/2022,QLA5UGO98N,500,"8260"
D10335,6,12/11/2022,QLB1Y5NSBF,1000,"7260"
D10335,6,12/13/2022,QLD23SBP3M,1000,"6260"
D10335,6,12/16/2022,QLG1CH4HVF,450,"5810"
D10335,6,12/18/2022,QLI8HQ0WTE,100,"5710"
D10335,6,12/20/2022,QLK2KNU734,600,"5110"
D10335,6,12/21/2022,QLL0NDHP20,500,"4610"
D10335,6,12/23/2022,QLN0V7SP1I,700,"3910"
D10335,6,12/30/2022,QLU2D7OLTI,500,"3410"
D10335,6,1/5/2023,RA59QX9ECZ,300,"3110"
D10335,6,1/12/2023,RAC98RP9U5,100,"3010"
D10335,6,5/6/2023,RE60U35DKE,100,"2910"
D10335,6,5/6/2023,RE65U39JTP,100,"2810"
D10336,1,7/18/2022,QGI2O00SBO,6050,0
D10336,2,8/24/2022,QHO4PN1CVC,500,500
D10336,2,9/16/2022,QIG249CBOW,100,600
D10336,2,9/16/2022,QIG64A0S7W,35,635
D10337,1,7/21/2022,QGL1TG31EN,12400,"13035"
D10337,2,8/15/2022,QHF58SKF3B,12700,0
D10337,3,9/12/2022,QIC9TJLB6X,13000,0
D10337,4,11/4/2022,QJ427VR638,12400,0
D10337,5,11/3/2022,QK346Q8QCQ,17680,0
D10337,6,12/3/2022,QL388R7N1W,17680,0
D10337,7,12/31/2022,QLV4DPL3HU,16900,0
D10337,8,1/31/2023,RAV6K9KI0E,17680,0
D10337,9,3/8/2023,RC89BAGVAB,16900,0
D10337,10,4/5/2023,RD56GOI37S,16900,0
D10337,11,5/4/2023,RE44QJF1O4,19500,900
D10337,12,8/3/2023,RH32544180,4500,"19200"
D10337,12,8/4/2023,RH418CD8EL,3500,"15700"
D10337,12,8/4/2023,RH418E76QZ,7000,"8700"
D10338,1,7/5/2022,QG50WAQVE2,2000,"5980"
D10338,1,7/11/2022,QGB3A5FZR1,5980,0
D10338,2,08/10/20222,QHA5ZEMXAB,500,"10560"
D10338,2,8/12/2022,QHC33344BD,800,"9760"
D10338,2,8/18/2022,QHI6F18DF4,500,"9260"
D10338,2,8/23/2022,QHN0OIL0D4,100,"9160"
D10338,2,8/25/2022,QHP2RAGR52,500,"8660"
D10338,2,9/21/2022,QIL8DXYU2Q,150,"8510"
D10339,1,7/21/2022,QGL9TXN6MV,12300,0
D10339,2,8/18/2022,QHI0EUEMK0,12900,0
D10339,3,9/14/2022,QIE8YFRU6G,12800,0
D10339,4,10/13/2022,QJD9SSPFSF,13000,0
D10339,5,11/11/2022,QKB1QCUQW5,13000,0
D10339,6,12/9/2022,QL90T06RJE,12900,0
D10339,7,2/10/2023,726824853,12900,0
D10339,8,3/8/2023,RC82AQQO7O,12700,0
D10339,9,3/20/2023,RCK89XSAAI,7000,"6000"
D10339,9,4/6/2023,RD63KSWDWX,6000,0
D10339,10,5/11/2023,REB7C0CQLB,12800,0
D10339,11,5/17/2023,REH6SQA3RW,200,"12300"
D10339,11,6/5/2023,RF54C7NSZ4,12300,0
D10339,12,7/7/2023,RG74YL90SM,12900,0
D10340,1,6/30/2022,QFU3MMOMJ9,347,"8613"
D10340,1,7/1/2022,QG11P5AMPT,347,"8266"
D10340,1,7/2/2022,QG24R3ZD9W,347,"7919"
D10340,1,7/3/2022,QG36T2DS22,347,"7572"
D10340,1,7/5/2022,QG54W0GJK2,694,"6878"
D10340,1,7/5/2022,QG55WFVN45,6878,0
D10340,2,7/6/2022,QG68Z8BSI8,347,"8853"
D10340,2,7/9/2022,QG93776SD7,347,"8506"
D10340,2,7/10/2022,QGA37S0E63,347,"8159"
D10340,2,7/11/2022,QGB2B4PFFC,694,"7465"
D10340,2,7/12/2022,QGC5D6KJ0R,694,"6771"
D10340,2,7/13/2022,QGD1F7YRPN,800,"5971"
D10340,2,7/14/2022,QGE8GZH6TU,500,"5471"
D10340,2,7/18/2022,QGI3NL2L1Z,870,"4601"
D10340,2,7/19/2022,QGJ9PV5PSZ,4601,0
D10340,3,7/23/2022,QGN2YLRM6C,680,"8840"
D10340,3,7/28/2022,QGS88DO5T4,347,"8493"
D10340,3,7/30/2022,QGU8C6TKAQ,347,"8146"
D10340,3,8/2/2022,QH29IQKX7P,800,"7346"
D10340,3,8/4/2022,QH41O4T0CH,450,"6896"
D10340,3,8/5/2022,QH56PJKJCQ,430,"6466"
D10340,3,8/6/2022,QH65RCQYGF,6466,0
D10340,4,8/20/2022,QHK1HXYW6J,9200,0
D10340,5,9/9/2022,QI95NLB0IH,9680,0
D10340,6,9/29/2022,QIT7VFF8U3,9680,0
D10340,7,10/22/2022,QJM3DOR38X,9920,0
D10340,8,11/10/2022,QKA9NB2Z21,9600,0
D10340,9,12/2/2022,QL284WBYIO,12300,0
D10340,10,12/23/2022,QLN2THQ7CG,12200,0
D10340,11,1/16/2023,RAG9HYAASZ,12500,0
D10340,12,2/4/2023,RB44V8UTUQ,12000,0
D10340,13,3/2/2023,RC29UB4U8L,12700,0
D10340,14,3/28/2023,,12700,0
D10340,15,5/1/2023,RE11G55IBB,7000,"6600"
D10341,15,5/4/2023,RE49OVDCFJ,6600,0
D10341,1,7/27/2022,QGR56DS8UF,9100,210
D10341,2,7/27/2022,QGR56DS8UF_D2,210,"8890"
D10341,2,8/19/2022,QHJ0GG5IR8,1000,"7890"
D10341,2,8/25/2022,QHP0RKPSPK,7890,0
D10341,3,9/23/2022,QIN6JGC54A,6900,"2620"
D10341,3,9/24/2022,QIO0KG8AAG,100,"2520"
D10342,1,7/13/2022,QGD8E3PVRS,1625,"4675"
D10342,1,7/30/2022,QGU2CFHK26,4675,0
D10342,2,8/26/2022,QHQ9TJ3P71,6450,0
D10342,3,9/22/2022,QIM7GJWL31,6450,0
D10342,4,10/27/2022,QJR5PYM1TJ,2800,"5100"
D10342,4,11/8/2022,QK86JUT9PO,200,"4900"
D10342,4,1/10/2023,RAA744G1LL,500,"4400"
D10343,1,7/13/2022,QGD3DXALWT,1200,"5300"
D10343,1,7/13/2022,QGD8DY584Y,400,"4900"
D10343,1,7/20/2022,QGK2T2TEHG,1550,"3350"
D10343,1,7/28/2022,QGS57TLJ77,750,"2600"
D10343,1,8/1/2022,QH13HZB4AL,2600,0
D10343,2,8/9/2022,QH99Y5GKGX,1000,"5500"
D10343,2,8/18/2022,QHI0FF2BI4,800,"4700"
D10343,2,8/19/2022,QHJ6HFG68Y,650,"4050"
D10343,2,8/29/2022,QHT6ZSTDA8,4100,50
D10344,1,7/8/2022,QG864B4OMQ,217,"6583"
D10344,1,7/9/2022,QG9175BRER,217,"6366"
D10344,1,7/10/2022,QGA998TYHR,217,"6149"
D10344,1,7/22/2022,QGM1X1X36F,650,"5499"
D10344,1,8/1/2022,QH14G1QUNS,100,"5399"
D10344,1,8/1/2022,QH15G1XGMH,100,"5299"
D10344,1,8/1/2022,QH12G1Z66S,100,"5199"
D10344,1,8/1/2022,QH15G30QEV,100,"5099"
D10344,1,8/1/2022,QH10G3CHMU,90,"5009"
D10344,1,8/3/2022,QH35KCUJ09,800,"4209"
D10344,1,8/7/2022,QH70UO4LTC,3909,300
D10344,1,8/8/2022,QH83VGP20J,300,0
D10345,1,7/13/2022,QGD9DT5TWB,1735,"8665"
D10345,1,7/14/2022,QGE1GAZ3HZ,350,"8315"
D10345,1,7/18/2022,QGI1OI0U0J,1400,"6915"
D10345,1,7/26/2022,QGQ54F7J1T,2000,"4915"
D10345,1,8/1/2022,QH17GDBRS7,700,"4215"
D10345,1,8/4/2022,QH40MJ6VKM,1050,"3165"
D10345,1,8/5/2022,QH59QLYFV7,3170,5
D10346,1,7/10/2022,QGA787OZHB,217,"6283"
D10346,1,7/10/2022,QGA893IATE,217,"6066"
D10346,1,7/11/2022,QGB9B49BLD,220,"5846"
D10346,1,7/13/2022,QGD2DR0SB8,250,"5596"
D10346,1,7/13/2022,QGD3EAY70D,95,"5501"
D10346,1,7/13/2022,QGD7FCPCOJ,100,"5401"
D10346,1,7/14/2022,QGE2GZ518M,320,"5081"
D10346,1,7/15/2022,QGF7IX7MYN,300,"4781"
D10346,1,7/19/2022,QGJ3R0D963,450,"4331"
D10346,1,7/21/2022,QGL5TEPW5P,220,"4111"
D10346,1,7/23/2022,QGN0X80XNI,250,"3861"
D10346,1,7/23/2022,QGN2YYZ766,94,"3767"
D10346,1,7/25/2022,QGP21YI4ZK,300,"3467"
D10346,1,8/1/2022,QH19HT0KJ9,327,"3140"
D10346,1,8/2/2022,QH20JLAGC2,400,"2740"
D10346,1,8/5/2022,QH54PTQUL8,1250,"1490"
D10346,1,8/6/2022,QH65RZ1AGL,1490,0
D10346,2,8/10/2022,QHA9YQ3565,500,"6300"
D10346,2,8/10/2022,QHA4ZL4HUW,217,"6083"
D10346,2,8/14/2022,QHE285NRM2,800,"5283"
D10346,2,8/18/2022,QHI2F5N63A,200,"5083"
D10346,2,8/19/2022,QHJ8GPLLM8,300,"4783"
D10346,2,8/21/2022,QHL8L0D2VQ,100,"4683"
D10346,2,8/24/2022,QHO7PHNK8J,1500,"3183"
D10346,2,8/26/2022,QHQ4U0WLLU,465,"2718"
D10346,2,8/30/2022,QHU62FJHO4,500,"2218"
D10346,2,8/31/2022,QHV75FXTAZ,950,"1268"
D10346,2,9/4/2022,QI45DYSDR5,700,568
D10346,2,9/5/2022,QI57FA0PCZ,200,368
D10346,2,9/5/2022,QI52FT5A7G,300,68
D10346,2,9/6/2022,QI68HLWQHK,68,0
D10346,3,9/12/2022,QIC2TAH2GI,217,"6583"
D10346,3,9/13/2022,QID9WGBGNV,350,"6233"
D10346,3,9/15/2022,QIF92BURYP,330,"5903"
D10346,3,9/26/2022,QIQ2PQZQK0,370,"5533"
D10346,3,9/27/2022,QIR3RYCAQ9,100,"5433"
D10346,3,10/1/2022,QJ141DBHSY,100,"5333"
D10346,3,10/1/2022,QJ141DZZX2,100,"5233"
D10346,3,10/5/2022,QJ50B6I8R0,100,"5133"
D10346,3,10/8/2022,QJ89HXWB6Z,100,"5033"
D10346,3,10/8/2022,QJ85HY8493,100,"4933"
D10346,3,10/8/2022,QJ84IBK2BM,100,"4833"
D10346,3,10/11/2022,QJB6PU2MK,4400,433
D10346,3,10/11/2022,QJB1PCNAKB,33,400
D10346,3,10/12/2022,QJC7QSUWH9,400,0
D10346,4,10/23/2022,QJN9HBNGMF,100,"6400"
D10346,4,10/23/2022,QJN6HBWMO0,100,"6300"
D10346,4,10/23/2022,QJN2HC3AHS,50,"6250"
D10346,4,10/23/2022,QJN9HHSESF,100,"6150"
D10346,4,10/23/2022,QJN5HHVVPJ,100,"6050"
D10346,4,10/23/2022,QJN8HHZQ9O,100,"5950"
D10346,4,10/24/2022,QJO9JCLR8H,100,"5850"
D10346,4,10/24/2022,QJO5JDWBXH,100,"5750"
D10346,4,10/24/2022,QJO2JE6ZTE,50,"5700"
D10346,4,10/25/2022,QJP3LPY3NH,100,"5600"
D10346,4,10/25/2022,QJP8LQ8KTO,100,"5500"
D10346,4,10/25/2022,QJP4LQQ542,100,"5400"
D10346,4,10/27/2022,QJR9QAYUE5,100,"5300"
D10346,4,10/27/2022,QJR1QB3ZCT,100,"5200"
D10346,4,11/4/2022,QK449DU84K,100,"5100"
D10346,4,11/4/2022,QK469E2I1C,100,"5000"
D10346,4,11/4/2022,QK459ECCNF,45,"4955"
D10346,4,11/7/2022,QK78FN5VKE,500,"4455"
D10346,4,11/7/2022,QK73FYQIBT,100,"4355"
D10346,4,11/7/2022,QK78GLA3MQ,60,"4295"
D10346,4,11/7/2022,QK70GZ0CU2,100,"4195"
D10346,4,11/7/2022,QK71GZ9TV1,100,"4095"
D10346,4,11/7/2022,QK79GZLCPP,100,"3995"
D10346,4,11/7/2022,QK74H7SQA6,90,"3905"
D10346,4,11/8/2022,QK87J0GBAB,100,"3805"
D10346,4,11/8/2022,QK82J4CI0O,100,"3705"
D10346,4,11/9/2022,QK97L7IP6F,100,"3605"
D10346,4,11/9/2022,QK99LA0OMR,100,"3505"
D10346,4,11/9/2022,QK95LX7L3P,95,"3410"
D10346,4,11/10/2022,QKA9NLTJ61,3410,0
D10346,5,11/15/2022,QKF616FCGG,100,"6350"
D10346,5,11/15/2022,QKF616HZKC,50,"6300"
D10346,5,11/16/2022,QKG72VBNWX,100,"6200"
D10346,5,11/17/2022,QKH33PZ249,68,"6132"
D10346,5,11/17/2022,QKH447O07C,100,"6032"
D10346,5,11/18/2022,QKI45XZ9PC,100,"5932"
D10346,5,11/18/2022,QKI35Y2R19,48,"5884"
D10346,5,11/21/2022,QKL7EKIJSN,100,"5784"
D10346,5,11/29/2022,QKT1W7D77F,100,"5684"
D10346,5,11/29/2022,QKT7W7L7KZ,100,"5584"
D10346,5,11/29/2022,QKT8W8C95C,70,"5514"
D10346,5,12/2/2022,QL2468RH0Q_D2,100,"5414"
D10346,5,12/2/2022,QL286CXE0I,85,"5329"
D10346,5,12/5/2022,QL59FZYMLH,100,"5229"
D10346,5,12/5/2022,QL58G08EEQ,100,"5129"
D10346,5,12/5/2022,QL52G0G0WS,100,"5029"
D10346,5,12/5/2022,QL53H7IA7T,100,"4929"
D10346,5,12/5/2022,QL55GPOIOX,500,
D10346,5,12/6/2022,QL69HETAHR,100,"4829"
D10346,5,12/6/2022,QL65HEYBT5,15,"4814"
D10346,5,12/6/2022,QL60IEPPTY,745,"4069"
D10346,5,12/6/2022,QL61IFLLYH,549,"3520"
D10346,5,12/6/2022,QL61IGJ51R,370,"3150"
D10346,5,12/6/2022,QL64IKRJVY,70,"3080"
D10346,5,12/8/2022,QL83OLW1N7,3000,80
D10346,5,12/8/2022,QL89OQ511H,80,0
D10346,6,12/15/2022,QLF19PXBP3,100,"6400"
D10346,6,12/15/2022,QLF09QB4DW,100,"6300"
D10346,6,12/15/2022,QLF89QMA06,30,"6270"
D10346,6,12/20/2022,QLK8MNMC1I,100,"6170"
D10346,6,12/20/2022,QLK7MNVCGX,100,"6070"
D10346,6,12/29/2022,QLT79D6VCL,100,"5970"
D10346,6,12/29/2022,QLT59DIC5D,100,"5870"
D10346,6,12/29/2022,QLT09DD3RU,100,"5770"
D10346,6,1/6/2022,RA69STMWDP,5770,0
D10346,7,1/13/2023,RAD1B5URRV,300,"6050"
D10346,7,1/17/2023,RAH3L6HA3B,100,"5950"
D10346,7,1/17/2023,RAH9L6PNN1,100,"5850"
D10346,7,1/20/2023,RAK8S4SJU4,300,"5550"
D10346,7,1/23/2023,RAN71OAOY9,300,"5250"
D10346,7,1/26/2023,RAQ97RJ26D,500,"4750"
D10346,7,1/26/2023,RAQ38S73WF,100,"4650"
D10346,7,1/26/2023,RAQ48SJBBM,100,"4550"
D10346,7,1/27/2023,RAR3CE6ZIN,100,"4450"
D10346,7,1/27/2023,RAR7CEB63L,100,"4350"
D10346,7,1/30/2023,RAU0IVT2R8,100,"4250"
D10346,7,2/1/2023,RB15MVJABR,4200,50
D10346,7,2/1/2023,RB15NOK4LD,50,0
D10346,8,2/4/2023,RB44UW7VLS,100,"6400"
D10346,8,2/4/2023,RB40UWNKSC,100,"6300"
D10346,8,2/4/2023,RB46UWVSZK,30,"6270"
D10346,8,2/4/2023,RB43VAIO41,50,"6220"
D10346,8,2/6/2023,RB631DQ9IL,100,"6120"
D10346,8,2/6/2023,RB671DZI0Z,100,"6020"
D10346,8,2/9/2023,RB9898Z1K0,100,"5920"
D10346,8,2/9/2023,RB949972G6,100,"5820"
D10346,8,2/10/2023,RBA3CKDB1B,200,"5620"
D10346,8,2/13/2023,RBD1LOF5A1,100,"5520"
D10346,8,2/14/2023,RBE8O3TE3A,100,"5420"
D10346,8,2/14/2023,RBE4O7MHNG,100,"5320"
D10346,8,2/17/2023,RBH8W7HYTY,200,"5120"
D10346,8,2/20/2023,RBK032XGWO,100,"5020"
D10346,8,2/21/2023,RBL67CWV7W,100,"4920"
D10346,8,2/22/2023,RBM99OEQQZ,100,"4820"
D10346,8,2/22/2023,RBM79S2Q4N,80,"4740"
D10346,8,2/24/2023,RBO1CVH7RH,80,"4660"
D10346,8,2/24/2023,RBO3D2455T,100,"4560"
D10346,8,2/24/2023,RBO6DOOX7U,400,"4160"
D10346,8,2/27/2023,RBR1MKUA8V,100,"4060"
D10346,8,3/1/2023,RC12QF58GC,550,"3510"
D10346,8,3/1/2023,RC17QKULFF,3510,0
D10346,9,3/3/2023,RC39XFEW41,200,"6300"
D10346,9,3/4/2023,RC46YWIE5S,250,"6050"
D10346,9,3/6/2023,RC695Y02A3,200,"5850"
D10346,9,3/6/2023,RC6868CTRQ,50,"5800"
D10346,9,3/9/2023,RC99DCAX3D,100,"5700"
D10346,9,3/9/2023,RC91DEBCT7,100,"5600"
D10346,9,3/16/2023,RCG5W4Q6WF,200,"5400"
D10346,9,3/17/2023,RCH91Z6MTV,217,"5183"
D10346,9,3/20/2023,RCK17M1AR9,250,"4933"
D10346,9,3/24/2023,RCO3K5MOLB,100,"4833"
D10346,9,3/27/2023,RCR1S1MZM3,200,"4633"
D10346,9,3/30/2023,RCU6YTZL3O,4330,303
D10346,9,3/30/2023,RCU4YU7IUK,303,0
D10346,10,5/5/2023,RE55RTLDN7,100,"7800"
D10346,10,5/5/2023,RE52RTTFY8,100,"7700"
D10346,10,5/5/2023,RE57RU0XU7,100,"7600"
D10346,10,5/25/2023,REP5DY3OH9,200,"7400"
D10346,10,6/27/2023,RFR140O9RH,3600,"3800"
D10346,10,6/29/2023,RFT494EXKO,500,"3300"
D10346,10,6/29/2023,RFT99FDRYL,1100,"2200"
D10346,10,6/29/2023,RFT49H96M6,2200,0
D10347,1,7/26/2022,QGQ14QZ7PT,3500,"9500"
D10347,1,7/28/2022,QGS18S9DUX,1300,"8200"
D10347,1,8/3/2022,QH39L1A6RT,1550,"6650"
D10347,1,8/11/2022,QHB81KTNG4,6650,0
D10347,2,9/8/2022,QI80LRKQ7O,13000,0
D10348,1,7/29/2022,QGT1AL4VEL,3250,"9750"
D10348,1,8/4/2022,QH41NX2XCD,2800,"6950"
D10348,1,8/11/2022,QHB81EM6XW,1450,"5500"
D10348,1,8/12/2022,QHC942UTUJ,1000,"4500"
D10348,1,8/13/2022,QHD066L548,1250,"3250"
D10348,1,8/15/2022,QHF49KE1ZU,2000,"1250"
D10348,1,8/16/2022,QHG8BCC94U,1250,0
D10348,2,8/30/2022,QHU93BQOCN,2000,"11600"
D10348,2,9/1/2022,QI177PWOVN,1000,"10600"
D10348,2,9/8/2022,QI89L7YBY7,1000,"9600"
D10348,2,9/10/2022,QIA2PHFH26,1000,"8600"
D10348,2,9/15/2022,QIF41Y78AY,500,"8100"
D10348,2,9/19/2022,QIJ3AOZO3H,1000,"7100"
D10348,2,9/20/2022,QIK4CL8I5A,2000,"5100"
D10348,2,9/21/2022,QIL5DEIEYH,4000,"1100"
D10348,2,9/21/2022,QIL0DGW9U0,1000,100
D10348,2,9/21/2022,QIL7DVDKH3,100,0
D10348,3,11/11/2022,QKB0QL0OWC,1000,"11900"
D10348,3,11/23/2022,QKN6HS6PNW,2000,"9900"
D10348,3,12/1/2022,QL132UDVGB,4200,"5700"
D10348,3,12/1/2022,QL192VWDVF,1300,"4400"
D10348,3,12/1/2022,QL1532NU9D,500,"3900"
D10348,3,12/1/2022,QL1432ZY7I,200,"3700"
D10348,3,12/1/2022,QL1936RW6Z,3000,700
D10348,3,12/1/2022,QL1538J59V,700,0
D10348,4,12/30/2022,QLU4BXSQJC,13600,0
D10348,5,1/25/2023,RAP056Y8QQ,6000,"7600"
D10348,5,1/31/2023,RAP056Y8QQ_D2,7600,0
D10348,6,3/13/2023,RCD1NZWWNB,3000,"11600"
D10349,1,8/1/2022,QH13GH479F,3250,"9750"
D10349,1,8/17/2022,QHH7CX7Z0P,4400,"5350"
D10349,1,8/19/2022,QHJ8FLQGVY,3350,"2000"
D10349,1,8/22/2022,QHM5M91CRT,2000,0
D10350,1,7/26/2022,QGQ84O25SU,2170,"10830"
D10350,1,8/16/2022,QHG3A9R3BX,5000,"5830"
D10350,1,8/17/2022,QHH3CAXDBJ,5830,0
D10351,1,9/16/2022,QIG43S8TK6,2000,"5300"
D10351,1,10/7/2022,QJ70ELBW9I,2000,"3300"
D10351,1,10/9/2022,QJ91J5RH3Z,1000,"2300"
D10351,1,10/18/2022,QJI957O7GZ,2300,0
D10352,1,8/3/2022,QH37LF8N8H,2000,"9900"
D10352,1,8/5/2022,QH56PRL2JC,100,"9800"
D10352,1,8/7/2022,QH77TI7W65,1000,"8800"
D10352,1,8/10/2022,QHA9ZM6SPD,4000,"4800"
D10352,1,8/13/2022,QHD75L3KOJ,3000,"1800"
D10352,1,8/13/2022,QHD95V7LD7,1800,0
D10352,2,9/10/2022,QIA7PBCUDV,6000,"7000"
D10352,2,9/12/2022,QIC8TLJRK2,7000,0
D10352,3,10/14/2022,QJE0VP2NHM,100,"12500"
D10352,3,10/14/2022,QJE2VPDFGW,12000,500
D10352,3,10/14/2022,QJE6VSQ0A6,500,0
D10352,4,11/13/2022,QKD7UVYL33,100,"12800"
D10352,4,11/13/2022,QKD1UW6SD7,12800,0
D10352,5,12/16/2022,QLG4AL0DD2,12800,0
D10353,1,8/24/2022,QHO7PSJ70D,5850,"7150"
D10353,1,8/26/2022,QHQ7TBY5FX,6700,450
D10353,1,8/26/2022,QHQ9TGIC3L,450,0
D10353,2,9/23/2022,QIN7HWZYRR,12900,0
D10353,3,10/26/2022,QJQ2MFVLM6,13600,0
D10353,4,4/24/2023,RDO6XAOB3K,3500,280
D10353,4,4/24/2023,RDO3XBZS5B,280,0
D10353,5,5/22/2023,REM86EG15G,3840,0
D10353,6,6/28/2023,RFS56RC6I1,4080,"4080"
D10354,1,9/16/2022,QIG63ODWHW,350,"10050"
D10354,1,9/19/2022,QIJ8A65QBA,700,"9350"
D10354,1,9/20/2022,QIK0D1BPEQ,350,"9000"
D10354,1,9/26/2022,QIQ9O3PSLX,1450,"7550"
D10354,1,9/29/2022,QIT0VVK95O,1000,"6550"
D10354,1,10/14/2022,QJE9UY6ENR,6550,0
D10354,2,10/25/2022,QJP7K1OE0X,800,"9600"
D10354,2,10/29/2022,QJT5V27DIT,1000,"8600"
D10354,2,10/31/2022,QJV2ZGNJA4,2000,"6600"
D10354,2,11/7/2022,QK76H6UISC,1000,"5600"
D10354,2,11/12/2022,QKC9RO4DLZ,5600,0
D10354,3,11/25/2022,QKP2M6ITMK,1000,"9160"
D10354,3,12/8/2022,QL85NZIWYD,9160,0
D10354,4,1/9/2023,RA90ZIKLPG,2000,"8880"
D10354,4,01/10/2023.,RAA23864Z6,8880,0
D10354,5,2/10/2023,RBA8BUQM7C,10880,0
D10354,6,3/14/2023,RCE9R1SBCP,10400,0
D10354,7,5/25/2023,REP7EDFUZ5,500,"10380"
D10354,7,5/29/2023,RET0P3SA7C,500,"9880"
D10354,7,5/31/2023,REV8UDOCTA,500,"9380"
D10355,1,9/22/2022,QIM9GDKKN7,2000,"4150"
D10355,1,9/30/2022,QIU9Y1SC1N,1700,"2450"
D10355,1,10/7/2022,QJ70F0QU6I,2350,100
D10355,1,10/7/2022,QJ78F7PBS2,100,0
D10355,2,10/14/2022,QJE8WINEYW,1650,"5150"
D10355,2,10/31/2022,QJV9YYFK5B,1200,"3950"
D10355,2,11/4/2022,QK419GG78P,1000,"2950"
D10355,2,11/6/2022,QK65EYWLJZ,2950,0
D10355,3,11/21/2022,QKL1DO08BP,500,"6000"
D10355,3,11/24/2022,QKO7KU6ZGP,1000,"5000"
D10355,3,11/27/2022,QKR1SR8O9F,800,"4200"
D10355,3,11/27/2022,QKR9SRR80T,500,"3700"
D10355,3,11/29/2022,QKT4X8YP2W,500,"3200"
D10355,3,12/3/2022,QL377LTK37,400,"2800"
D10355,3,12/4/2022,QL42DJV22K,500,"2300"
D10355,3,12/5/2022,QL56FOGQ4Q,2300,0
D10355,4,12/13/2022,QLD84B4W8Y,900,"5900"
D10355,4,12/22/2022,QLM9SF5IN5,1500,"4400"
D10355,4,12/27/2022,QLR660RCQA,1500,"2900"
D10355,4,12/29/2022,QLT7AHDQ8X,600,"2300"
D10355,4,1/3/2023,RA36L7DEMO,1900,400
D10355,4,1/3/2023,RA36L91BQI,150,250
D10355,4,1/3/2023,RA35MF70T7,250,0
D10355,5,1/18/2023,RAI2MENQD4,1000,"5500"
D10355,5,1/23/2023,RAN3YQQFBV,250,"5250"
D10355,5,1/27/2023,RAR1ABRFAD,300,"4950"
D10355,5,1/29/2023,RAT8H2JQ4U,1816,"3134"
D10355,5,1/29/2023,RAT0H3DRWI,470,"2664"
D10355,5,2/6/2023,RB6817RXKA,2665,1
D10355,6,2/16/2023,RBG0T82JCA,500,"6000"
D10355,6,2/20/2023,RBK14CGTR3,700,"5300"
D10355,6,2/20/2023,RBK34D9K6L,200,"5100"
D10355,6,2/21/2023,RBL45HK38Q,150,"4950"
D10355,6,2/21/2023,RBL2716P2Q,200,"4750"
D10355,6,2/24/2023,RBO8EUUFEK,400,"4350"
D10355,6,2/25/2023,RBP5HN8PO3,700,"3650"
D10355,6,2/27/2023,RBR8KQR7TY,480,"3170"
D10355,6,3/2/2023,RC25V35FOH,150,"3020"
D10355,6,3/6/2023,RC6962NOSB,1000,"2020"
D10355,6,3/7/2023,RC718L6SAN,2020,0
D10355,7,3/11/2023,RCB3KRJNLN,150,"6650"
D10355,7,3/20/2023,RCK97QHEI7,200,"6450"
D10355,7,3/24/2023,RCO6HTSHF0,150,"6300"
D10355,7,3/24/2023,RCO0K9O304,180,"6120"
D10355,7,3/25/2023,RCP1MV92T3,450,"5670"
D10355,7,3/26/2023,RCQ0PA72M4,1400,"4270"
D10355,7,3/27/2023,RCR3RXVFT3,250,"4020"
D10355,7,4/4/2023,RD41EPL14V,450,"3570"
D10355,7,4/5/2023,RD50FSO81O,3570,0
D10355,8,4/22/2023,RDM9QUPS3H,350,"6150"
D10355,8,4/22/2023,RDM1SC974L,250,"5900"
D10355,8,5/1/2023,RE11GNKM91,4500,"1400"
D10355,8,5/2/2023,RE39LRN6PH,1400,0
D10355,9,5/17/2023,REH6QP1OLO,700,"7460"
D10355,9,5/18/2023,REI9V3IE35,130,"7330"
D10355,9,5/20/2023,REK11X6VJ1,1050,"6280"
D10355,9,5/22/2023,REM954K14F,340,"5940"
D10355,9,5/22/2023,REM671OKN6,180,"5760"
D10355,9,6/2/2023,RF241VIUTU,5760,0
D10355,10,6/10/2023,RFA1OV5YFH,300,"7500"
D10355,10,6/16/2023,RFG38Z3ZFH,370,"7130"
D10355,10,6/18/2023,RFI7CIHG3V,600,"6530"
D10355,10,6/18/2023,RFI6EI80UG_D2,200,"6330"
D10355,10,6/26/2023,RFQ5YJTPIP,170,"6160"
D10355,10,7/7/2023,RG78X6U0HM,2000,"4160"
D10355,10,7/7/2023,RG71XIT5QF,2000,"2160"
D10355,10,7/13/2023,RGD2FFPLGK,2160,0
D10355,11,8/10/2023,RHA5QVJE1T,7800,0
D10356,1,9/25/2022,QIP3NRHVPZ,220,"7680"
D10356,1,9/26/2022,QIQ7Q56V09,180,"7500"
D10356,1,9/29/2022,QIT1WVNTFL,300,"7200"
D10356,1,10/4/2022,QJ427NU5BQ,400,"6800"
D10356,1,10/9/2022,QJ91L5V0C7,300,"6500"
D10356,1,10/15/2022,QJF0WWYN4K,500,"6000"
D10356,1,10/16/2022,QJG71ZUXY9,350,"5650"
D10356,1,10/24/2022,QJO2IZHEGW,100,"5550"
D10356,1,10/24/2022,QJO8IZQ1IU,100,"5450"
D10356,1,10/24/2022,QJO5IZTOJZ,50,"5400"
D10356,1,10/26/2022,QJQ9M2R93L,450,"4950"
D10356,1,10/26/2022,QJQ1O18783,500,"4450"
D10356,1,11/3/2022,QK3573EE3J,100,"4350"
D10356,1,11/3/2022,QK3473LCLK,100,"4250"
D10356,1,11/9/2022,QK98M6LF0Y,200,"4050"
D10356,1,11/11/2022,QKB8PYJBOK,100,"3950"
D10356,1,11/11/2022,QKB3PYOMR1,50,"3900"
D10356,1,11/14/2022,QKE6XP4J14,100,"3800"
D10356,1,11/17/2022,QKH63URG8W,100,"3700"
D10356,1,11/17/2022,QKH53UV3K3,100,"3600"
D10356,1,11/22/2022,QKM2EUL0NE,250,"3350"
D10356,1,11/28/2022,QKS5SXLZ6R,1000,"2350"
D10356,1,12/1/2022,QL161G259S,100,"2250"
D10356,1,12/1/2022,QL141GHUT6,100,"2150"
D10356,1,12/5/2022,QL56ECX2S2,100,"2050"
D10356,1,12/5/2022,QL56ED37G8,100,"1950"
D10356,1,12/7/2022,QL70KMN6FE,100,"1850"
D10356,1,12/17/2022,QLH4D1AABO,100,"1750"
D10356,1,12/17/2022,QLH0D1GC3K,50,"1700"
D10356,1,12/23/2022,QLN7TKNGH7,100,"1600"
D10356,1,1/1/2022,RA12G7KKO0,200,"1400"
D10357,1,10/14/2022,QJE8UXAPT6,750,"7150"
D10357,1,10/18/2022,QJI359ZUI1,150,"7000"
D10357,1,10/19/2022,QJJ68MAGBE,100,"6900"
D10357,1,10/22/2022,QJM0DH102M,150,"6750"
D10357,1,10/24/2022,QJO1HNZF8D,150,"6600"
D10357,1,10/26/2022,QJQ2NJAJ4M,400,"6200"
D10357,1,10/27/202#,QJS4QMR6KS,200,"6000"
D10357,1,10/30/2022,QJU6X6UMEG,200,"5800"
D10357,1,11/1/2022,QK14181GZS,150,"5650"
D10357,1,11/2/2022,QK213K7ZWT,150,"5500"
D10357,1,11/4/2022,QK4182W4UZ,150,"5350"
D10357,1,11/7/2022,QK70FL44II,200,"5150"
D10357,1,11/8/2022,QK81IMXJCH,150,"5000"
D10357,1,11/10/2022,QKA8MKZROU,150,"4850"
D10357,1,11/11/2022,QKB2QIXEZ6,150,"4700"
D10357,1,11/15/2022,QKF8YKBCLA,200,"4500"
D10357,1,11/18/2022,QKI35UFJBX,300,"4200"
D10357,1,11/23/2022,QKN8H8YMOM,100,"4100"
D10357,1,11/23/2022,QKN9HD1ZQ7,100,"4000"
D10357,1,11/29/2022,QKU3XPMWL5,200,"3800"
D10357,1,12/5/2022,QL53EPDW13,150,"3650"
D10357,1,12/8/2022,QL83NLVOBX_D2,200,"3450"
D10357,1,12/13/2022,QLD82M1PVC,150,"3300"
D10357,1,12/16/2022,QLG2ATPFIA_D2,100,"3200"
D10358,1,10/15/2022,QJF9WVHGUN,1625,"4525"
D10358,1,10/18/2022,QJI96E1G3J,1625,"2900"
D10358,1,10/22/2022,QJM4DLEG1Y,2900,0
D10358,2,11/1/2022,QK1532WCLZ,1625,"4425"
D10358,2,11/10/2022,QKA3MNVGS3,4425,0
D10358,3,12/29/2022,QLT5902MLB,100,"7800"
D10358,3,1/16/2023,RAG6JH2ZW6,100,"7700"
D10358,3,1/16/2023,RAG8JH6MNG,100,"7600"
D10358,3,1/23/2023,RAN0Z3U9U8,100,"7500"
D10358,3,1/23/2023,RAN2Z3YEMY,100,"7400"
D10358,3,1/31/2023,RAV5KBLO6X,100,"7300"
D10359,1,10/4/2022,QJ449HZ28I,100,"6700"
D10359,1,10/4/2022,QJ479I10AT,100,"6600"
D10359,1,10/4/2022,QJ409I4W9I,17,"6583"
D10359,1,10/5/2022,QJ50BT3FKM,100,"6483"
D10359,1,10/5/2022,QJ52BT6CSG,100,"6383"
D10359,1,10/5/2022,QJ52BTBECU,17,"6366"
D10359,1,10/6/2022,QJ63E8MDFV,100,"6266"
D10359,1,10/6/2022,QJ64E8J3WI,100,"6166"
D10359,1,10/7/2022,QJ71GINRM5,234,"5932"
D10359,1,10/22/2022,QJM4DQZ3DY,500,"5432"
D10359,1,10/25/2022,QJP3L5UXE5,100,"5332"
D10359,1,10/25/2022,QJP0L6ELY4,300,"5032"
D10359,1,11/2/2022,QK273G2J57,100,"4932"
D10359,1,11/2/2022,QK253G4LXN,50,"4882"
D10359,1,11/3/2022,QK365WHEJO,100,"4782"
D10359,1,11/3/2022,QK366BAEU0,100,"4682"
D10359,1,11/3/2022,QK386BE8DG,100,"4582"
D10359,1,11/3/2022,QK366BYNNY,72,"4510"
D10359,1,11/4/2022,QK47868P91,500,"4010"
D10359,1,11/4/2022,QK468WKLG4,95,"3915"
D10359,1,11/5/2022,QK55B8BTWT,100,"3815"
D10359,1,11/5/2022,QK59B8XD13,100,"3715"
D10359,1,11/9/2022,QK92LGWY8Q,100,"3615"
D10359,1,11/9/2022,QK96LIFWS2,100,"3515"
D10359,1,11/11/2022,QKB4OZPXOI,200,"3315"
D10360,1,10/16/2022,QJG71S4EPZ,1620,"4681"
D10360,1,10/28/2022,QJS5RO5RP1,1,"4680"
D10360,1,10/28/2022,QJS4ROAX0O,4680,0
D10360,2,11/16/2022,QKG024G3JQ,500,"6000"
D10360,2,11/25/2022,QKP0NA79N8,6000,0
D10360,3,12/8/2022,QL84Q53ROO,1600,"5200"
D10360,3,12/15/2022,QLF89VJ05E,1600,"3600"
D10360,3,12/28/2022,QLS56ZM769,500,"3100"
D10360,3,12/28/2022,QLS08AJAY4,3100,0
D10360,4,1/21/2023,RAL7UMXTMB,1625,"4875"
D10360,4,1/29/2023,RAT7HBOXYD,1625,"3250"
D10360,4,2/10/2023,RBA6E1HNRY,3250,0
D10360,5,2/23/2023,RBN8CKQBTA,500,"5950"
D10360,5,2/24/2023,RBO0ETEMP6,500,"5450"
D10360,5,3/10/2023,RCA3IBNZXN,5450,0
D10360,6,4/4/2023,RD46F04JN0,3250,"3250"
D10360,6,4/8/2023,RD88NWY1L2,3250,0
D10360,7,5/5/2023,RE52RI8N10,6500,0
D10360,8,6/5/2023,RF579MYGDX,1925,"5975"
D10360,8,6/5/2023,RF549MTIN8,1,"5974"
D10360,8,6/24/2023,RFO7TRBPZ5,1000,"4974"
D10360,8,7/21/2023,RGL2348BYC,2000,"2974"
D10360,8,7/22/2023,RGL94L97K3,2974,0
D10361,1,11/11/2022,QKB1Q6NSBH,13000,0
D10361,2,12/09/0203,QL90RKGJJO,12900,0
D10361,3,1/7/2023,RA77VKIXFZ,13000,0
D10361,4,2/2/2023,RB29PNKO1B,12700,0
D10361,5,3/2/2023,RC27UZV7JZ,15600,0
D10361,6,4/2/2023,RC27UZV7JZ_D2,15600,0
D10361,7,4/29/2023,RDT2B1UPRS,15240,0
D10361,8,5/28/2023,RES0NGZA4W,15600,0
D10362,1,10/20/2022,QJK19Y1OK3,220,"6030"
D10362,1,10/21/2022,QJL4CDH660,100,"5930"
D10362,1,10/21/2022,QJL7CDLLU5,100,"5830"
D10362,1,10/24/2022,QJO5I76NYH,400,"5430"
D10362,1,10/31/2022,QJV4XTLW18,400,"5030"
D10362,1,11/1/2022,QK181D97LM,400,"4630"
D10362,1,11/3/2022,QK395ZWLL5,400,"4230"
D10362,1,11/7/2022,QK78FZ8QSQ,450,"3780"
D10362,1,11/9/2022,QK91KO1TC5,400,"3380"
D10362,1,11/12/2022,QKC2RF94RK,300,"3080"
D10362,1,11/12/2022,QKC6RNY7BO,3080,0
D10362,2,11/15/2022,QKF0ZAC6XY,500,"5100"
D10362,2,11/16/2022,QKG41SZLD6,5100,0
D10362,3,11/20/2022,QKL5CNKTWT,400,"7500"
D10362,3,12/16/2022,QLG7ANB4X1,450,"7050"
D10362,3,12/19/2022,QLJ6IIG9IW,500,"6550"
D10362,3,12/29/2022,QLT794WCOV,400,"6150"
D10362,3,1/5/2023,RA53Q0YRL5,500,"5650"
D10362,3,1/11/2023,RAB46K2HHW,200,"5450"
D10362,3,1/28/2023,RAS6DROEYY,500,"4950"
D10362,3,2/7/2023,RB754Z0YT3,300,"4650"
D10362,3,4/29/2023,RDT3BSGMDN,500,"4150"
D10362,3,6/24/2023,RFO9TX3153,500,"3650"
D10362,3,6/24/2023,RFO1U16S1P,500,"3150"
D10362,3,6/26/2023,RFQ422W2F6,200,"2950"
D10362,3,7/1/2023,RG13GLF9S9,500,"2450"
D10362,3,7/7/2023,RG73XX652J,300,"2150"
D10362,3,7/14/2023,RGE3J9DKF7,300,"1850"
D10362,3,8/5/2023,RH54CMSJYE,500,"1350"
D10362,3,8/8/2023,RH82JAOMFM,300,"1050"
D10362,3,8/20/2023,RHK0KYK6EG,300,750
D10363,1,11/22/2022,QKM2G8G6E2,1500,"6660"
D10363,1,11/23/2022,QKN7HHDPGT,6660,0
D10363,2,12/20/2022,QLL5NXCYFD,7740,0
D10363,3,1/19/2023,RAJ1QREDX3,6000,"2160"
D10363,3,1/19/2023,RAJ9QS4SQR,1500,660
D10363,3,1/20/2023,RAK7RYYUN9,660,0
D10363,4,2/18/2023,RBI1X2Y8IB,7800,0
D10363,5,3/18/2023,RCI24IMD1Y,7800,0
D10363,6,4/26/2023,RDQ23OBDO2,4000,"4760"
D10363,6,5/10/2023,REA26V4MRW,4760,0
D10364,1,10/28/2022,QJS0RPUEYU,1500,"4100"
D10364,1,10/29/2022,QJT5UFS06B,200,"3900"
D10364,1,11/3/2022,QK376TZ6Y7,1300,"2600"
D10364,1,11/4/2022,QK468TMDPY,1500,"1100"
D10364,1,11/4/2022,QK439I3AZD,1100,0
D10364,2,11/11/2022,QKB0PVBJE0,1650,"4850"
D10364,2,12/2/2023,QL295NXVXJ,4800,50
D10364,2,12/2/2023,QL2663OU94,50,0
D10364,3,11/11/2022,QKB0PVBJE0_D2,1650,"4850"
D10364,3,12/2/2023,QL295NXVXJ_D2,4800,50
D10364,3,12/2/2023,QL2663OU94_D2,50,0
D10364,4,12/24/2022,QLO8XF6QRG,500,"6800"
D10364,4,1/7/2022,RA70URV2D2,400,"6400"
D10364,4,1/7/2023,RA75VFFKXV,400,"6000"
D10364,4,1/9/2023,RA991LC1G3,350,"5650"
D10364,4,1/11/2023,RAB35AHIIF,5200,450
D10364,4,1/11/2023,RAB75GESQN,450,0
D10364,5,2/21/2023,RBL1607GNJ,500,"6800"
D10364,5,2/28/2023,RBR0LTDEQC,100,"6700"
D10365,1,11/1/2022,QK162XD5S0,1000,"5500"
D10365,1,1/8/2022,QK82HNBV1Y,625,"4875"
D10365,1,11/14/2022,QKE6VWPT18,950,"3925"
D10365,1,11/16/2022,QKG31IGQY3,700,"3225"
D10365,1,11/22/2022,QKM5FMFQPH,3225,0
D10366,1,11/2/2022,QK234UFDTH,1900,"5480"
D10366,1,11/9/2022,QK94KL3HD0,1950,"3530"
D10366,1,11/15/2022,QKF1YKCWFD,3530,0
D10366,2,11/24/2022,QKO4KKD7N6,500,"7660"
D10366,2,12/2/2022,QL294PVFBD,800,"6860"
D10366,2,12/3/2022,QL367R7BTA,650,"6210"
D10366,2,12/10/2022,QLA0TWSR54,900,"5310"
D10366,2,12/14/2022,QLE2571NKQ,5310,0
D10366,3,1/11/2023,RAB1504MIX,7800,0
D10366,4,2/9/2023,RB96A17RP6,8160,0
D10366,5,3/9/2023,RC91EB1M99,7800,0
D10366,6,4/6/2023,RD61J9W0XN,7800,0
D10366,7,5/3/2023,RE30LY0IZM,7800,0
D10366,8,5/31/2023,REV6UHY19U,1800,"6960"
D10367,1,11/17/2022,QKH4448P9Y,12300,0
D10367,2,12/13/2022,QLD53DXCJZ,12700,0
D10367,3,1/10/2023,RAA93P0RA9,12900,0
D10367,4,2/7/2023,RB7855NZFA,12600,300
D10367,4,2/8/2023,RB8978Z865,300,0
D10367,5,3/8/2023,RC81ASBLE7,12900,0
D10367,6,4/8/2023,RD85O6OTP7,13600,0
D10367,7,5/8/2023,RE8720NJNZ,13000,600
D10367,7,5/8/2023,RE852EZINX,600,0
D10367,8,6/6/2023,RF61D0X3IJ,12900,0
D10367,9,7/7/2023,RG72YFICWQ,15600,0
D10367,10,8/7/2023,RH73HRVBE3,15600,0
D10368,1,11/14/2022,QKE6VUVN74,570,"5380"
D10368,1,11/16/2022,QKG81GP5FG,1070,"4310"
D10368,1,11/21/2022,QKL4DA6DB6,4310,0
D10368,2,12/22/2022,QLM8RQV2ZC,300,"7600"
D10368,2,1/17/2023,RAH7K0AVN3,25,"7575"
D10368,2,1/17/2023,RAH3K0KAUX,225,"7350"
D10368,2,2/6/2023,RB6118PQ83,300,"7050"
D10369,1,11/29/2022,QKT8W8C95C_D2,12600,0
D10369,2,1/24/2023,RAO02QYH3S,3000,"12800"
D10370,1,11/9/2022,QK99MC02KN,450,"12150"
D10370,1,11/11/2022,QKB3OVACF1,450,"11700"
D10370,1,11/14/2022,QKE2VO66FA,450,"11250"
D10370,1,11/14/2022,QKE0X01JFC,450,"10800"
D10370,1,11/14/2022,QKE0WV2LMM,450,"10350"
D10370,1,11/16/2022,QKG7395LJP,450,"9900"
D10370,1,11/17/2022,QKH85LCGF4,450,"9450"
D10370,1,11/18/2022,QKI76LMQG1,1350,"8100"
D10370,1,11/19/2022,QKJ7ADDZCJ,900,"7200"
D10370,1,11/21/2022,QKL5ERCSYP,450,"6750"
D10370,1,11/23/2022,QKN4JFC5HG,450,"6300"
D10370,1,11/26/2022,QKQ9OA1YJ1,450,"5850"
D10370,1,11/28/2022,QKS6SUK6M0,900,"4950"
D10370,1,11/29/2022,QKT5XJ5CQ5,900,"4050"
D10370,1,12/2/2022,QL237HOJNN,1800,"2250"
D10370,1,12/3/2022,QL3383BFWT,2250,0
D10370,2,12/6/2022,QL63JAD8XZ,900,"12700"
D10370,2,12/9/2022,QL98T02HBY,900,"11800"
D10370,2,1/3/2023,RA36LPE5ZQ,8800,"3000"
D10370,2,1/3/2023,RA39LO4UPF,3000,0
D10370,3,1/28/2023,RAS0D0Q78Q,12600,0
D10370,4,2/17/2023,RBH6UGCXH8,12000,100
D10370,4,2/17/2023,QKG7395LJP_D2,100,0
D10371,1,11/16/2022,QKG62TQ5CC,1625,"4525"
D10371,1,11/24/2022,QKO7JSG4KF,1625,"2900"
D10371,1,11/29/2022,QKT6WG76IC,1625,"1275"
D10371,1,11/30/2022,QKU3YIFAZ1,1275,0
D10371,2,12/6/2022,QL62K7O4N4,1625,"4475"
D10371,2,12/14/2022,QLE8555FC6,1625,"2850"
D10371,2,12/20/2022,QLK8N3CN48,2850,0
D10371,3,1/2/2023,RA24K1GIV8,3250,"2650"
D10371,3,1/5/2023,RA57RIQ62X,2650,0
D10371,4,1/13/2023,RAD6CD9E6W,3250,"2500"
D10371,4,1/19/2023,RAJ4QDUR4Y,2500,0
D10371,5,1/13/2023,RAD6CD9E6W_D2,3250,"2500"
D10371,5,1/19/2023,RAJ4QDUR4Y_D2,2500,0
D10371,6,1/30/2023,RAU4HOQ1WY,1625,"4375"
D10371,6,2/6/2023,RB6517HMRV,1625,"2750"
D10371,6,2/7/2023,RB734EY49D,2950,200
D10371,7,2/17/2023,RBH1U48BS5,2250,"6080"
D10371,7,2/24/2023,RBO4DZ3K1C,6080,0
D10371,8,3/7/2023,RC797S8A3X,2275,"5845"
D10371,8,3/10/2023,RCA3GHLYMX,5845,0
D10371,9,4/25/2023,RDP7ZVCTT1,1000,"9220"
D10371,9,4/28/2023,RDS18V6SSP,1100,"8120"
D10371,9,5/1/2023,RE18HXLARA,500,"7620"
D10371,9,5/4/2023,RE40OI94VO,600,"7020"
D10371,9,5/15/2023,REF4MDG1HK,780,"6240"
D10372,1,11/21/2022,QKL8DAZDT8,2000,"11600"
D10372,1,11/23/2022,QKN0I4UYCM,600,"11000"
D10372,1,11/23/2022,QKN4HN1MVA,650,"10350"
D10372,1,11/26/2022,QKQ2O9PX74,500,"9850"
D10372,1,11/28/2022,QKS1STPZ4P,500,"9350"
D10372,1,11/30/2022,QKU3Y2Z03T_D2,500,"8850"
D10372,1,12/3/2022,QL247I4HCQ_D2,500,"8350"
D10372,1,12/5/2022,QL52E1NNJM,600,"7750"
D10372,1,12/6/2022,QL68KAELRG,550,"7200"
D10372,1,12/8/2022,QL83O55MV1,1850,"5350"
D10372,1,12/9/2022,QL99QK2LCX,5350,0
D10372,2,12/19/2022,QLJ3IIC0A5,3200,"9800"
D10372,2,12/27/2022,QLR73YXP6V,3000,"6800"
D10372,2,12/29/2022,QLT3AQDOEV,280,"6520"
D10372,2,1/2/2023,RA24KE9FQ0,3000,"3520"
D10372,2,1/6/2023,RA69U9H995,3520,0
D10372,3,1/15/2023,RAF9H4K79R,3000,"8200"
D10372,3,1/18/2022,RAI8N19SMK,8200,0
D10372,4,2/15/2023,RBF9PS6XZH_D1,13200,200
D10372,5,2/15/2023,RBF9PS6XZH_D2,200,400
D10372,5,3/20/2023,RBF9PS6XZH_D3,13400,"13800"
D10372,6,4/20/2023,RDK9MIRR23,13000,600
D10372,6,4/20/2023,RDK5MKLA57,600,0
D10373,1,11/18/2022,QKI67XDJL8,217,"5783"
D10373,1,11/19/2022,QKJ3A4SZF1,100,"5683"
D10373,1,11/19/2022,QKJ3A4XAW9,100,"5583"
D10373,1,11/19/2022,QKJ3A51CXH,17,"5566"
D10373,1,11/20/2022,QKK5CDPTEH,100,"5466"
D10373,1,11/20/2022,QKK8CDSE3I,100,"5366"
D10373,1,11/20/2022,QKK1CDWP31,17,"5349"
D10373,1,11/17/2022,QKH05N3HZW,217,"5132"
D10373,1,11/21/2022,QKL3EQMIP3,100,"5032"
D10373,1,11/21/2022,QKL9EQP225,100,"4932"
D10373,1,11/21/2022,QKL1EQQFGT,17,"4915"
D10373,1,11/22/2022,QKM2H08BRO,100,"4815"
D10373,1,11/22/2022,QKM7H0F6RH,100,"4715"
D10373,1,11/22/2022,QKM5H0QSOF,17,"4698"
D10373,1,11/23/2022,QKN5JFUNAN,100,"4598"
D10373,1,11/23/2022,QKN9JFVUKT,100,"4498"
D10373,1,11/23/2022,QKN2JFWOUW,17,"4481"
D10373,1,11/24/2022,QKO5LLQC9L,100,"4381"
D10373,1,11/24/2022,QKO7LLTP8D,100,"4281"
D10373,1,11/24/2022,QKO0LLW7E0,17,"4264"
D10373,1,11/25/2022,QKP9O3AAOD,100,"4164"
D10373,1,11/25/2022,QKP9O3GMFT,100,"4064"
D10373,1,11/25/2022,QKP5O3IKFZ,17,"4047"
D10373,1,11/26/2022,QKQ1QDFNE5,100,"3947"
D10373,1,11/26/2022,QKQ2QDKYNG,100,"3847"
D10373,1,11/26/2022,QKQ5QDWDAV,17,"3830"
D10373,1,11/27/2022,QKR7SOEFHT,100,"3730"
D10373,1,11/27/2022,QKR7SOH5JJ,100,"3630"
D10373,1,11/27/2022,QKR7SOK6HH,17,"3613"
D10373,1,11/28/2022,QKS5V3VOLZ,100,"3513"
D10373,1,11/28/2022,QKS9V441JP,100,"3413"
D10373,1,11/28/2022,QKS0V477JW,17,"3396"
D10373,1,11/29/2022,QKT1XH22MZ,100,"3296"
D10373,1,11/29/2022,QKT7XH4JPJ,100,"3196"
D10373,1,11/29/2022,QKT6XH58AS,17,"3179"
D10373,1,11/30/2022,QKU5ZXPJVR,100,"3079"
D10373,1,11/30/2022,QKU3ZXS719,100,"2979"
D10373,1,11/30/2022,QKU3ZXUOQZ,17,"2962"
D10373,1,12/1/2022,QL114596LV,100,"2862"
D10373,1,12/1/2022,QL1645FZFM,100,"2762"
D10373,1,12/2/2022,QL217ANIIP,100,"2662"
D10373,1,12/2/2022,QL287AR23E,100,"2562"
D10373,1,12/2/2022,QL257B2END,17,"2545"
D10373,1,12/4/2022,QL42DYH0GC,434,"2111"
D10373,1,12/5/2022,QL59EZFWBH,2111,0
D10373,2,12/5/2022,QL50H81PIG,217,"6283"
D10373,2,12/6/2022,QL62JXXX86,100,"6183"
D10373,2,12/6/2022,QL67K57Y8D,100,"6083"
D10373,2,12/6/2022,QL62K5AU1G,17,"6066"
D10373,2,12/8/2022,QL86Q3ZDHW,100,"5966"
D10373,2,12/8/2022,QL86Q4DDH8,100,"5866"
D10373,2,12/8/2022,QL80Q42CDS,100,"5766"
D10373,2,12/8/2022,QL80Q440VK,100,"5666"
D10373,2,12/8/2022,QL86Q4ES54,34,"5632"
D10373,2,12/11/2022,QLB0Y8HBPA,100,"5532"
D10373,2,12/11/2022,QLB8Y8JEJE,100,"5432"
D10373,2,12/11/2022,QLB7Y8W1RZ,100,"5332"
D10373,2,12/11/2022,QLB3Y8ZLI7,100,"5232"
D10373,2,12/11/2022,QLB8Y9E4P2,34,"5198"
D10373,2,12/12/2022,QLC61UPXPM,100,"5098"
D10373,2,12/12/2022,QLC11US51B,100,"4998"
D10373,2,12/12/2022,QLC91UTI6F,100,"4898"
D10373,2,12/12/2022,QLC41UUHKG,100,"4798"
D10373,2,12/14/2022,QLE85G8CZM,100,"4698"
D10373,2,12/14/2022,QLE075A058,100,"4598"
D10373,2,12/21/2022,QLL4PR9WWO,1000,"3598"
D10373,2,12/24/2022,QLO5WI16O9,1438,"2160"
D10373,2,12/26/2022,QLQ63STKXI,100,"2060"
D10373,2,12/26/2022,QLQ93SZR4H,100,"1960"
D10373,2,12/26/2022,QLQ03T4SHE,17,"1943"
D10373,2,12/27/2022,QLR1614RJJ,100,"1843"
D10373,2,12/27/2022,QLR7615W03,100,"1743"
D10373,2,1/3/2023,RA38LUT15M,1743,0
D10373,3,1/10/2023,RAA42LRSK6,1300,"5500"
D10373,3,1/18/2023,RAI0MC5ZVU,1304,"4196"
D10373,3,1/25/2023,RAP64XYTGU,1950,"2246"
D10373,3,2/3/2023,RB33T6OP0J,2246,0
D10373,4,2/17/2023,RBH7U25KTV,2140,"6890"
D10373,4,2/25/2023,RBP4FT9TEI,2128,"4762"
D10373,4,3/2/2023,RC20TBAR2Q,2128,"2634"
D10373,4,3/7/2023,RC7480IPNA,2634,0
D10373,5,4/4/2023,RD48DU485I,9030,0
D10374,1,11/26/2022,QKQ5OLNEZX,1600,"4800"
D10374,1,12/13/2022,QLD52OI7MH,4800,0
D10374,2,1/10/2023,RAA24VGDIU,5000,"1500"
D10374,2,1/10/2023,RAA44WLAK2,1500,0
D10374,3,2/6/2023,RB651ID2R9_D2,6400,0
D10375,1,1/19/2023,RAJ8PL5PLG,200,"8560"
D10375,1,1/23/2023,RAN9YZFM53,200,"8360"
D10375,1,1/26/2023,RAQ07S57L2,200,"8160"
D10375,1,2/7/2023,RB743VBFR2,200,"7960"
D10375,1,2/17/2023,RBH9TZII7R,400,"7560"
D10376,1,12/14/2022,QLE74VESYB,8960,0
D10376,2,1/12/2023,RAB2776XU4,9000,100
D10376,2,1/12/2023,RAD6AAFHKE_D2,100,0
D10377,1,11/23/2022,QKN6HBYP0O,200,"6000"
D10377,1,11/30/2022,QKU5YY0IO5,100,"5900"
D10377,1,30/11/2022,QKU1YY55WL,100,"5800"
D10377,1,30/11/2022,QKU8YYFC0I,40,"5760"
D10377,1,12/2/2022,QL264K1W9A,100,"5660"
D10377,1,12/2/2022,QL234K5YZP,100,"5560"
D10377,1,12/2/2022,QL224KCOUM,20,"5540"
D10377,1,12/5/2022,QL56H3932C,1010,"4530"
D10377,1,12/5/2022,QL50H3EEDE,100,"4430"
D10377,1,12/5/2022,QL56H3HY3M,40,"4390"
D10377,1,12/11/2022,QLB2XI1AC8,3000,"1390"
D10377,1,12/14/2022,QLE151B6HV,1390,0
D10377,2,1/12/2023,RAC07L645M,6500,0
D10377,3,2/10/2023,QLE151B6HV_D2,6500,0
D10377,4,3/10/2023,RCA7G6SOWL,6500,0
D10377,5,4/21/2023,RDL9PSLWU3,200,"7100"
D10378,1,12/1/2022,QL163FB9J4,1625,"5175"
D10378,1,12/8/2022,QL87NUZIYR,1625,"3550"
D10378,1,12/16/2022,QLG8B3VJ4K,1625,"1925"
D10378,1,12/21/2022,QLL0O9IBIK,1925,0
D10378,2,1/14/2023,RAE3D3VIIZ,3780,0
D10378,3,1/21/2023,RAL5V9YK4R,1625,"5175"
D10378,3,2/14/2023,RBE2MYMFXQ,4875,300
D10378,3,2/14/2023,RBE7NSHT7N,300,0
D10379,1,27-11-2022,QKR1SSHJYZ,109,"3016"
D10379,1,25-11-2022,QKP3O73GK3,109,"2907"
D10379,1,24-11-2022,QKO4LQTKFI,109,"2798"
D10379,1,24-11-2022,QKO2JNBF22,109,"2689"
D10379,1,11/29/2022,QKT0V6QT8U,109,"2580"
D10379,1,11/29/2022,QKT6XBM8Z2,109,"2471"
D10379,1,12/3/2022,QL33AGOZC1,327,"2144"
D10379,1,12/5/2022,QL50GJ03VG,218,"1926"
D10379,1,12/7/2022,QL76N5ETM8,327,"1599"
D10379,1,12/11/2022,QLB8VYW1PA,436,"1163"
D10379,1,12/14/2022,QLE04TVY5C,218,945
D10379,1,12/14/2022,QLE275PIBG,218,727
D10379,1,12/16/2022,QLG4AAJSSE,218,509
D10379,1,12/16/2022,QLG9BDFTVP_D2,484,25
D10379,1,12/16/2022,QLG1BE0SSP,25,0
D10379,2,17/12/2022,QLH8FD1MH0,109,"3141"
D10379,2,12/22/2022,QLM1SCWB99,327,"2814"
D10379,2,12/26/2022,QLQ328XBXV,218,"2596"
D10379,2,12/26/2022,QLQ53VOLND,109,"2487"
D10379,2,12/29/2022,QLT88POIJ4,218,"2269"
D10379,2,12/29/2022,QLT1AJE913,327,"1942"
D10379,2,12/31/2022,QLV1DIAVUT,218,"1724"
D10379,2,12/31/2022,QLV2FJV9LM,109,"1615"
D10379,2,1/4/2023,RA48P49HG2,327,"1288"
D10379,2,1/5/2023,RA50RPQJSK,109,"1179"
D10379,2,1/6/2023,RA63U2QF9L,109,"1070"
D10379,2,1/7/2023,RA76WPJHLM,109,961
D10379,2,1/9/2023,RA942EYH4I,218,743
D10379,2,1/10/2023,RAA84U922Q,218,525
D10379,2,1/12/2023,RAC57QJG4D,109,416
D10379,2,1/14/2023,QLT1AJE913_D2,416,0
D10379,3,1/15/2023,RAF3H3IYGF,100,"3100"
D10379,3,1/16/2023,RAG8JHKM2I,118,"2982"
D10379,3,1/17/2023,RAH2M2E3CE,109,"2873"
D10379,3,1/19/2023,RAJ2OQHDBQ,109,"2764"
D10379,3,1/19/2023,RAJ6R4YL8M,109,"2655"
D10379,3,1/20/2023,RAK1TLQBDB,100,"2555"
D10379,3,1/21/2023,RAL3VV2DA1,118,"2437"
D10379,3,1/22/2023,RAM8YJYAYC,109,"2328"
D10379,3,1/26/2023,RAQ37E1DPN,327,"2001"
D10379,3,1/26/2023,RAQ49RY4AA,100,"1901"
D10379,3,1/28/2023,RAS5CNVF5T,118,"1783"
D10379,3,1/30/2023,RAU3JSLIXT,218,"1565"
D10379,3,1/31/2023,RAV6M5WTXA,218,"1347"
D10379,3,2/3/2023,RB33SGIJI9,218,"1129"
D10379,3,2/4/2023,RB42WZGEUU,109,"1020"
D10379,3,2/7/2023,RB733QE3ED,218,802
D10379,3,2/9/2023,RB9292FE52,218,584
D10379,3,2/10/2023,RBA3BHX9IZ,218,366
D10379,3,2/10/2023,RAQ37E1DPN_D2,366,0
D10379,4,2/18/2023,RBI1WPTES3,327,"3073"
D10379,4,2/23/2023,RBN5B9QQZ3,500,"2573"
D10379,4,3/2/2023,RC24SL63NS,372,"2201"
D10379,4,3/2/2023,RC21URDABZ,327,"1874"
D10379,4,3/5/2023,RC562WNTHI,250,"1624"
D10379,4,3/13/2023,RCE2QDY4UA,1624,0
D10379,5,4/13/2023,RDD64DQLBG,3250,0
D10379,6,4/25/2023,RDP1Z2HSBN,218,"3182"
D10379,6,5/6/2023,RE64W22CPG,327,"2855"
D10379,6,5/15/2023,REF6KHURIY,2705,150
D10379,6,5/17/2023,REH2QOHG9A,150,0
D10379,7,6/2/2023,RF271NHPUL,327,"2923"
D10379,7,6/14/2023,RFE8ZV3PJ0,600,"2323"
D10379,7,6/16/2023,RFG97AG15Z,2323,0
D10379,8,6/26/2023,RFS55DT3JL,327,"2723"
D10379,8,6/28/2023,RFQ42D47A8,327,"2396"
D10379,8,6/30/2023,RFU6CFI8RG,490,"1906"
D10379,8,7/1/2023,RG12H422RK,654,"1252"
D10379,8,7/2/2023,RG23JUWLSN,327,925
D10379,8,7/6/2023,RG60TCXV1Y,925,0
D10379,9,7/23/2023,RGN79XE97P,1500,"3050"
D10379,9,7/27/2023,RGR8LDSYAC,300,"2750"
D10379,9,7/31/2023,RGV4UIXX8M,850,"1900"
D10379,9,8/2/2023,RH262I59WU,2150,250
D10379,10,8/18/2023,RHI8ERWYP6,650,"3900"
D10380,1,11/30/2022,QKU8ZP8RBC,500,"3010"
D10380,1,12/1/2022,QL193191L9,495,"2515"
D10380,1,12/7/2022,QL72MS841Y,975,"1540"
D10380,1,12/8/2022,QL82NX0Y20,1540,0
D10380,2,12/18/2022,QLI0HE5SSI,975,"3765"
D10380,2,1/6/2023,RA64U802WW,100,"3665"
D10380,2,1/6/2023,RA63U82NY1,100,"3565"
D10380,2,1/6/2023,RA64U8674Y,100,"3465"
D10380,2,1/6/2023,RA66U89IW4,100,"3365"
D10380,2,1/13/2023,RAD3BDGYFT,500,"2865"
D10380,2,1/15/2023,RAF1GPB72Z,300,"2565"
D10380,2,1/16/2023,RAG9JGK9DR,200,"2365"
D10380,2,1/17/2023,RAH3M07WTX,200,"2165"
D10380,2,1/20/2023,RAK0TL4CEU,200,"1965"
D10381,1,12/8/2022,QL80NQN15C,11400,0
D10381,2,2/15/2023,RBF7OK0PD5,13000,0
D10381,3,3/2/2023,RC22T5P9ZO,11600,0
D10381,4,4/14/2023,RDE073AL9U,13000,0
D10381,5,5/11/2023,REB0BQGXSQ,18750,0
D10381,6,6/12/2023,RFC0VH4KSK,20400,0
D10381,7,6/27/2023,RFR42RS5YS,17250,0
D10381,8,7/24/2023,RGO1B4UYMF,25600,0
D10381,9,8/22/2023,RHM3QE1H4L,25800,0
D10382,1,11/27/2022,QKR7QXQWTL,250,"5450"
D10382,1,11/28/2022,QKS0T3U4WM,250,"5200"
D10382,1,11/29/2022,QKT9VKN3JN,250,"4950"
D10382,1,12/1/2022,QL182R7BO2,250,"4700"
D10382,1,12/2/2022,QL284RJ5ZS,250,"4450"
D10382,1,12/7/2022,QL72M2WO8Y,500,"3950"
D10382,1,12/9/2022,QL92Q90TBM,800,"3150"
D10382,1,12/9/2022,QL91SVHREJ,3150,0
D10382,2,12/10/2022,QLA7VHQQGV,250,"5350"
D10382,2,12/12/2022,QLC81F513I,300,"5050"
D10382,2,12/17/2022,QLH5DVM513,5050,0
D10382,3,12/15/2022,QLI6HFR3FY,250,"5350"
D10382,3,12/19/2022,QLJ7K07YZ1,300,"5050"
D10382,3,12/22/2022,QLM8QTXI2A,5600,550
D10382,4,12/22/2022,QLM8QTXI2A_D2,550,"5150"
D10382,4,12/31/2022,QLV5E6RVJ3,600,"4550"
D10382,4,1/4/2022,QLJ7K07YZ1_D2,4550,0
D10382,5,1/17/2023,RAH1KBO71X,200,"6300"
D10382,5,1/18/2023,RAI1NKC5SD,250,"6050"
D10382,5,3/6/2023,RC636JOU0T,100,"5950"
D10383,1,11/29/20222,QKT7WGD3ZN,100,"6400"
D10383,1,11/29/2022,QKT9WGW06N,100,"6300"
D10383,1,11/29/2022,QKT6WH1XUI,20,"6280"
D10383,1,11/30/2022,QKU2YQNZEA,100,"6180"
D10383,1,11/30/2022,QKU1YQT24V,100,"6080"
D10383,1,11/30/2022,QKU0YQXW3C,20,"6060"
D10383,1,12/1/2022,QL172TE1ZL,100,"5960"
D10383,1,12/1/2022,QL172TJ3FT,100,"5860"
D10383,1,12/1/2022,QL102TNN3K,20,"5840"
D10383,1,12/2/2022,QL225YDT8I,100,"5740"
D10383,1,12/2/2022,QL245YK0A0,100,"5640"
D10383,1,12/2/2022,QL245YODNA,20,"5620"
D10383,1,12/3/2022,QL329MC0PE,100,"5520"
D10383,1,12/3/2022,QL339MHQGD,100,"5420"
D10383,1,12/3/2022,QL369MOPI8,20,"5400"
D10383,1,12/4/2022,QL48DRS528,100,"5300"
D10383,1,12/4/2022,QL43DRWH6N,100,"5200"
D10383,1,12/4/2022,QL44DS0XIM,20,"5180"
D10383,1,12/5/2022,QL51GLVFAD,100,"5080"
D10383,1,12/5/2022,QL53GMELKZ,20,"5060"
D10383,1,12/5/2022,QL55GMSFXL,100,"4960"
D10383,1,12/6/2022,QL66J5AVPG,100,"4860"
D10383,1,12/6/2022,QL68J5H8U4,100,"4760"
D10383,1,12/6/2022,QL66J5P6RE,20,"4740"
D10383,1,12/7/2022,QL78LXRUX4,100,"4640"
D10383,1,12/7/2022,QL77LXYMBB,100,"4540"
D10383,1,12/7/2022,QL78LY94GY,20,"4520"
D10383,1,12/8/2022,QL80PDWD3E,100,"4420"
D10383,1,12/8/2022,QL80PEEQWE,100,"4320"
D10383,1,12/8/2022,QL84PET1OG,20,"4300"
D10383,1,12/9/2022,QL90SL0YS4,100,"4200"
D10383,1,12/9/2022,QL91SL6LEB,100,"4100"
D10383,1,12/9/2022,QL94SLCISW,20,"4080"
D10383,1,12/10/2022,QLA9UL8VGD,100,"3980"
D10383,1,12/10/2022,QLA1ULF0X7,100,"3880"
D10383,1,12/10/2022,QLA6ULK78K,20,"3860"
D10383,1,12/11/2022,QLB9XG153B,100,"3760"
D10383,1,12/11/2022,QLB6XG6Y0W,100,"3660"
D10383,1,12/11/2022,QLB7XGBZFH,20,"3640"
D10383,1,12/12/2022,QLC8ZY2XJU,100,"3540"
D10383,1,12/12/2022,QLC8ZY6PMG,100,"3440"
D10383,1,12/12/2022,QLC9ZYCGCP,20,"3420"
D10383,1,12/13/2022,QLD83L3BVO,100,"3320"
D10383,1,12/13/2022,QLD13LA2Q9,100,"3220"
D10383,1,12/13/2022,QLD93LHEGD,20,"3200"
D10383,1,12/14/2022,QLE86QAKDS,100,"3100"
D10383,1,12/14/2022,QLE96Q3ISD,100,"3000"
D10383,1,12/14/2022,QLE46PW5DS,20,"2980"
D10383,1,12/15/2022,QLF19W2C3X,100,"2880"
D10383,1,12/15/2022,QLF59W4D5H,100,"2780"
D10383,1,12/15/2022,QLF29W6HNK,20,"2760"
D10383,1,12/16/2022,QLG1CMMBSB,100,"2660"
D10383,1,12/16/2022,QLG1CMPBPB,100,"2560"
D10383,1,12/16/2022,QLG1CMTXGT,20,"2540"
D10383,1,12/17/2022,QLH0FBX2B8,100,"2440"
D10383,1,12/17/2022,QLH9FC02GT,100,"2340"
D10383,1,12/17/2022,QLH8FC2YM8,20,"2320"
D10383,1,12/19/2022,QLJ4HVL8QG,100,"2220"
D10383,1,12/19/2022,QLJ3HVL905,100,"2120"
D10383,1,12/19/2022,QLJ8HVL0YU,20,"2100"
D10383,1,12/19/2022,QLJ5K8ITDR,100,"2000"
D10383,1,12/19/2022,QLJ3K8O44D,100,"1900"
D10383,1,12/19/2022,QLJ0K91ZUU,17,"1883"
D10383,1,12/20/2022,QLK6N3MJA4,100,"1783"
D10383,1,12/20/2022,QLK3N3O9GN,100,"1683"
D10383,1,12/20/2022,QLK3N3PPI9,20,"1663"
D10383,1,12/22/2022,QLM5PV6NPF,100,"1563"
D10383,1,12/22/2022,QLM3PV6XSZ,100,"1463"
D10383,1,12/22/2022,QLM8PV6MTU,20,"1443"
D10383,1,12/22/2022,QLM1SFL377,100,"1343"
D10383,1,12/22/2022,QLM0SFOJVS,100,"1243"
D10383,1,12/22/2022,QLM3SFQZQ3,20,"1223"
D10383,1,12/24/2022,QLO3VFBJU7,100,"1123"
D10383,1,12/24/2022,QLO6VFCCVA,100,"1023"
D10383,1,12/24/2022,QLO8VFCOS8,20,"1003"
D10383,1,12/24/2022,QLO8Y35R40,100,903
D10383,1,12/24/2022,QLO1Y3BHOH,100,803
D10383,1,12/24/2022,QLO7Y3HHN3,20,783
D10383,1,12/26/2022,QLQ31PRLIL,100,683
D10383,1,12/26/2022,QLQ31PSMHZ,100,583
D10383,1,12/26/2022,QLQ51PSYL1,20,563
D10383,1,12/26/2022,QLQ43V6DMY,100,463
D10383,1,12/26/2022,QLQ43V7HNS,100,363
D10383,1,12/26/2022,QLQ53V82CJ,20,343
D10383,1,12/27/2022,QLR06126ZU,160,183
D10383,1,12/28/2022,QLS687G1G8,100,83
D10383,1,12/28/2022,QLS187KC31,100,17
D10383,2,1/1/2023,RA11G1GGPH,450,"12550"
D10383,2,1/1/2023,RA11I9LEDV,450,"12100"
D10383,2,1/2/2023,RA24JTYEBM,450,"11650"
D10383,2,1/3/2023,RA37MWI24T,450,"11200"
D10383,2,1/4/2023,RA49PAHDVX,450,"10750"
D10383,2,1/6/2023,RA68RTVHCW_D2,450,"10300"
D10383,2,1/6/2023,RA68U8WUXA,450,"9850"
D10383,2,1/7/2023,RA78WPCHF2,400,"9450"
D10383,2,1/8/2023,RA88YW8YCI,450,"9000"
D10383,2,1/9/2023,RA922B62CE,400,"8600"
D10383,2,1/11/2023,RAB4782Z2A,450,"8150"
D10383,2,1/12/2023,RAC19UX5NB,450,"7700"
D10383,2,1/15/2023,RAF3F6WVLD,400,"7300"
D10383,2,1/18/2023,RAI7OHRT6J,550,"6750"
D10383,2,1/20/2023,RAK0RGTEQ8,400,"6350"
D10383,2,1/20/2023,RAK0TIX8A2,500,"5850"
D10383,2,1/21/2023,RAL0W4YDXE,430,"5420"
D10383,2,1/23/2023,RAO42MKYXI,400,"5020"
D10383,2,1/25/2023,RAP44XBKPG,350,"4670"
D10383,2,1/26/2023,RAQ99UFLQX,380,"4290"
D10383,2,1/27/2023,RAR8BM3W8M,2700,"1590"
D10383,2,1/29/2023,RAT7H46YO7,1600,10
D10383,3,2/1/2023,RB18P2VE0G,500,"14100"
D10383,3,2/3/2023,RB26RRWBUE,500,"13600"
D10383,3,2/26/2023,RBQ2JXSWQ4,500,"13100"
D10383,3,3/2/2023,RC24SWXY70,2000,"11100"
D10383,3,3/4/2023,RC49YR5WBZ,1000,"10100"
D10383,3,3/5/2023,RC523YX3TK,1000,"9100"
D10383,3,3/6/2023,RC655WSYCT,1100,"8000"
D10383,3,3/8/2023,RC83A4Z6J9,300,"7700"
D10383,3,3/9/2023,RC90EQZU2I,400,"7300"
D10383,3,3/11/2023,RCB4K1UZFS,300,"7000"
D10383,3,3/14/2023,RCE6QLMJ76,400,"6600"
D10383,3,3/17/2023,RCH1124Y1T,300,"6300"
D10383,3,3/20/2023,RCK29IJWUE,200,"6100"
D10383,3,3/23/2023,RCN5FVYNAR,100,"6000"
D10383,3,3/31/2023,RCV82JR4MO,200,"5800"
D10383,3,4/7/2023,RD78LQE47Q,100,"5700"
D10383,3,5/29/2023,RET5QRVVUP,200,"5500"
D10383,3,6/1/2023,RF13XBDOHF,2000,"3500"
D10383,3,6/1/2023,RF15XG4WEL,3500,0
D10385,1,12/5/2022,QL54FM8144,100,"3620"
D10385,1,12/5/2022,QL57FMCMM9,30,"3590"
D10385,1,12/6/2022,QL64JLEHQW,100,"3490"
D10385,1,12/6/2022,QL64JLEHQW_D2,30,"3460"
D10385,1,12/7/2022,QL77M7KGOD,100,"3360"
D10385,1,12/7/2022,QL74M7PWYO,100,"3260"
D10385,1,12/8/2022,QL85PCQPVL,30,"3230"
D10385,1,12/9/2022,QL90R1BDBC,100,"3130"
D10385,1,12/10/2022,QLA6TRMCPG,60,"3070"
D10385,1,12/10/2022,QLA5UNCB8L,100,"2970"
D10385,1,12/11/2022,QLB7WK86YR,100,"2870"
D10385,1,12/11/2022,QLB4WMCW6K,30,"2840"
D10385,1,12/12/2022,QLC2YHEQX8,100,"2740"
D10385,1,12/12/2022,QLC4YHIVC2,30,"2710"
D10385,1,12/13/2022,QLD82VSHGY,100,"2610"
D10385,1,12/13/2022,QLD62VZRN8,30,"2580"
D10385,1,12/14/2022,QLE668GP3I,100,"2480"
D10385,1,12/14/2022,QLE068V87A,27,"2453"
D10385,1,12/15/2022,QLF68L41RU,100,"2353"
D10385,1,12/15/2022,QLF08L79DW,30,"2323"
D10385,1,12/169/2022,QLG7C7VAAR,100,"2223"
D10385,1,12/16/2022,QLG6C80YJS,30,"2193"
D10385,1,12/17/2022,QLH8DWTK9K,100,"2093"
D10385,1,12/17/2022,QLH5DWZOER,100,"1993"
D10385,1,12/18/2022,QLI2FQBE1A,30,"1963"
D10385,1,12/19/2022,QLJ6I33WR8,100,"1863"
D10385,1,12/19/2022,QLJ3I36JNT,90,"1773"
D10385,1,12/20/2022,QLK6MZYQRC,100,"1673"
D10385,1,12/20/2022,QLK8N09H9U,30,"1643"
D10385,1,12/21/2022,QLL1NVDH75,100,"1543"
D10385,1,12/21/2022,QLL8NVOCHQ,30,"1513"
D10385,1,12/22/2022,QLM7Q4KZHF,100,"1413"
D10385,1,12/22/2022,QLM0Q7NEHS,30,"1383"
D10385,1,12/23/2022,QLN4UJXFFC,100,"1283"
D10385,1,12/23/2022,QLN6UK34S6,30,"1253"
D10385,1,12/24/2022,QLO5W6C2FD,100,"1153"
D10385,1,12/24/2022,QLO4W6GH1C,30,"1123"
D10385,1,12/25/2022,QLP0YP516O,30,"1093"
D10385,1,12/25/2022,QLP4YVCLLK,100,993
D10385,1,12/25/2022,QLP6YVQFQE,100,893
D10385,1,12/25/2022,QLP8YVU0SK,100,793
D10385,1,12/25/2022,QLP1YVX0B7,60,733
D10385,1,12/27/2022,QLR550ULQX,900,167
D10385,2,12/27/2022,QLR550ULQX_D2,167,"3733"
D10385,2,1/4/2023,RA40OHJZF0,100,"3633"
D10385,2,1/5/2023,RA52RGA97I,100,"3533"
D10385,2,1/5/2023,RA56RGMVJQ,30,"3503"
D10385,2,1/6/2023,RA68TEV9M8,100,"3403"
D10385,2,1/6/2023,RA61TF5DYP,23,"3380"
D10385,2,1/8/2023,RA85XDSNNP,100,"3280"
D10385,2,1/8/2023,RA86XDYAWO,30,"3250"
D10385,2,1/8/2023,RA86XUPY2M,100,"3150"
D10385,2,1/8/2023,RA83Y9QE6T,30,"3120"
D10385,2,1/10/2023,RAA52U7S1H,100,"3020"
D10385,2,1/10/2023,RAA739N327,30,"2990"
D10385,2,1/11/2023,RAB262RMCI,100,"2890"
D10385,2,1/11/2023,RAB06QY0EK,30,"2860"
D10385,2,1/12/2023,RAC68VYWAQ,100,"2760"
D10385,2,1/12/2023,RAC98W4FVT,60,"2700"
D10385,2,1/13/2023,RAE3CNJDM9,100,"2600"
D10385,2,1/13/2023,RAE7CNOVJD,100,"2500"
D10385,2,1/13/2023,RAE1CNRR6V,60,"2440"
D10385,2,1/15/2023,RAF8FAMTSY,100,"2340"
D10385,2,1/15/2023,RAF3FAV36D,28,"2312"
D10385,2,1/16/2023,RAG4I5PL3M,30,"2282"
D10385,2,1/16/2023,RAG7IVHGH3,100,"2182"
D10385,2,1/17/2023,RAH6KA8EVI,100,"2082"
D10385,2,1/17/2023,RAH9KAJ0HN,20,"2062"
D10385,2,1/19/2023,RAJ5PCNHP3,100,"1962"
D10385,2,1/19/2023,RAJ0PCSK5U,100,"1862"
D10385,2,1/19/2023,RAJ9Q2ER1T,50,"1812"
D10385,2,1/20/2023,RAK7S46THN,100,"1712"
D10385,2,1/20/2023,RAK9S4MHW1,30,"1682"
D10385,2,1/21/2023,RAL3VKBISF,100,"1582"
D10385,2,1/21/2023,RAL6VKRLH0,40,"1542"
D10385,2,1/22/2023,RAM9YD2CQ7,100,"1442"
D10385,2,1/22/2023,RAM7YD9LT1,30,"1412"
D10385,2,1/23/2023,RAN51KTZDR,100,"1312"
D10385,2,1/23/2023,RAN81KXRJ8,30,"1282"
D10385,2,1/24/2023,RAO23WI5D6,100,"1182"
D10385,2,1/24/2023,RAO53WLCNJ,30,"1152"
D10385,2,1/25/2023,RAP65W3AUQ,100,"1052"
D10385,2,1/25/2023,RAP65WBLIY,100,952
D10385,2,1/26/2023,RAQ27JW0AY,60,892
D10385,2,1/27/2023,RAR8AM95QQ,100,792
D10385,2,1/28/2023,RAS3CO5F7F,100,692
D10385,2,1/28/2023,RAS5CP7RVD,60,632
D10385,2,1/29/2023,RAT2FCG08Q,100,532
D10385,2,1/29/2023,RAT1FCLIOV,28,504
D10385,2,1/30/2023,RAU8IFW35A,572,68
D10385,3,1/31/2023,RAV6LXD8GK,100,"5060"
D10385,3,1/31/2023,RAV1LXLURT,100,"4960"
D10385,3,2/1/2023,RB10MP0YTU,100,"4860"
D10385,3,2/1/2023,RB15MP6O6R,100,"4760"
D10385,3,2/2/2023,RB25QMX7O3,100,"4660"
D10385,3,2/2/2023,RB27QN66S3,20,"4640"
D10385,3,2/3/2023,RB33S2Z8YV,100,"4540"
D10385,3,2/3/2023,RB38S347SI,100,"4440"
D10385,3,2/4/2023,RB47VLDEDP,100,"4340"
D10385,3,2/5/2023,RB54XME5WS,100,"4240"
D10385,3,2/5/2023,RB58XMIO5Q,70,"4170"
D10385,3,2/6/2023,RB681TBKIO,100,"4070"
D10385,3,2/6/2023,RB621THOZQ,70,"4000"
D10385,3,2/7/2023,RB763QU6K6,100,"3900"
D10385,3,2/7/2023,RB723QYARM,100,"3800"
D10385,3,2/8/2023,RB896A92VV,100,"3700"
D10385,3,2/8/2023,RB856AE1Z9,70,"3630"
D10385,3,2/10/2023,RBA4BPUCQ0,354,"3276"
D10385,3,2/11/2023,RBD0JHV7KQ,340,"2936"
D10385,3,2/13/2023,RBD0JHV7KQ_D2,100,"2836"
D10385,3,2/13/2023,RBD7JI262P,100,"2736"
D10385,3,2/14/2023,RBE6MNIZFS_D2,100,"2636"
D10385,3,2/14/2023,RBE4MV8V34,48,"2588"
D10385,3,2/15/2023,RBF4PPCFF2,100,"2488"
D10385,3,2/15/2023,RBF5PR752T,100,"2388"
D10385,3,2/17/2023,RBH0TZ3PEE,100,"2288"
D10385,3,2/17/2023,RBI4WKL8YE,100,"2188"
D10385,3,2/17/2023,RBI6WKVEVS,100,"2088"
D10385,3,2/17/2023,RBH0TZ3PEE_D2,48,"2040"
D10385,3,2/18/2023,RBI4WKL8YE_D2,100,"1940"
D10385,3,2/18/2023,RBI6WKVEVS_D2,80,"1860"
D10385,3,2/19/2023,RBJ5ZF14N7,100,"1760"
D10385,3,2/19/2023,RBJ4ZF648Q,100,"1660"
D10385,3,2/20/2023,RBL46DT45C,100,"1560"
D10385,3,2/20/2023,RBL26E0CU0,100,"1460"
D10385,3,2/21/2023,RBL46DT45C_D2,100,"1360"
D10385,3,2/21/2023,RBL26E0CU0_D2,100,"1260"
D10385,3,2/22/2023,RBM77W5GBV,100,"1160"
D10385,3,2/22/2023,RBM77W94TV,100,"1060"
D10385,3,02/23/2023,RBN3AQJ5NF,100,960
D10385,3,2/24/2023,RBO3D4DKKD,100,860
D10385,3,2/28/2023,RBS7NVY2IT,860,0
D10385,4,3/2/2023,RC25TQOEK7,100,"4540"
D10385,4,3/2/2023,RC24TQTES8,100,"4440"
D10385,4,3/3/2023,RC31VGAKMH,100,"4340"
D10385,4,3/3/2023,RC31VGJ8TN,100,"4240"
D10385,4,2/28/2023,RBS5P6N0IN,100,"4140"
D10385,4,3/1/2023,RC13RO6ZSX,200,"3940"
D10385,4,3/4/2023,RC40YDR826,200,"3740"
D10385,4,3/5/2023,RC52429MXM,100,"3640"
D10385,4,3/5/2023,RC5942E2AR,45,"3595"
D10385,4,3/6/2023,RC695C1529,200,"3395"
D10385,4,3/7/2023,RC717NQR9T,100,"3295"
D10385,4,3/7/2023,RC717OJ4AH,100,"3195"
D10385,4,3/9/2023,RC96EH8XA4,340,"2855"
D10385,4,3/10/2023,RCA8HQS886,200,"2655"
D10385,4,3/11/2023,RCB9ILO9S9,200,"2455"
D10385,4,3/12/2023,RCC9N3TF1D,200,"2255"
D10385,4,3/13/2023,RCD0PHBQQU,200,"2055"
D10385,4,3/14/2023,RCE1S3HTE5,200,"1855"
D10385,4,3/15/2023,RCF0U86D1M,1855,0
D10385,5,3/22/2023,RCM7DYPYLF,400,"6900"
D10385,5,3/23/2023,RCN3GS2RHN,451,"6449"
D10385,5,3/26/2023,RCQ2OWH6J4,400,"6049"
D10385,5,3/29/2023,RCT7VZQDM5,268,"5781"
D10385,5,4/2/2023,RD2282TPG2,700,"5081"
D10385,5,4/3/2023,RD38B7UJZ6,200,"4881"
D10385,5,4/4/2023,RD43ELJ2S9,500,"4381"
D10385,5,4/8/2023,RD88PZZ5X0,200,"4181"
D10386,1,12/21/2022,QLL1NT9AQT,300,"6200"
D10386,1,1/12/2023,RAC583JX0H,200,"6000"
D10387,1,3/8/2023,RC91DAXOGZ,13000,0
D10387,2,4/9/2023,RD97R17A75,3000,"10600"
D10387,2,4/11/2023,RDB8W38820,10600,0
D10388,1,2/20/2023,RBK82ZKD58,500,"7300"
D10388,1,2/25/2023,RBP0FNP0HK,1000,"6300"
D10388,1,3/3/2023,RC38VGHM02,600,"5700"
D10388,1,3/8/2023,RC92DWYZLM,5700,0
D10388,2,4/5/2023,RD56GBOZPK,7800,0
D10388,3,5/3/2023,RE32NWXYK0,7800,0
D10389,1,3/1/2023,RC16RM01EW,3200,"9800"
D10389,1,3/8/2023,RC86CFWDEU,3300,"6500"
D10389,1,3/15/2023,RCF6VG5I5G,3250,"3250"
D10389,1,3/22/2023,RCM4EYC798,3250,0
D10389,2,6/14/2023,RFE92RG9VJ,3250,"9050"
D10389,2,6/24/2023,RFO0VRUC82,9050,0
D10390,1,3/31/2023,RCV720LK5J,6500,"6500"
D10390,2,6/30/2023,RFU0D2RK1W,100,"7800"
D10391,1,3/4/2023,RC421RWDLS,435,"11365"
D10391,1,3/5/2023,RC574AO01X,435,"10930"
D10391,1,3/6/2023,RC6374TFAX,435,"10495"
D10391,1,3/7/2023,RC77A08E2N,435,"10060"
D10391,1,3/8/2023,RC89COA1CZ,400,"9660"
D10391,1,3/9/2023,RC99FGZ35P,435,"9225"
D10391,1,3/10/2023,RCA1IBDRHF,400,"8825"
D10391,1,3/11/2023,RCB2L5QQDQ,435,"8390"
D10391,1,3/12/2023,RCC9NLBMJX,435,"7955"
D10391,1,3/15/2023,RCF5SXL47R,435,"7520"
D10391,1,3/15/2023,RCF0VLY7U2,435,"7085"
D10391,1,3/16/2023,RCG6YCPUA0,435,"6650"
D10391,1,3/18/2023,RCI24WPEAW,435,"6215"
D10391,1,3/19/2023,RCJ77DRJWJ,435,"5780"
D10391,1,3/20/2023,RCK08CKIHU,5480,300
D10391,1,3/20/2023,RCK78OTTVB,300,0
D10391,2,3/22/2023,RCM8F5RO98,435,"13165"
D10391,2,3/28/2023,RCS4UQMUNI,350,"12815"
D10391,2,3/29/2023,RCT5XF6G9B,435,"12380"
D10392,1,4/24/2023,RDO8WK623K,14600,0
D10393,1,4/4/2023,RD44CXSBBE,3000,"10000"
D10393,1,4/6/2023,RD67J2LELF,3250,"6750"
D10393,1,4/9/2023,RD91QDUKOX,3250,"3500"
D10393,1,4/12/2023,RDC3ZYP405,3500,0
D10393,2,5/8/2023,RE851H9Y0J,6500,"6500"
D10393,2,5/11/2023,REB8AIR99U,6500,0
D10393,3,5/27/2023,RER9LHARWR,3250,"9750"
D10393,3,6/8/2023,RF82I3XJOK,9750,0
D10393,4,7/5/2023,RG51RSXBKR,6500,"6500"
D10393,4,7/6/2023,RG69TMHPAB,6500,0
D10393,5,8/2/2023,RH272VDNSZ,12600,200
D10393,5,8/2/2023,RH2633KI3Y,200,0
D10394,1,6/23/2023,RFN7RE7SX3,500,"12500"
D10394,1,6/24/2023,RFO5US3IAV,500,"12000"
D10394,1,6/25/2023,RFP5YB6W8J,350,"11650"
D10394,1,6/26/2023,RFQ61S0T4Y,400,"11250"
D10394,1,6/28/2023,RFS05J68W0,600,"10650"
D10394,1,6/29/2023,RFT08JA0JY,600,"10050"
D10394,1,7/8/2023,RG841OLHL0,1200,"8850"
D10394,1,7/10/2023,RGA67U7I3Q,300,"8550"
D10394,1,7/19/2023,RGJ2WQNP4M,8550,0
D10394,2,8/14/2023,RHE82ORZ6Y,12800,200
D10395,1,7/4/2023,RG49OVNNPX,1625,"4875"
D10395,1,7/11/2023,RGB7A8F8TR,1625,"3250"
D10395,1,7/18/2023,RGI8UF57U6,1625,"1625"
D10395,1,7/25/2023,RGP3E3I3PF,1625,0
D10395,2,8/1/2023,RH11Z0FUHJ,1625,"4425"
D10395,2,8/8/2023,RH82L5JJ3A,1625,"2800"
D10395,2,8/15/2023,RHF46R6RI0,2800,0
D10395,3,8/22/2023,RHM5RMIK35,3250,"9750"
D10396,1,6/29/2023,RFT39SEKJN,310,"8720"
D10396,1,6/30/2023,RFU4CVPMIG,310,"8410"
D10396,1,7/1/2023,RG15GABAZ3,310,"8100"
D10396,1,7/4/2023,RG45NVKSUN,1000,"7100"
D10396,1,7/6/2023,RG68U39BNC,650,"6450"
D10396,1,7/8/2023,RG8624PI6G,650,"5800"
D10396,1,7/10/2023,RGA878SHNK,650,"5150"
D10396,1,7/12/2023,RGC8CZWHGQ,650,"4500"
D10396,1,7/14/2023,RGE6IS03UC,650,"3850"
D10396,1,7/17/2023,RGH3RJXHJD,1000,"2850"
D10396,1,7/20/2023,RGK8Z4FTTG,600,"2250"
D10396,1,7/22/2023,RGM96XBLBH,500,"1750"
D10396,1,7/26/2023,RGQ6GEIMD8,600,"1150"
D10396,1,7/26/2023,RGQ2H8SIYM,1150,0
D10396,2,7/28/2023,RGS0NOA5I0,350,"8750"
D10396,2,7/30/2023,RGU2SXQNFW,600,"8150"
D10396,2,8/1/2023,RH12ZEALZM,700,"7450"
D10396,2,8/3/2023,RH37621CID,700,"6750"
D10396,2,8/6/2023,RH61ET3RQR,1000,"5750"
D10396,2,8/10/2023,RHA3QD4MOT,1200,"4550"
D10396,2,8/14/2023,RHE840XKJW,350,"4200"
D10396,2,8/13/2023,RHD1ZXVYZX,800,"3400"
D10396,2,8/16/2023,RHG19KI2RP,700,"2700"
D10396,2,8/21/2023 12:57:49,RHL9NVUGNL,1000,"1700"
D10396,2, 8/19/2023 13:37:23,RHJ2IDBMP8,900,800
D10396,2,7/27/2023,RGR7KD4ACX,400,400
D10396,2,8/22/2023,RHM4R4N76C,400,0
D10397,1,7/24/2023,RGP7D84PM5,3250,"9750"
D10397,1,8/2/2023,RH3860PR0K,9750,0
D10398,1,7/19/2023,RGJ1Y340ZP,1000,"5500"
D10400,1,07/18/2023 23:13:12,RGI8VIC5VQ,230,"6570"
D10400,1,07/17/2023 10:42:51,RGH2QCGX3M,460,"6110"
D10401,1,7/22/2023,RGM16X6WIB,3250,"9750"
D10401,1,7/30/2023,RGU5S6TM8R,3250,"6500"
D10401,1,8/6/2023,RH67DRT08P,3250,"3250"
D10401,1,8/9/2023,RH95MC7ORN,650,"2600"
D10401,1,8/13/2023,RHD21VNQ3S,2600,0
D10402,1,8/17/2023,RHH2C9H5DQ,2200,"6900"