Application ID,Loan No.,Repaid Date,Mpesa Code,Amount,Balance
N3001,1,11/21/2022,QKL0E0DQR0,400,8700
N3001,1,12/06/2022,QL67J8JRIB,500,8200
N3001,1,12/11/2022,QLB3Y2UADJ,500,7700
N3001,1,12/13/2022,QLD43PQTF6,500,7200
N3001,1,12/23/2022,QLN5V1AKK3,1000,6200
N3001,1,01/09/2023,RA902FJM98,500,5700
N3001,1,01/17/2023,RAH8K8RR6U,2000,3700
N3001,1,02/03/2023,RB35S2SYWB,400,3300
N3001,1,02/20/2023,RBK62JL3PG,500,2800
N3001,1,04/10/2023,RDA1UEUFYX,300,2500
N3001,1,06/16/2023,RFG07B69KC,300,2200
N3001,1,06/18/2023,RFI6EI80UG,200,2000
N3002,1,12/12/2022,QLC5YHHOR1,6000,450
N3002,1,12/14/2022,QLE477YFF6,350,100
N3002,1,12/15/2022,QLF47GPGQE,100,0
N3002,2,3/1/2023,RC19R2FKGT,6500,0
N3002,3,3/28/2023,RCS7T9COCB,6400,0
N3002,4,4/12/2023,RDC8ZJDILM,5800,0
N3002,5,4/22/2023,RDM9T9PVK5,6720,0
N3002,6,5/26/2023,REQ9HQA3ZN,6500,1300
N3002,6,5/26/2023,REQ6I8785A,1300,0
N3003,1,11/19/2022,QKJ38Y99NF,100,6250
N3003,1,11/19/2022,QKJ98YBZHJ,17,6233
N3003,1,11/19/2022,QKJ88YD4AY,100,6133
N3003,1,11/19/2022,QKJ98YFMGJ,100,6033
N3003,1,11/19/2022,QKJ58YGSL3,17,6016
N3003,1,11/19/2022,QKJ88YK0U6,100,5916
N3003,1,11/21/2022,QKL6CX1X2U,100,5816
N3003,1,11/21/2022,QKL9CX5ET1,100,5716
N3003,1,11/21/2022,QKL3CX6C2N,34,5682
N3003,1,11/21/2022,QKL3CX8E2J,100,5582
N3003,1,11/21/2022,QKL7CXCPMN,100,5482
N3003,1,11/22/2022,QKM9F9WEBN,100,5382
N3003,1,11/22/2022,QKM0F9Y8WC,17,5365
N3003,1,11/22/2022,QKM3F9Z6Z3,100,5265
N3003,1,11/23/2022,QKN3IGF9OP,100,5165
N3003,1,11/23/2022,QKN8IGGBA2,17,5148
N3003,1,11/23/2022,QKN1IGIWZP,100,5048
N3003,1,11/24/2022,QKO4LCLUOG,100,4948
N3003,1,11/24/2022,QKO3LCND6X,17,4931
N3003,1,11/24/2022,QKO0LCS5A4,100,4831
N3003,1,11/25/2022,QKP2NZX5CE,100,4731
N3003,1,11/25/2022,QKP4NZYLE2,17,4714
N3003,1,11/25/2022,QKP1O00PUR,100,4614
N3003,1,11/26/2022,QKQ0QIUG82,100,4514
N3003,1,11/26/2022,QKQ3QIW02Z,17,4497
N3003,1,11/26/2022,QKQ6QIXRZM,100,4397
N3003,1,11/27/2022,QKR2SP82TK,100,4297
N3003,1,11/27/2022,QKR3SP8NQN,17,4280
N3003,1,11/27/2022,QKR8SPATZG,100,4180
N3003,1,11/28/2022,QKS2V3PRRY,100,4080
N3003,1,11/28/2022,QKS2V3RB0A,100,3980
N3003,1,11/28/2022,QKS3V3SUQ5,17,3963
N3003,1,11/29/2022,QKT0X5U9JY,100,3863
N3003,1,11/29/2022,QKT6X6UGT2,100,3763
N3003,1,11/29/2022,QKT4X6XEFI,17,3746
N3003,1,11/30/2022,QKU7ZMEEYN,100,3646
N3003,1,11/30/2022,QKU4ZMKBR4,100,3546
N3003,1,11/30/2022,QKU7ZMZUNR,17,3529
N3003,1,12/01/2022,QL1344OX4J,100,3429
N3003,1,12/01/2022,QL1244RT12,100,3329
N3003,1,12/01/2022,QL1644TGH6,17,3312
N3003,1,12/02/2022,QL247GP1RS,100,3212
N3003,1,12/02/2022,QL257GR7JJ,17,3195
N3003,1,12/02/2022,QL277GS8L7,100,3095
N3003,1,12/03/2022,QL30APLXJ2,100,2995
N3003,1,12/03/2022,QL38ARK2DQ,100,2895
N3003,1,12/03/2022,QL31ARLV4N,17,2878
N3003,1,12/04/2022,QL48DYR2OS,100,2778
N3003,1,12/04/2022,QL48DYSQMK,100,2678
N3003,1,12/04/2022,QL43DYV4BP,17,2661
N3003,1,12/05/2022,QL54H7VWDY,100,2561
N3003,1,12/05/2022,QL56H7XQBW,100,2461
N3003,1,12/05/2022,QL56H7ZV06,17,2444
N3003,1,12/06/2022,QL69KAC5XJ,100,2344
N3003,1,12/06/2022,QL62KAE6JI,100,2244
N3003,1,12/06/2022,QL64KAF2T8,17,2227
N3003,1,12/07/2022,QL70N6N4F4,100,2127
N3003,1,12/07/2022,QL72N6P7A6,100,2027
N3003,1,12/07/2022,QL74N6T5R4,17,2010
N3003,1,12/08/2022,QL85Q3T8WR,100,1910
N3003,1,12/08/2022,QL81Q3V0DX,100,1810
N3003,1,12/08/2022,QL87Q3W5XX,17,1793
N3003,1,12/09/2022,QL92SW4Q3O,100,1693
N3003,1,12/09/2022,QL91SW7C9N,17,1676
N3003,1,12/09/2022,QL92SUKUE0,100,1576
N3003,1,12/10/2022,QLA6VQ3DUS,100,1476
N3003,1,12/10/2022,QLA2VQBGPI,100,1376
N3003,1,12/10/2022,QLA3VQFSSP,17,1359
N3003,1,12/11/2022,QLB2Y8LSTW,100,1259
N3003,1,12/11/2022,QLB5Y8NFHX,17,1242
N3003,1,12/11/2022,QLB7Y8P86L,100,1142
N3003,1,12/12/2022,QLC51UZUJ5,100,1042
N3003,1,12/12/2022,QLC11V11MP,17,1025
N3003,1,12/12/2022,QLC21V37MS,100,925
N3003,1,12/13/2022,QLD94HG7VJ,100,825
N3003,1,12/13/2022,QLD04HJHBW,100,725
N3003,1,12/13/2022,QLD44HMC6S,17,708
N3003,1,12/14/2022,QLE052AX0U,708,0
N3003,2,12/15/2022,QLF79VATD5,100,8790
N3003,2,12/15/2022,QLF59VDEH1,100,8690
N3003,2,12/15/2022,QLF59VFTQZ,100,8590
N3003,2,12/16/2022,QLG2CNH5RS,100,8490
N3003,2,12/16/2022,QLG8CNJB2Q,100,8390
N3003,2,12/16/2022,QLG2CNMQPE,100,8290
N3003,2,12/16/2022,QLG1CNOM87,4,8286
N3003,2,12/17/2022,QLH9FBLT0X,100,8186
N3003,2,12/17/2022,QLH0FBOR7G,100,8086
N3003,2,12/17/2022,QLH4FBRAG0,100,7986
N3003,2,12/17/2022,QLH7FBTT6H,4,7982
N3003,2,12/18/2022,QLI0HQET3Q,100,7882
N3003,2,12/19/2022,QLJ7KDY14Z,100,7782
N3003,2,12/19/2022,QLJ5KE43HH,100,7682
N3003,2,12/19/2022,QLJ3KE714H,100,7582
N3003,2,12/19/2022,QLJ6KEBSI0,4,7578
N3003,2,12/20/2022,QLK4N2JNZ2,100,7478
N3003,2,12/20/2022,QLK4N2L5EY,100,7378
N3003,2,12/20/2022,QLK2N2MTE2,100,7278
N3003,2,12/20/2022,QLK5N2OAVZ,4,7274
N3003,2,12/21/2022,QLL4PLTIWY,100,7174
N3003,2,12/21/2022,QLL6PLXU16,100,7074
N3003,2,12/21/2022,QLL1PM225P,100,6974
N3003,2,12/21/2022,QLL5PM5EXB,4,6970
N3003,2,12/22/2022,QLM5SHT9CZ,100,6870
N3003,2,12/22/2022,QLM6SHUE8E,100,6770
N3003,2,12/22/2022,QLM6SHW0SG,100,6670
N3003,2,12/22/2022,QLM1SHXG7P,4,6666
N3003,2,12/23/2022,QLN3VDIQBT,100,6566
N3003,2,12/23/2022,QLN7VDJNN3,100,6466
N3003,2,12/23/2022,QLN1VDKY5N,100,6366
N3003,2,12/23/2022,QLN8VDN42U,4,6362
N3003,2,12/24/2022,QLO9YC82BR,100,6262
N3003,2,12/24/2022,QLO2YC9BYW,100,6162
N3003,2,12/24/2022,QLO3YCBNNF,100,6062
N3003,2,12/24/2022,QLO7YCDLH5,4,6058
N3003,2,12/25/2022,QLP41NGKZE,100,5958
N3003,2,12/25/2022,QLP11NIOGT,100,5858
N3003,2,12/25/2022,QLP01NKZRE,100,5758
N3003,2,12/25/2022,QLP21NM704,4,5754
N3003,2,12/26/2022,QLQ13V8JFZ,100,5654
N3003,2,12/26/2022,QLQ03V9EC6,100,5554
N3003,2,12/26/2022,QLQ63VABL0,100,5454
N3003,2,12/26/2022,QLQ03VDZQC,4,5450
N3003,2,12/27/2022,QLR05ZBXC4,100,5350
N3003,2,12/27/2022,QLR15ZENSV,100,5250
N3003,2,12/27/2022,QLR25ZGLJG,100,5150
N3003,2,12/27/2022,QLR45ZIBXC,100,5050
N3003,2,12/27/2022,QLR85ZKDDC,4,5046
N3003,2,12/28/2022,QLS38DSODR,100,4946
N3003,2,12/28/2022,QLS38DU2FZ,100,4846
N3003,2,12/28/2022,QLS18DUMRB,100,4746
N3003,2,12/30/2022,QLS58DW2S7,4,4742
N3003,2,12/30/2022,QLU5BCNYQT,100,4642
N3003,2,12/30/2022,QLU9BCR0L3,100,4542
N3003,2,12/30/2022,QLU7BDUIKZ,100,4442
N3003,2,12/30/2022,QLU2BEEMGK,100,4342
N3003,2,12/30/2022,QLU9BESHF9,100,4242
N3003,2,12/30/2022,QLU7BEWLNB,100,4142
N3003,2,12/30/2022,QLU2BF0XIA,100,4042
N3003,2,12/30/2022,QLU2BFJA84,8,4034
N3003,2,1/1/2023,RA12GR93XO,100,3934
N3003,2,1/1/2023,RA11GRBEVR,100,3834
N3003,2,1/1/2023,RA14GU9X6K,100,3734
N3003,2,1/2/2023,RA25KC7JST,100,3634
N3003,2,1/2/2023,RA23KCCDCT,100,3534
N3003,2,1/2/2023,RA27KCGBCB,100,3434
N3003,2,1/4/2023,RA43NTI2O7,100,3334
N3003,2,1/4/2023,RA40NTM31W,100,3234
N3003,2,1/4/2023,RA41NTQV0H,100,3134
N3003,2,1/4/2023,RA49NTUSCH,4,3130
N3003,2,1/5/2023,RA51ROH53P,100,3030
N3003,2,1/5/2023,RA57RP0CI5,100,2930
N3003,2,1/5/2023,RA59RPISTR,100,2830
N3003,2,1/6/2023,RA77UC2J9F,100,2730
N3003,2,1/6/2023,RA79UC3W2F,100,2630
N3003,2,1/6/2023,RA79UC4ID7,100,2530
N3003,2,1/6/2023,RA79UC5WKP,100,2430
N3003,2,1/6/2023,RA77UC6A5T,100,2330
N3003,2,1/6/2023,RA76UC7EB2,100,2230
N3003,2,1/6/2023,RA79UC8I47,8,2222
N3003,2,1/7/2023,RA72WS88FQ,100,2122
N3003,2,1/7/2023,RA70WSA74E,100,2022
N3003,2,1/7/2023,RA76WSCZYU,4,2018
N3003,2,1/8/2023,RA80Z09KF6,100,1918
N3003,2,1/8/2023,RA85Z0BD2T,100,1818
N3003,2,1/8/2023,RA83Z0DIPR,100,1718
N3003,2,1/8/2023,RA89Z0K5G3,4,1714
N3003,2,1/9/2023,RA99ZQMS5D,1714,0
N3003,3,1/10/2023,RAA54MJSJN,100,12300
N3003,3,1/10/2023,RAA44MLSRW,34,12266
N3003,3,1/10/2023,RAA64MTE48,100,12166
N3003,3,1/10/2023,RAA34NYGVZ,100,12066
N3003,3,1/10/2023,RAA44O30IU,100,11966
N3003,3,1/11/2023,RAB77ALDFV,100,11866
N3003,3,1/11/2023,RAB87ASP3A,100,11766
N3003,3,1/11/2023,RAB97B1YX3,100,11666
N3003,3,1/11/2023,RAB97BAYYN,100,11566
N3003,3,1/11/2023,RAB37BBZOZ,30,11536
N3003,3,1/12/2023,RAC79R90KH,100,11436
N3003,3,1/12/2023,RAC79RB6AJ,100,11336
N3003,3,1/12/2023,RAC19SRHHD,100,11236
N3003,3,1/12/2023,RAC79TECJT,100,11136
N3003,3,1/12/2023,RAC19TIX2F,34,11102
N3003,3,1/13/2023,RAD2CB9OP6,100,11002
N3003,3,1/13/2023,RAD9CBB9FV,100,10902
N3003,3,1/13/2023,RAD0CBDC52,100,10802
N3003,3,1/13/2023,RAD7CBIUIN,100,10702
N3003,3,1/13/2023,RAD9CBKJRF,34,10668
N3003,3,1/14/2023,RAE1EO7OYD,100,10568
N3003,3,1/14/2023,AE9EOCVQ7,100,10468
N3003,3,1/14/2023,RAE0EORL4K,100,10368
N3003,3,1/14/2023,RAE2EOW3XQ,100,10268
N3003,3,1/14/2023,RAE6EOZLX4,34,10234
N3003,3,1/15/2023,RAF0GWHZ6O,100,10134
N3003,3,1/15/2023,RAF0GWOKOE,100,10034
N3003,3,1/15/2023,RAF5GX1OHT,100,9934
N3003,3,1/15/2023,RAF2GX815Y,100,9834
N3003,3,1/15/2023,RAF1GXDUPT,34,9800
N3003,3,1/16/2023,RAG2JHWDOM,100,9700
N3003,3,1/16/2023,RAG0JHZWH0,100,9600
N3003,3,1/16/2023,RAG5JI3L59,100,9500
N3003,3,1/16/2023,RAG6JI3ORK,100,9400
N3003,3,1/16/2023,RAG1JI6CJH,34,9366
N3003,3,1/18/2023,RAI4MFPWUU,100,9266
N3003,3,1/18/2023,RAI3MFVHGR,100,9166
N3003,3,1/18/2023,RAI3MG6F9P,100,9066
N3003,3,1/18/2023,RAI6MGGYOE,100,8966
N3003,3,1/18/2023,RAI5MGW0Y1,34,8932
N3003,3,1/18/2023,RAI8OIJ36I,100,8832
N3003,3,1/18/2023,RAI5OIQUWZ,100,8732
N3003,3,1/18/2023,RAI6OKKWNM,100,8632
N3003,3,1/18/2023,RAI3OKTYK1,100,8532
N3003,3,1/18/2023,RAI7OKVXBX,34,8498
N3003,3,1/19/2023,RAJ1QUBL5D,100,8398
N3003,3,1/19/2023,RAJ2QUGQDG,100,8298
N3003,3,1/19/2023,RAJ6QVIQM8,100,8198
N3003,3,1/19/2023,RAJ7QVTWIV,100,8098
N3003,3,1/19/2023,RAJ0QVZVLQ,34,8064
N3003,3,1/21/2023,RAL1TSP94L,100,7964
N3003,3,1/21/2023,RAL8TSQ37A,100,7864
N3003,3,1/21/2023,RAL0TSRD3U,100,7764
N3003,3,1/21/2023,RAL4TSS0BI,100,7664
N3003,3,1/21/2023,RAL9TSSL99,34,7630
N3003,3,1/21/2023,RAL5WBKTQ7,100,7530
N3003,3,1/21/2023,RAL6WBO7DY,100,7430
N3003,3,1/21/2023,RAL1WBXZEB,100,7330
N3003,3,1/21/2023,RAL5WC22P7,100,7230
N3003,3,1/21/2023,RAL8WCAPYK,34,7196
N3003,3,1/23/2023,RAN1YONDMZ,100,7096
N3003,3,1/23/2023,RAN5YOT87X,100,6996
N3003,3,1/23/2023,RAN5YOV9G1,100,6896
N3003,3,1/23/2023,RAN4YOVWIU,100,6796
N3003,3,1/23/2023,RAN1YOX1X1,34,6762
N3003,3,1/23/2023,RAN926FSBH,100,6662
N3003,3,1/23/2023,RAN726J71R,100,6562
N3003,3,1/23/2023,RAN926O31D,100,6462
N3003,3,1/23/2023,RAN426R702,100,6362
N3003,3,1/23/2023,RAN326UCOT,34,6328
N3003,3,01/24/2023,RAO14N1QST,100,6228
N3003,3,01/24/2023,RAO44N59EY,100,6128
N3003,3,01/24/2023,RAO44N9HR4,100,6028
N3003,3,01/24/2023,RAO24NDCLY,100,5928
N3003,3,01/24/2023,RAO94NFPN9,34,5894
N3003,3,01/26/2023,RAQ59OGTBV,434,5460
N3003,3,01/25/2023,RAP876SNJ0,100,5360
N3003,3,01/25/2023,RAP977043X,100,5260
N3003,3,01/25/2023,RAP8776JDG,100,5160
N3003,3,01/25/2023,RAP877OX98,100,5060
N3003,3,01/27/2023,RAR6C9GZHC,100,4960
N3003,3,01/27/2023,RAR3C9QWOP,100,4860
N3003,3,01/27/2023,RAR3C9V9QL,100,4760
N3003,3,01/27/2023,RAR6C9ZI48,100,4660
N3003,3,01/27/2023,RAR1CA49XN,34,4626
N3003,3,01/28/2023,RAS5ETGEUR,434,4192
N3003,3,01/30/2023,RAU4JSJM4W,1736,2456
N3003,3,02/01/2023,RB18NZE39E,2456,0
N3003,4,2/2/2023,RB21RIIDKZ,434,12566
N3003,4,2/3/2023,RB37UCT20J,100,12466
N3003,4,2/3/2023,RB36UCYH9E,100,12366
N3003,4,2/3/2023,RB39UD3H8N,100,12266
N3003,4,2/3/2023,RB33UD6W75,100,12166
N3003,4,2/3/2023,RB35UD9Z5D,34,12132
N3003,4,2/4/2023,RB49X7BCTH,100,12032
N3003,4,2/4/2023,RB45X7DCD7,100,11932
N3003,4,2/4/2023,RB41X7G2CB,100,11832
N3003,4,2/4/2023,RB48X7O5FE,100,11732
N3003,4,2/4/2023,RB42X8A06A,34,11698
N3003,4,2/5/2023,RB52ZKXYLO,100,11598
N3003,4,2/5/2023,RB51ZOQ28B,100,11498
N3003,4,2/5/2023,RB57ZOS29T,100,11398
N3003,4,2/5/2023,RB57ZPG6AZ,100,11298
N3003,4,2/5/2023,RB58ZPJ9VY,34,11264
N3003,4,2/6/2023,RB6337MVV9,100,11164
N3003,4,2/6/2023,RB6437VEWW,100,11064
N3003,4,2/6/2023,RB6938ONQP,100,10964
N3003,4,2/6/2023,RB653CJAKL,100,10864
N3003,4,2/6/2023,RB653CM3RX,34,10830
N3003,4,2/7/2023,RB795V3MZD,100,10730
N3003,4,2/7/2023,RB775VD94F,100,10630
N3003,4,2/7/2023,RB795VK76Z,100,10530
N3003,4,2/7/2023,RB755WICUX,100,10430
N3003,4,2/8/2023,RB848HQS1Y,268,10162
N3003,4,2/9/2023,RB95B92OD1,434,9728
N3003,4,2/10/2023,RBA1DZH9CF,434,9294
N3003,4,2/11/2023,RBB9GKFWZ1,434,8860
N3003,4,2/12/2023,RBC5J3JZ81,434,8426
N3003,4,2/13/2023,RBD5LKIJ93,434,7992
N3003,4,2/15/2023,RBF3OZLX2N,434,7558
N3003,4,2/15/2023,RBF2QZGXUW,434,7124
N3003,4,02/16/2023,RBG0TLAPDM,434,6690
N3003,4,02/17/2023,RBH9W604HF,434,6256
N3003,4,02/18/0223,RBI6YVLSZW,434,5822
N3003,4,02/19/2023,RBJ926LOT7,434,5388
N3003,4,02/20/2023,RBK14VT88V,434,4954
N3003,4,02/21/2023,RBL472U08W,434,4520
N3003,4,02/22/2023,RBM49W7PLK,434,4086
N3003,4,02/24/2023,RBO1CUTJNX,434,3652
N3003,4,02/24/2023,RBO8EWF4Y4,434,3218
N3003,4,02/25/2023,RBP6HXAW1I,434,2784
N3003,4,02/26/2023,RBQ4KD2JWI,434,2350
N3003,4,02/27/2023,RBR5MYG9F9,434,1916
N3003,4,02/28/2023,RBS3PNVD0B,434,1482
N3003,4,03/01/2023,RC10SF2AU0,434,1048
N3003,4,03/02/2023,RC29U8L663,1048,0
N3003,5,3/3/2023,RC38XXDUOA,520,15080
N3003,5,3/4/2023,RC471O2J15,520,14560
N3003,5,3/5/2023,RC564E7VKA,520,14040
N3003,5,3/5/2023,RC6278YIFU,520,13520
N3003,5,3/7/2023,RC70A0YWNQ,520,13000
N3003,5,3/8/2023,RC82CJZ4S4,520,12480
N3003,5,3/9/2023,RC92FE3BB8,520,11960
N3003,5,3/10/2023,RCA5IA7ZP5,520,11440
N3003,5,3/11/2023,RCB5KYO327,520,10920
N3003,5,3/12/2023,RCC0NHWXQO,520,10400
N3003,5,3/13/2023,RCD2Q3673W,520,9880
N3003,5,3/14/2023,RCE5SOCL9B,520,9360
N3003,5,3/16/2023,RCG6W7WM3A,520,8840
N3003,5,3/16/2023,RCG6YC5ZPA,520,8320
N3003,5,3/17/2023,RCH421YKK2,520,7800
N3003,5,3/18/2023,RCI94W7QFZ,520,7280
N3003,5,3/19/2023,RCJ97DLZQH,520,6760
N3003,5,3/21/2023,RCL3ATRIC7,520,6240
N3003,5,3/22/2023,RCM8D3Y3O6,520,5720
N3003,5,3/23/2023,RCN2HR7AW4,520,5200
N3003,5,3/24/2023,RCO1KF9MUF,520,4680
N3003,5,3/25/2023,RCP1N4ENBB,52,4628
N3003,5,3/25/2023,RCP8N4HP9K,468,4160
N3003,5,3/26/2023,RCQ6PGS7U0,520,3640
N3003,5,3/27/2023,RCR4S1CRSS,520,3120
N3003,5,3/28/2023,RCS5UPV49V,520,2600
N3003,5,3/29/2023,RCT6XESOJS,520,2080
N3003,5,3/30/2023,RCU1ZX1PA7,520,1560
N3003,5,3/31/2023,RCV61I8UF4,1560,0
N3003,6,4/1/2023,RD176QU127,217,6083
N3003,6,4/2/2023,RD2388M1LD,217,5866
N3003,6,4/5/2023,RD51GIGLAF,434,5432
N3003,6,4/6/2023,RD66KPZ95M,217,5215
N3003,6,4/9/2023,RD91QEJ98Z,217,4998
N3003,6,4/10/2023,RDA4VD4OPW,217,4781
N3003,6,4/11/2023,RDB2X18B7M,217,4564
N3003,6,4/12/2023,RDC8ZS49GQ,217,4347
N3003,6,4/13/2023,RDD43PF1JQ,217,4130
N3003,6,4/14/2023,RDE1743GQF,217,3913
N3003,6,04/17/2023,RDH1FA9Y2L,217,3696
N3003,6,04/18/2023,RDI8HYNGZI,217,3479
N3003,6,04/19/2023,RDJ8KUGWRI,217,3262
N3003,6,04/21/2023,RDL9O26VLF,434,2828
N3003,6,04/21/2023,RDL9QKGIWH,434,2394
N3003,6,04/22/2023,RDM6T7TPZQ,434,1960
N3003,6,04/23/2023,RDN2VORIQQ,217,1743
N3003,6,04/24/2023,RDO0YBSJI0,434,1309
N3003,6,04/25/2023,RDP4YZI7OQ,1309,0
N3003,7,4/26/2023,RDQ34GPIJ1,434,12566
N3003,7,4/27/2023,RDR77EDK8F,434,12132
N3003,7,4/28/2023,RDS7A4XRXP,434,11698
N3003,7,4/29/2023,RDT4D20E1O,434,11264
N3003,7,5/1/2023,RE17GYR3P7,434,10830
N3003,7,5/2/2023,RE29KUKTE1,434,10396
N3003,7,5/3/2023,RE30NXMC0U,434,9962
N3003,7,5/4/2023,RE48QM9L4Q,434,9528
N3003,7,5/7/2023,RE73ZGYE4P,434,9094
N3003,7,5/5/2023,RE51TOCSSF,434,8660
N3003,7,05/09/2023,RE95696YCN,434,8226
N3003,7,05/10/2023,REA88WEB94,434,7792
N3003,7,05/12/2023,REC4ER2ALK,434,7358
N3003,7,05/13/2023,RED6HOT5LK,434,6924
N3003,7,05/14/2023,REE1KEWGNV,434,6490
N3003,7,05/15/2023,REF1N8AAX7,434,6056
N3003,7,05/16/2023,REG1PQ17X9,434,5622
N3003,7,05/17/2023,REH5SO53CN,434,5188
N3003,7,05/18/2023,REI1VETAKR,434,4754
N3003,7,05/19/2023,REJ8Y90IDO,434,4320
N3003,7,05/22/2023,REM9692AOX,2000,2320
N3003,7,05/24/2023,REO8BNA66M,2320,0
N3003,8,5/25/2023,REP9FHYH7J,520,14360
N3003,8,5/26/2023,REQ7IKFB1H,520,13840
N3003,8,5/27/2023,RER6LAAB54,520,13320
N3003,8,5/28/2023,RES1NZRZD3,520,12800
N3003,8,5/29/2023,RET8QUIJDM,520,12280
N3003,8,5/31/2023,REV9TUAFN7,520,11760
N3003,8,5/31/2023,REV9WJDYRT,520,11240
N3003,8,6/1/2023,RF17ZE479N,520,10720
N3003,8,6/2/2023,RF233GUEWX,520,10200
N3003,8,6/3/2023,RF316IILXP,520,9680
N3003,8,06/04/2023,RF458Q56MX,520,9160
N3003,8,06/05/2023,RF56C4XXJA,520,8640
N3003,8,06/06/2023,RF68F0K1B6,520,8120
N3003,8,06/07/2023,RF78HNTY78,520,7600
N3003,8,06/08/2023,RF81KU5FW9,520,7080
N3003,8,06/10/2023,RFA9OCM9RZ,520,6560
N3003,8,06/10/2023,RFA4QOTXPM,520,6040
N3003,8,06/11/2023,RFB6TPDLBM,520,5520
N3003,8,06/12/2023,RFC2WJPX12,520,5000
N3003,8,06/14/2023,RFE2ZL5L8M,1040,3960
N3003,8,06/15/2023,RFF53TTUJF,3960,0
N3003,9,6/16/2023,RFG78QH8FN,520,14840
N3003,9,6/17/2023,RFH0BRN3BK,520,14320
N3003,9,6/18/2023,RFI4EHNFQE,520,13800
N3003,9,6/19/2023,RFJ2H6B4EU,520,13280
N3003,9,6/20/2023,RFK7K6M7OD,520,12760
N3003,9,6/21/2023,RFL7MMJSTR,520,12240
N3003,9,6/22/2023,RFM9PK9J7J,520,11720
N3003,9,6/23/2023,RFN1SO4POB,520,11200
N3003,9,6/24/2023,RFO2VSFOMM,520,10680
N3003,9,6/27/2023,RFR55BKGHB,520,10160
N3003,9,06/28/2023,RFS081VNQG,350,9810
N3003,9,06/29/2023,RFT8AYX7EU,360,9450
N3003,9,06/30/2023,RFU7E2WOGT,400,9050
N3003,9,07/01/2023,RG13H0ZWOZ,430,8620
N3003,9,07/02/2023,RG23JVFHR9,520,8100
N3003,9,07/03/2023,RG32MW4WWK,400,7700
N3003,9,07/04/2023,RG46PVZ14U,520,7180
N3003,9,07/05/2023,RG58SZZ33Y,250,6930
N3003,9,07/07/2023,RG75YMC74L,600,6330
N3003,9,07/08/2023,RG842P6LG4,450,5880
N3003,9,07/09/2023,RG955FWNIH,550,5330
N3003,9,07/10/2023,RGA28BNIN4,800,4530
N3003,9,07/11/2023,RGB5B66GWJ,800,3730
N3003,9,07/12/2023,RGC0C0QRJ6,3730,0
N3003,10,7/28/2023 23:13:31,RGS8OIJWBE,350,10050
N3003,10,7/27/2023 23:14:35,RGR0LK6BUM,350,9700
N3003,10,7/26/2023 21:54:50,RGQ4IJ5KFW,350,9350
N3003,10,7/24/2023 21:45:59,RGO7CSLBMN,350,9000
N3003,10,7/22/2023 18:42:27,RGM36OF3EL,350,8650
N3003,10,7/19/2023 23:07:21,RGJ1Y3DBBJ,350,8300
N3003,10,7/19/2023 10:19:22,RGJ9W23E2L,350,7950
N3003,10,7/17/2023 10:44:29,RGH5QCMNLV,350,7600
N3003,10,7/17/2023 10:43:08,RGH1QCIC9T,350,7250
N3003,10,7/15/2023 22:06:08,RGF3MY6XYJ,350,6900
N3003,10,7/14/2023 20:58:13,RGE9JRDY6F,350,6550
N3003,10,7/13/2023 23:11:48,RGD6H3KITE,350,6200
N3003,10,07/31/2023,RGV4WQPA4C,500,5700
N3003,10,08/01/2023,RH18ZUF3RS,500,5200
N3003,10,08/02/2023,RH2044B5MO,500,4700
N3003,10,08/03/2023,RH3572YTNF,500,4200
N3003,10,8/4/2023,RH43A3RCQP,500,3700
N3004,1,11/25/2022,QKP7NINNFF,1625,4125
N3004,1,12/02/2022,QL265ESTO6,4125,0
N3004,2,12/9/2022,QL92R31URO,5600,0
N3004,3,12/19/2022,QLJ1JTYPTF,1625,5675
N3004,3,1/7/2023,RA70V0N844,2000,3675
N3004,3,1/10/2023,RAA72IYCW9,500,3175
N3005,1,12/6/2022,QL68K9UFT0,2600,5200
N3005,1,12/09/2022,QL96R6XTHE,800,4400
N3005,1,12/12/2022,QLC21DNVIG,500,3900
N3005,1,12/12/2022,QLJ8J8IV5C,3900,0
N3006,1,11/30/2022,QKU7XSETFD,900,5600
N3006,1,12/02/2022,QL275HBOOL,625,4975
N3006,1,12/03/2022,QL347UZAB6,100,4875
N3006,1,12/08/2022,QL91QTBHLR,700,4175
N3006,1,12/10/2022,QLA2TC4P5W,580,3595
N3006,1,12/14/2022,QLE05HRPL0,345,3250
N3006,1,12/15/2022,QLF37P5NM1,300,2950
N3006,1,12/06/2022,QLG2AM2BEI,325,2625
N3006,1,12/19/2022,QLJ2I2CA1Y,1000,1625
N3006,1,12/21/2022,QLL6ND4ZSI,300,1325
N3006,1,12/21/2022,QLL7NL2Y75,100,1225
N3006,1,12/23/2022,QLN6SZB1FG,400,825
N3006,1,12/24/2022,QLO1W37L85,825,0
N3006,2,12/28/2022,QLS86D97BW,500,5850
N3006,2,12/29/2022,QLT59CNJFR,100,5750
N3006,2,12/29/2022,QLT09CZG94,100,5650
N3006,2,12/31/2022,QLV4DJVH0O,625,5025
N3006,2,01/01/2023,RA17GGTEZR,300,4725
N3006,2,01/04/2023,RA48ORJ5AI,800,3925
N3006,2,01/05/2023,RA54PIHQQM,200,3725
N3006,2,01/05/2023,RA55PIPF5R,25,3700
N3006,2,01/05/2023,RA55RMSLQL,100,3600
N3006,2,01/05/2023,RA59RN2A39,100,3500
N3006,2,01/08/2023,RA86WXH2D4,400,3100
N3006,2,01/11/2023,RAB45TL6SA,400,2700
N3006,2,01/13/2023,RAD9CAP8J5,100,2600
N3006,2,01/13/2023,RAD0CAV4XA,100,2500
N3006,2,01/13/2023,RAD8BO4T6O,100,2400
N3006,2,01/13/2023,RAD3BOETB9,100,2300
N3006,2,01/14/2023,RAE9CTE1U3,100,2200
N3006,2,01/14/2023,RAE1CTJK1P,100,2100
N3006,2,01/14/2023,RAE7ESQGBR,100,2000
N3006,2,01/15/2023,RAF9F2ZOHL,100,1900
N3006,2,01/15/2023,RAF5H2Q2U3,100,1800
N3006,2,01/15/2023,RAF4H2TQDW,100,1700
N3006,2,01/15/2023,RAF1H2XNE7,25,1675
N3006,2,01/16/2023,RAG3JFFTHX,100,1575
N3006,2,01/17/2023,RAH1JYSKXR,100,1475
N3006,2,01/17/2023,RAH4JZ3I4A,100,1375
N3006,2,01/17/2023,RAH1JZBXTT,100,1275
N3006,2,01/17/2023,RAH7LN724F,1200,75
N3006,2,01/18/2023,RAI5MDOHAT,75,0
N3006,3,1/24/2023,RAO233AA88,1000,5500
N3006,3,1/24/2023,RAO333R609,125,5375
N3006,3,01/24/2023,RAO5382SYP,100,5275
N3006,3,01/26/2023,RAQ77NH9OR,400,4875
N3006,3,02/01/2023,RB10MX4H72,225,4650
N3006,3,02/02/2023,RB24PDQ2CG,200,4450
N3006,3,02/02/2023,RB23QLYVUV,200,4250
N3006,3,02/09/2023,RB929Z5BQG,1000,3250
N3006,3,02/10/2023,RBA0BXJUXE,650,2600
N3006,3,02/10/2023,RBA0BYZG22,300,2300
N3006,3,02/11/2023,RBB2FGDSJQ,675,1625
N3006,3,02/11/2023,RBB5GBDEOH,200,1425
N3006,3,02/12/2023,RBC8H587R4,200,1225
N3006,3,02/12/2023,RBC3J38YXL,80,1145
N3006,3,02/13/2023,RBD5JL1I33,400,745
N3006,3,02/13/2023,RBD7LKNT45,270,475
N3006,3,02/13/2023,RBD9LNN3VX,175,300
N3006,3,02/14/2023,RBF9PSB159,100,200
N3006,3,02/14/2023,RBF9PS6XZH,100,100
N3006,3,02/15/2023,RBF9PS6XZH2,100,0
N3006,3,02/15/2023,RBF9PSB1592,100,-100
N3006,3,02/15/2023,RBF2Q7WFSY,100,-200
N3006,4,3/3/2023,RC34WZDE00,3200,3250
N3006,4,3/12/2023,RCC3LJ91XF,3250,0
N3006,5,4/2/2023,RD32AK7PKA,1000,5450
N3006,5,4/4/2023,RD42CJ2ONC,525,4925
N3006,5,4/4/2023,RD41CJJY7Z,100,4825
N3006,5,04/05/2023,RD50G0XNBW,300,4525
N3006,5,04/05/2023,RD57HCIH3F,300,4225
N3006,5,04/08/2023,RD81OQ5Q6T,600,3625
N3006,5,04/09/2023,RD96SKZMM4,300,3325
N3006,5,04/10/2023,RDA4V78HAG,125,3200
N3006,5,04/14/2023,RDE55SDSHJ,325,2875
N3006,5,04/15/2023,RDF17NPLHX,250,2625
N3006,5,04/16/2023,RDG4AY4ENY,200,2425
N3006,5,04/16/2023,RDG1C6ZR3X,200,2225
N3006,5,04/19/2023,RDJ8IHYJK0,450,1775
N3006,5,04/19/2023,RDJ4ISZYZE,100,1675
N3006,5,04/19/2023,RDJ2IT5T7Y,100,1575
N3006,5,04/23/2023,RDN6TNNW9K,700,875
N3006,5,04/24/2023,RDO5VY9EQL,325,550
N3006,5,04/24/2023,RDO5X5TZZ3,150,400
N3006,5,04/24/2023,RDO5XCLIZV,400,0
N3006,6,5/1/2023,RE14G2D3TQ,625,5675
N3006,6,5/2/2023,RE23ILVJBN,300,5375
N3006,6,5/2/2023,RE27JF5GYX,200,5175
N3006,6,5/3/2023,RE38M1Y5ME,500,4675
N3006,6,5/7/2023,RE75XY17E1,425,4250
N3006,6,5/8/2023,RE80ZXY5FS,200,4050
N3006,6,5/8/2023,RE892ZK20F,300,3750
N3006,6,5/9/2023,RE9040CYPA,350,3400
N3006,6,5/9/2023,RE995STO49,300,3100
N3006,6,5/10/2023,REA26MJ2AI,50,3050
N3006,6,5/14/2023,REE9JKREJF,400,2650
N3006,6,5/17/2023,REH7Q7HF5R,525,2125
N3006,6,5/17/2023,REH6QDSPGI,700,1425
N3006,6,05/20/2023,REK9Z5EJWJ,1425,0
N3006,7,6/16/2023 14:46:22,RFG37FP0KB,"3,250.00",3250
N3006,7,6/14/2023 8:50:43,RFE9ZTIGPL,300,2950
N3006,7,6/13/2023 9:25:10,RFD4X2TZVE,500,2450
N3006,7,6/8/2023 21:01:48,RF88KS6FPE,200,2250
N3006,7,6/5/2023 16:49:03,RF79FMF3X1,300,1950
N3006,7,06-05-2023 16:49:03,RF55AWP51H,25,1925
N3006,7,6/5/2023 16:40:45,RF55AVRBGZ,300,1625
N3006,7,6/3/2023 19:40:09,RF325W97EA,350,1275
N3006,7,6/1/2023 19:41:34,RF15YWYRAD,350,925
N3006,7,5/29/2023 15:51:29,RET9PIHZ13,100,825
N3006,7,5/29/2023 15:47:17,RET0PI40DA,100,725
N3006,7,5/27/2023 19:04:23,RER0KS6PIS,225,500
N3006,7,5/27/2023 8:24:05,RER6IXJZQK,500,0
N3007,1,12/3/2022,QL349UL2XO,3200,9700
N3007,1,12/10/2022,QLA6VGAE3M,3250,6450
N3007,1,12/18/2022,QLI0FPG9QO,3250,3200
N3007,1,12/23/2022,QLN6T8YVB8,3200,0
N3007,2,12/31/2022,QLV9FWHK7D,3250,9750
N3007,2,1/7/2023,RA71WBTVP3,1250,8500
N3007,2,1/15/2023,RAF2GM7W28,2000,6500
N3007,2,1/21/2023,RAL7UM4M95,7100,-600
N3008,1,12/7/2022,QL72KEBXPE,100,5500
N3008,1,12/07/2022,QL77KEDF91,90,5410
N3008,1,12/07/2022,QL73KEEY33,37,5373
N3008,1,12/07/2022,QL72MW8712,100,5273
N3008,1,12/07/2022,QL74MWF5RI,100,5173
N3008,1,12/07/2022,QL77MWLXM7,7,5166
N3008,1,12/08/2022,QL89Q51FO3,100,5066
N3008,1,12/09/2022,QL99Q91FX5,100,4966
N3008,1,12/09/2022,QL91QEJD1N,17,4949
N3008,1,12/10/2022,QLA8UPJTMI,100,4849
N3008,1,12/10/2022,QLA2UTOAO0,100,4749
N3008,1,12/11/2022,QLB4W1RD4C,450,4299
N3008,1,12/12/2022,QLC31TCFY7,100,4199
N3008,1,12/13/2022,QLD12GEFK9,4100,99
N3008,1,12/13/2022,QLD12HGHIV,99,0
N3008,2,12/15/2022,QLF17IITQD,500,8110
N3008,2,12/15/2022,QLF29R6GG8,500,7610
N3008,2,12/17/2022,QLH4FA21VK,450,7160
N3008,2,12/23/2022,QLN7U3MNGD,1300,5860
N3008,2,01/04/2023,RA48N9HDLA,5860,0
N3008,3,1/7/2023,RA76WS4RCI,1000,8100
N3008,3,01/10/2023,RAA649M6UU,1000,7100
N3009,1,12/13/2022,QLD84ESPLQ,1625,5175
N3009,1,12/20/2022,QLK4MZQ1AU,1625,3550
N3009,1,01/02/2023,RA21IQL9LB,600,2950
N3009,1,01/09/2023,RA911DLSVR,1500,1450
N3009,1,01/10/2023,RAA94URM8X,1450,0
N30010,1,12/9/2022,QL96QKG950,500,10800
N30010,1,12/09/2022,QL97SBTNW9,500,10300
N30010,1,12/12/2022,QLC21J8E00,1000,9300
N30010,1,12/14/2022,QLE0766Z2O,1000,8300
N30010,1,12/15/2022,QLF49EERAK,500,7800
N30010,1,12/17/2022,QLH3D9G8HF,500,7300
N30010,1,12/18/2022,QLH5FC0CZ1,500,6800
N30010,1,12/19/2022,QLJ5I6F48J,6700,100
N30010,1,12/19/2022,QLJ0I8GF7G,100,0
N30010,2,12/22/2022,QLL4PTJ632,1000,11200
N30010,2,12/24/2022,QLO7VEEPKN,1000,10200
N30010,2,12/25/2022,QLP21N7HNQ,1000,9200
N30010,2,12/27/2022,QLR55Z5KK5,1000,8200
N30010,2,12/29/2022,QLT1AO186R,1000,7200
N30010,2,1/1/2023,RA19I5L6LD,1000,6200
N30010,2,1/7/2023,RA77WI81HV,1000,5200
N30010,2,1/8/2023,RA89YR21Q9,1000,4200
N30010,2,1/9/2023,RA921QMSVY,4200,0
N30010,3,1/10/2023,RAA64T1H2I,1000,16100
N30010,3,1/12/2023,RAC29O19N6,1300,14800
N30010,3,1/14/2023,RAE9ETIRCJ,650,14150
N30010,3,1/15/2023,RAF9H2YHEF,650,13500
N30010,3,1/16/2023,RAG1JJ6K9D,650,12850
N30010,3,1/17/2023,RAH6LYWJXC,650,12200
N30010,3,1/18/2023,RAI5OENWAH,650,11550
N30010,3,1/19/2023,RAJ9R3ZH0R,500,11050
N30010,3,1/20/2023,RAK1TQV3YN,650,10400
N30010,3,1/21/2023,RAL1W9YOIT,800,9600
N30010,3,1/23/2023,RAN4Z6PUDU,9600,0
N30010,4,1/27/2023,RAR59YLYW5,650,15950
N30010,4,1/25/2023,RAP9797U6Z,650,15300
N30010,4,1/27/2023,RAR59YLYW52,650,14650
N30010,4,1/27/2023,RAR9CF7NX9,650,14000
N30010,4,1/29/2023,RAT1H7IIMT,1300,12700
N30010,4,1/30/2023,RAU1JSI3SZ,650,12050
N30010,4,1/31/2023,RAV9M59UJJ,650,11400
N30010,4,2/1/2023,RB15OW1283,650,10750
N30010,4,2/2/2023,RB29RPOEOP,650,10100
N30010,4,2/4/2023,RB40WZGZ02,1300,8800
N30010,4,2/5/2023,RB54ZKTPM8,650,8150
N30010,4,2/6/2023,RB631BKWLX,8150,0
N30010,5,2/8/2023,RB858MY303,1500,18220
N30010,5,2/10/2023,RBA5DKGE57,1500,16720
N30010,5,2/12/2023,RBC0J4S874,1500,15220
N30010,5,2/14/2023,RBE2OAP7LU,750,14470
N30010,5,2/15/2023,RBF2QX9B4O,750,13720
N30010,5,2/17/2023,RBH1W525NJ,750,12970
N30010,5,2/18/2023,RBI5YRTBHR,750,12220
N30010,5,2/19/2023,RBJ827GQNO,750,11470
N30010,5,2/20/2023,RBK44SVH0O,750,10720
N30010,5,2/21/2023,RBL85CKJ3O,10720,0
N30010,6,2/24/2023,RBO1EMY3WB,3000,16380
N30010,6,2/25/2023,RBP9H76IQ5,750,15630
N30010,6,2/17/2023,RBR5MWEBH9,1500,14130
N30010,6,2/28/2023,RBS0PL009K,750,13380
N30010,6,3/3/2023,RC37XML6D7,750,12630
N30010,6,3/4/2023,RC471V6VW1,1,12629
N30010,6,3/4/2023,RC451V980V,1500,11129
N30010,6,3/5/2023,RC524EG4EU,750,10379
N30010,6,3/6/2023,RC67574J93,10379,0
N30010,7,3/14/2023,RCE0SO0TD6,1474,18246
N30010,7,3/16/2023,RCG8VVQDNO,737,17509
N30010,7,3/18/2023,RCI84CMP7S,737,16772
N30010,7,3/21/2023,RCL4B4VHII,16772,0
N30010,8,4/19/2023,RDJ3ITCVHB,2000,27200
N30010,8,4/24/2023,RDO9Y8EF2L,2000,25200
N30010,8,4/27/2023,RDR87CU13U,2000,23200
N30010,8,5/1/2023,RE10G0XSDK,2000,21200
N30010,8,5/6/2023,RE63URRT2D,500,20700
N30010,8,5/6/2023,RE64WMSP2K,1000,19700
N30010,8,5/5/2023,RE57TBT373,1500,18200
N30010,8,5/10/2023,REA98TDNWJ,1000,17200
N30010,8,5/16/2023,REG2PAM6JK,17200,0
N30011,1,1/5/2023,RA51RE2BXJ,13000,0
N30011,2,2/6/2023,RB651ID2R9,13000,600
N30011,2,02/06/2023,RB641JYZ8C,600,0
N30011,3,3/7/2023,RC798R62KB,13000,0
N30011,4,4/7/2023,RD76M1RPNI,13000,0
N30011,5,5/10/2023,REA47RD6AQ,13000,0
N30012,1,12/22/2022,QLM2SEX4W6,1625,4775
N30012,1,12/29/2022,QLT3AO73CR,1625,3150
N30012,1,01/05/2023,RA59RLJ1M9,1625,1525
N30012,1,01/09/2023,RAA14S5DPV,1525,0
N30012,2,1/18/2023,RAI6OI9YME,3225,9075
N30012,2,1/18/2023,RAI2OM2DMO,25,9050
N30012,2,1/25/2023,RAP07BYBPC,3250,5800
N30012,2,2/1/2023,RB10MN2WN8,5800,0
N30012,3,2/9/2023,RB968YCA7A,3250,9150
N30012,3,2/16/2023,RBF8R0GJ38,3250,5900
N30012,3,2/22/2023,RBM79VIUVX,3250,2650
N30012,3,2/23/2023,RBN7AHC5M1,2650,0
N30012,4,3/10/2023,RC20UZVVQC,6000,5800
N30012,4,3/10/2023,RCA8FMG8FC,1000,4800
N30012,4,3/11/2023,RCB5J50KDN,4600,200
N30012,4,3/11/2023,RCB5J5ISAZ,200,0
N30012,5,3/19/2023,RCJ07D7ZY4,1500,14300
N30012,5,3/26/2023,RCQ7PIC42B,2000,12300
N30012,5,4/12/2023,RDC31CZPOB,3500,8800
N30012,5,4/25/2023,RDP41567YQ,1000,7800
N30012,5,5/3/2023,RE38NWTI24,6000,1800
N30013,1,12/22/2022,QLM9QZS5WN,1625,4825
N30013,1,01/03/2023,RA39LWM2IT,1625,3200
N30013,1,1/9/2023,RA9615RO1I,2500,700
N30013,1,1/11/2023,RAB669QEN8,700,0
N30013,2,2/18/2023,RBI5WYGHNN,90,8670
N30013,2,2/19/2023,RBJ120A7MZ,200,8470
N30013,2,2/21/2023,RBL9590BV3,250,8220
N30014,1,12/17/2022,QLH7FC2AFX,300,5900
N30014,1,12/18/2022,QLI8HHWJ4E,300,5600
N30014,1,12/19/2022,QLJ6KAL6OA,300,5300
N30014,1,12/20/2022,QLK7N2HP91,217,5083
N30014,1,12/21/2022,QLL9PT4LA5,300,4783
N30014,1,12/22/2022,QLM9SDJSC9,300,4483
N30014,1,12/24/2022,QLO4VE63DC,500,3983
N30014,1,12/24/2022,QLO3YCQJ7P,300,3683
N30014,1,12/26/2022,QLQ33M1BMJ,300,3383
N30014,1,12/27/2022,QLR15Y6V0P,500,2883
N30014,1,12/30/2022,QLU6BOKG9Q,300,2583
N30014,1,01/01/2023,RA16HQGV2O,500,2083
N30014,1,01/03/2023,RA34KVPBB6,400,1683
N30014,1,01/04/2023,RA46PA890Y,300,1383
N30014,1,01/09/2023,RA991EHDJZ,1383,0
N30014,2,1/11/2023,RAB150TFFH,650,7960
N30014,2,1/13/2023,RAD3ACLLCH,500,7460
N30014,2,1/14/2023,RAE6ESXFSS,500,6960
N30014,2,1/16/2023,RAG2HBBKH6,500,6460
N30014,2,1/17/2023,RAH3LIKCL1,500,5960
N30014,2,1/19/2023,RAJ2R4XHI8,500,5460
N30014,2,1/20/2023,RAK4TN03RC,500,4960
N30014,2,1/24/2023,RAO232WP0K,1000,3960
N30014,2,1/26/2023,RAQ89N450C,500,3460
N30014,2,1/30/2023,RAU8IP1NHO,1500,1960
N30014,2,1/31/2022,RAV9L26465,1960,0
N30014,3,2/28/2023 21:50:16,RBS6PL9WTA,500,5400
N30014,3,3/3/2023 21:07:58,RC32XTX9WG,500,4900
N30014,3,3/4/2023 22:38:59,RC471VY7U9,500,4400
N30014,3,3/7/2023 22:34:09,RC74A0FJRI,500,3900
N30014,3,3/8/2023,RC87CR9WS9,500,3400
N30014,3,3/10/2023,RCA8I9911K,500,2900
N30014,3,3/13/2023,RCD4NRB0KI,500,2400
N30014,3,3/15/2023,RCF3UGCYF1,700,1700
N30014,3,3/16/2023,RCG2WFN0FW,1700,0
N30014,4,03/24/2023,RCO8I44CUK,1050,9750
N30014,4,03/29/2023,RCT2WZKFGY,3250,6500
N30014,4,04/06/2023,RD60KAFCDA,4000,2500
N30014,4,4/13/2023,RDD845Z68A,2500,0
N30014,5,04/23/2023,RDN5UVV9AJ,1500,4550
N30014,5,05/06/2023,RE68UZP45Y,4550,0
N30014,6,05/15/2023,REF3N0E2TF,3100,9900
N30014,6,05/24/2023,REO2B7IUFG,3100,6800
N30014,6,05/30/2023,REU6TEYOFU,2000,4800
N30014,6,06/06/2023,RF69CZDOVJ,5100,-300
N30014,7,06/27/2023,RFR74VY6AR,7000,6000
N30014,7,07/04/2023,RG48PT1ZXA,6000,0
N30014,8,07/22/2023,RGM56QV633,5950,0
N30015,1,12/17/2022,QLH0DOV4QM,980,6860
N30015,1,12/18/2022,QLI7H0SS7H,980,5880
N30015,1,12/19/2022,QLJ3IS7LYF,980,4900
N30015,1,12/20/2022,QLK4MHH634,980,3920
N30015,1,12/21/2022,QLL0OXPU9Y,980,2940
N30015,1,12/23/2022,QLN8SLBFD0,980,1960
N30015,1,12/24/2022,QLO1VJUTZ7,980,980
N30015,1,12/24/2022,QLO0Y2DPJ2,980,0
N30015,2,3/29/2023,RCT4WD8I6W,1000,24000
N30015,2,03/30/2023,RCU3Z91UN5,1000,23000
N30015,2,3/31/2023,RCV636K6BK,1000,22000
N30015,2,4/1/2023,RD18558URS,1000,21000
N30015,2,4/2/2023,RD218KJHS9,1000,20000
N30015,2,4/3/2023,RD31BEMP6D,1000,19000
N30015,2,4/4/2023,RD47EDLN1P,1000,18000
N30015,2,4/5/2023,RD50H72NTW,1000,17000
N30015,2,4/6/2023,RD62K36P80,1000,16000
N30015,2,04/07/2023,RD79N292ML,1000,15000
N30015,2,04/08/2023,RD86Q1Q4OK,1000,14000
N30015,2,04/09/2023,RD99S71A6H,1000,13000
N30015,2,04/10/2023,RDA5USJ2FB,1000,12000
N30015,2,04/11/2023,RDB3XQL1WF,1000,11000
N30015,2,04/12/2023,RDC41E0B08,1000,10000
N30015,2,04/13/2023,RDD63JX2QI,1000,9000
N30015,2,04/14/2023,RDE37240FP,1000,8000
N30015,2,04/15/2023,RDF59W40B9,1000,7000
N30015,2,04/16/2023,RDG6BZKDWA,1000,6000
N30015,2,04/17/2023,RDH2F18ADU,1000,5000
N30015,2,04/18/2023,RDI6HVXEP6,1000,4000
N30015,2,04/19/2023,RDJ4KA6JXG,1000,3000
N30015,2,04/20/2023,RDK9N9DBNZ,1000,2000
N30015,2,04/21/2023,RDL5Q2547V,1000,1000
N30015,2,04/22/2023,RDM5R0FGCP,1000,0
N30015,3,4/22/2023,RDM9SC91LX,1000,24000
N30015,3,04/23/2023,RDN3VGDVAH,1000,23000
N30015,3,4/24/2023,RDO6XR62DK,1000,22000
N30015,3,4/25/2023,RDP1ZWQZKX,1000,21000
N30015,3,4/26/2023,RDQ94JTA6V,1000,20000
N30015,3,4/27/2023,RDR26V6RL6,1000,19000
N30015,3,4/28/2023,RDS29MOU70,1000,18000
N30015,3,4/29/2023,RDT8CY6C86,1000,17000
N30015,3,4/30/2023,RDU4EU54WO,1000,16000
N30015,3,05/01/2023,RE14HZCPXW,1000,15000
N30015,3,05/02/2023,RE23K6OHJR,1000,14000
N30015,3,05/03/2023,RE38N92XWY,1000,13000
N30015,3,05/04/2023,RE47QHZEAP,1000,12000
N30015,3,05/05/2023,RE63VUAY03,1000,11000
N30015,3,05/06/2023,RE55TN276D,1000,10000
N30015,3,05/07/2023,RE77Z6CY4V,1000,9000
N30015,3,05/08/2023,RE83356E4V,1000,8000
N30015,3,05/09/2023,RE965UYSF4,1000,7000
N30015,3,05/10/2023,REA88HC4VG,1000,6000
N30015,3,05/11/2023,REB1B2DHIF,1000,5000
N30015,3,05/12/2023,REC1E2QRR5,1000,4000
N30015,3,05/14/2023,REE9HWY9R5,1000,3000
N30015,3,05/14/2023,REE7I0VL75,1000,2000
N30015,3,05/15/2023,REF3MW3M1X,1000,1000
N30015,3,05/16/2023,REG0OR4M0S,1000,0
N30015,4,5/16/2023,REG6PQYY3O,1000,24000
N30015,4,05/17/2023,REH9SAS2AB,1000,23000
N30015,4,5/18/2023,REI0V6MBG4,1000,22000
N30015,4,5/20/2023,REK9YDYXFP,1000,21000
N30015,4,5/20/2023,REK422R78I,1000,20000
N30015,4,5/21/2023,REL64J8EME,1000,19000
N30015,4,5/23/2023,REN27M50NK,1000,18000
N30015,4,5/23/2023,REN99NKDZJ,1000,17000
N30015,4,5/24/2023,REO1CTASZR,1000,16000
N30015,4,05/25/2023,REP7F51EL1,1000,15000
N30015,4,05/26/2023,REQ5IH0CXF,1000,14000
N30015,4,05/27/2023,RER7KRBOHX,1000,13000
N30015,4,05/28/2023,RES8NVO190,1000,12000
N30015,4,05/30/2023,REU0QVS60Y,1000,11000
N30015,4,05/31/2023,REV3TQMNA3,1000,10000
N30015,4,05/31/2023,REV4WFJ7LU,1000,9000
N30015,4,06/01/2023,RF17Z3KOVT,1000,8000
N30015,4,06/02/2023,RF223C06YM,1000,7000
N30015,4,06/03/2023,RF35674X7X,1000,6000
N30015,4,06/04/2023,RF448T0DB8,1000,5000
N30015,4,06/05/2023,RF59C5A3FT,1000,4000
N30015,4,06/07/2023,RF78F60VLK,1000,3000
N30015,4,06/08/2023,RF89KI1MKX,1000,2000
N30015,4,06/10/2023,RFA5O4DAHR,1000,1000
N30015,4,06/07/2023,RF77HXKO2B,1000,0
N30015,5,6/10/2023,RFA5QZ1PUX,1300,37100
N30015,5,06/12/2023,RFC6TT1PRU,1300,35800
N30015,5,06/12/2023,RFC5WEO5FZ,1300,34500
N30015,5,6/13/2023,RFD6Z8XWU8,1300,33200
N30015,5,6/14/2023,RFE52VYPUD,1300,31900
N30015,5,6/15/2023,RFF163MPSR,1300,30600
N30015,5,6/16/2023,RFG592NLQ9,1300,29300
N30015,5,6/18/2023,RFI4BZNBX6,1300,28000
N30015,5,6/18/2023,RFI1EJC1FP,1300,26700
N30015,5,06/20/2023,RFK9HE0OUT,1300,25400
N30015,5,06/21/2023,RFL4K7SKQS,1300,24100
N30015,5,06/22/2023,RFM5N2RNG9,1300,22800
N30015,5,06/23/2023,RFN7PXN669,1300,21500
N30015,5,06/24/2023,RFO6SY87YU,1300,20200
N30015,5,06/25/2023,RFP1VYBA6T,1300,18900
N30015,5,06/26/2023,RFQ5YJNMT3,1300,17600
N30015,5,06/27/2023,RFR92I3SRL,1300,16300
N30015,5,06/28/2023,RFS15F78X3,1300,15000
N30015,5,06/29/2023,RFT38886AX,1300,13700
N30015,5,06/30/2023,RFU1BA3RSH,1300,12400
N30015,5,06/30/2023,RFU9DUJJXF,1300,11100
N30015,5,07/02/2023,RG28HAM5B8,1300,9800
N30015,5,07/02/2023,RG27JA4R3T,1300,8500
N30015,5,07/03/2023,RG37MRW551,1300,7200
N30015,5,07/04/2023,RG41PO9DOB,1300,5900
N30015,5,07/05/2023,RG57SWZRHN,1300,4600
N30015,5,07/06/2023,RG69VUG0YN,1300,3300
N30015,5,07/07/2023,RG79WY0P35,3300,0
N30015,6,7/30/2023 21:05:55,RGU1TXKBXP,"3,900.00",35100
N30015,6,07/28/2023 0:37:14,RGS4LLZUL6,"2,600.00",32500
N30015,6,7/25/2023 21:54:19,RGP6FN7CO0,"2,600.00",29900
N30015,6,07/23/2023 19:02:44,RGN29FXSD4,"2,600.00",27300
N30015,6,7/21/2023 21:51:28,RGL74HCCLL,"1,300.00",26000
N30015,6,7/19/2023 20:20:16,RGJ8XQQRWE,"2,600.00",23400
N30015,6,7/17/2023 20:44:49,RGH5SAHCGR,"2,600.00",20800
N30015,6,7/15/2023 21:15:50,RGF4MTF2OC,"2,600.00",18200
N30015,6,7/14/2023 6:59:36,RGE2H9WA72,"1,300.00",16900
N30015,6,7/12/2023 21:48:01,RGC7E239HR,"1,300.00",15600
N30015,6,7/11/2023 20:39:31,RGB8B43JDS,"1,300.00",14300
N30015,6,7/11/2023 5:01:25,RGB58MO4R5,"1,300.00",13000
N30015,6,7/9/2023 23:03:34,RG945KAOT6,"1,300.00",11700
N30015,6,7/9/2023 23:03:34,RG852ROAM5,"1,300.00",10400
N30015,6,7/8/2023 20:56:46,RG73YLT3ND,"1,300.00",9100
N30015,6,07/31/2023,RGV0WPTF7C,2600,6500
N30015,6,08/01/2023,RH14ZWQRMW,1300,5200
N30015,6,08/02/2023,RH203T4O8W,1300,3900
N30015,6,08/03/2023,RH396G201J,1300,2600
N30015,6,08/05/2023,RH51D97FLV,2600,0
N30016,1,1/15/2023,RAF0FJDAV2,1650,11350
N30016,1,1/16/2023,RAG3HHTHQR,1100,10250
N30016,1,1/16/2023,RAG9I87NYJ,500,9750
N30016,1,1/21/2023,RAL3VDODBV,250,9500
N30016,1,01/22/2023,RAM9YGZILZ,450,9050
N30016,1,1/22/2023,RAM7YHWZSL,450,8600
N30016,1,1/23/2023,RAN6ZE0AUW,200,8400
N30016,1,1/24/2023,RAO52P46T9,500,7900
N30016,1,01/25/2023,RAP853055A,500,7400
N30016,1,01/26/2023,RAQ77NQJ8T,500,6900
N30016,1,01/27/2023,RAR4A4UZY6,20,6880
N30016,1,01/27/2023,RAR2A556EM,480,6400
N30016,1,02/03/2023,RB30SF4LGQ,400,6000
N30016,1,02/03/2023,RB41USSWXF,500,5500
N30016,1,02/04/2023,RB46VNA1YW,5500,0
N30016,2,2/13/2023,RBD7JKMASX,400,12600
N30016,2,2/14/2023,RBE6MNIZFS,500,12100
N30016,2,2/15/2023,RBF9PH7ZI7,500,11600
N30016,2,2/17/2023,RBH0U7AZF8,500,11100
N30016,2,2/17/2023,RBH4UIUWY0,300,10800
N30016,2,2/18/2023,RBI1WSHX47,400,10400
N30016,2,2/20/2023,RBK92LDESV,600,9800
N30016,2,2/21/2023,RBL955E3MZ,400,9400
N30016,2,2/22/2023,RBM67ZMWGE,300,9100
N30016,2,2/25/2023,RBP2FKA9WG,500,8600
N30016,2,2/28/2023,RBS7O6633Z,500,8100
N30016,2,3/2/2023,RC22SU2COG,500,7600
N30016,2,3/3/2023,RC36VU7L2K,500,7100
N30016,2,3/4/2023,RC40YTFCPA,6700,400
N30016,2,3/4/2023,RBH0U7AZF82,400,0
N30016,3,3/17/2023,RCH8YNKJMK,700,12300
N30016,3,3/20/2023,RCK77SXOMX,500,11800
N30016,3,3/25/2023,RCP8L42NL2,400,11400
N30016,3,3/27/2023,RCR5PYSR3N,500,10900
N30016,3,3/30/2023,RCU4XRYS8O,500,10400
N30016,3,3/31/2023,RCV11FJ2K9,400,10000
N30016,3,4/1/2023,RD164SPC5M,1000,9000
N30016,3,4/1/2023,RD134SXJN1,9000,0
N30016,4,4/27/2023,RDR862X3HM,500,15300
N30016,4,4/29/2023,RDT7AQTBMJ,500,14800
N30016,4,5/11/2023,REB29J8DPI,500,14300
N30016,4,5/12/2023,REC9D3FML5,300,14000
N30016,4,5/15/2023,REF8L83TMA,500,13500
N30016,4,5/31/2023,REV4V9HDMC,300,13200
N30016,4,6/16/2023,RFG97P6V4B,500,12700
N30016,4,6/21/2023,RFL2KWPTVU,500,12200
N30017,1,1/15/2023,RAF9GXO0TH,3250,10350
N30017,1,2/3/2023,RB32T210AU,1500,8850
N30017,1,2/7/2023,RB744642IA,8850,0
N30018,1,1/17/2023,RAH4KNTJZ8,2000,11600
N30018,1,1/18/2023,RAI2OECF0C,1250,10350
N30018,1,1/26/2023,RAQ29LPCH8,1000,9350
N30018,1,1/30/2023,RAU4J85PQ6,750,8600
N30018,1,1/31/2023,RAV6MGAN8M,500,8100
N30018,1,2/2/2023,RB27PJHE2F,500,7600
N30018,1,2/2/2023,RB26RHIXWO,500,7100
N30018,1,2/6/2023,RB6133H7VZ,500,6600
N30018,1,02/07/2023,RB7762KSDD,500,6100
N30018,1,02/08/2023,RB818E8ZQZ,2000,4100
N30018,1,02/09/2023,RB959LOO0H,4100,0
N30018,2,2/17/2023,RBH9U03E5R,500,13100
N30018,2,2/20/2023,RBK14JZ5OJ,700,12400
N30018,2,2/27/2023,RBR7KPWZWX,300,12100
N30018,2,2/28/2023,RBS6NAYWPM,500,11600
N30018,2,3/2/2023,RC28ST77B6,400,11200
N30018,2,3/8/2023,RC83AFNQFT,400,10800
N30018,2,3/9/2023,RC90D6YC4Q,400,10400
N30018,2,3/10/2023,RCA6FZFHEA,500,9900
N30018,2,3/17/2023,RCH5YKCDPV,1300,8600
N30018,2,3/20/2023,RCK37PAJ8J,900,7700
N30018,2,3/22/2023,RCM1D4MR1T,750,6950
N30018,2,3/25/2023,RCP7L0WNFL,400,6550
N30018,2,3/27/2023,RCR5PTFUZ1,700,5850
N30018,2,3/30/2023,RCU7XYDL5V,300,5550
N30018,2,4/2/2023,RD239CRRZ3,400,5150
N30018,2,4/5/2023,RD53FDDTRL,400,4750
N30018,2,4/9/2023,RD91SPZV25,300,4450
N30018,2,4/11/2023,RDB2VQUU3W,250,4200
N30018,2,5/14/2023,RED5FEK53N,180,4020
N30018,2,06/08/2023,RF81IVLQ2X,300,3720
N30019,1,1/13/2023,RAD8CBBEXM,500,5950
N30019,1,1/15/2023,RAF9GS4VQT,1000,4950
N30019,1,1/17/2023,RAH9M1M8DN,125,4825
N30019,1,1/22/2023,RAM9WPN8KV,500,4325
N30019,1,1/28/2023,RAS4EY18IY,625,3700
N30019,1,2/2/2023,RB25PZUCEJ,500,3200
N30019,1,2/5/2023,RB57YQU5X9,600,2600
N30019,1,2/7/2023,RB7245TIKQ,2650,-50
N30019,2,2/8/2023,RB818NPVJF,232,6268
N30019,2,2/10/2023,RBA4BRXFNA,232,6036
N30019,2,2/12/2023,RBC9IB38HR,232,5804
N30019,2,2/14/2023,RBE4LZE52W,232,5572
N30019,2,2/18/2023,RBI8WSW8L2,300,5272
N30019,2,2/20/2023,RBK639JBJA,300,4972
N30019,2,2/25/2023,RBP7GB6Y69,400,4572
N30019,2,2/26/2023,RBQ5IZZNVX,300,4272
N30019,2,3/2/2023,RC21TAL28B,500,3772
N30019,2,03/07/2023,RC7981AMLH,3772,0
N30019,3,3/12/2023,RCC4LRKOV6,400,6900
N30019,3,3/20/2023,RCK18GU5H5,300,6600
N30019,3,3/23/2023,RCN7G4ASXV,300,6300
N30019,3,4/6/2023,RD64I8M1TQ,300,6000
N30019,3,4/10/2023,RDA3ULZ2IH,1000,5000
N30019,3,4/15/2023,RDF47YJPVS,500,4500
N30019,3,4/15/2023,RDF57YW3Q3,500,4000
N30019,3,4/24/2023,RDO6XZPC5G,500,3500
N30019,3,5/2/2023,RE21IMUGWX,300,3200
N30019,3,05/05/2023,RE57RI5QVP,300,2900
N30019,3,05/10/2023,REA576CAZZ,500,2400
N30019,3,05/15/2023,REF0KVZHRU,300,2100
N30019,3,06/02/2023,RF27ZUDB5X,300,1800
N30019,3,06/04/2023,RF4093S62W,500,1300
N30019,3,06/16/2023,RFG28S428C,100,1200
N30020,1,1/24/2023,RAO62VX348,3250,9750
N30020,1,2/1/2023,RB15P23N9X,3250,6500
N30020,1,2/11/2023,RBB7EZFORR,3250,3250
N30020,1,2/14/2023,RBE9MVGZ8R,3050,200
N30020,1,2/14/2023,RBE8N32PDC,200,0
N30020,2,2/23/2023,RBN9CJM029,2000,11600
N30020,2,3/4/2023,RC42ZR0KNM,1200,10400
N30020,2,3/15/2023,RCF9TPQX2J,3250,7150
N30020,2,3/25/2023,RCP2LKVEN8,1750,5400
N30020,2,4/1/2023,RD134A0LQH,5400,0
N30021,1,2/6/2023,RB67ZX8HGD,100,4900
N30021,1,2/6/2023,RB69ZXD8TV,74,4826
N30021,1,2/7/2023,RB714PV7RR,100,4726
N30021,1,2/7/2023,RB714QBV9P,74,4652
N30021,1,2/8/2023,RB877EI3O1,100,4552
N30021,1,2/8/2023,RB887IJZT0,74,4478
N30021,1,2/9/2023,RB92AT7P42,100,4378
N30021,1,2/9/2023,RB90ATHDMY,74,4304
N30021,1,02/14/2023,RBE3M26MIN,522,3782
N30021,1,02/16/2023,RBG5RKC0S3,470,3312
N30021,1,02/17/2023,RBH1W4ALFJ,300,3012
N30021,1,02/20/2023,RBK744YK1T,400,2612
N30021,1,02/21/2023,RBL87BSPAW,100,2512
N30021,1,02/21/2023,RBL77BXL1T,100,2412
N30021,1,02/23/2023,RBN1AAJ1V5,100,2312
N30021,1,02/23/2023,RBN7ADOZ7X,100,2212
N30021,1,02/28/2023,RBS7OAE0S1,2212,0
N30021,2,3/2/2023,RC25TRI123,100,5060
N30021,2,3/2/2023,RC26TRNQ8I,100,4960
N30021,2,3/9/2023,RC96CVB55C,100,4860
N30021,2,3/9/2023,RC99CVD82D,100,4760
N30021,2,3/11/2023,RCB4JI3KQI,400,4360
N30021,2,3/17/2023,RCH8YMOSLY,400,3960
N30021,2,3/25/2023,RCP4LSPZVO,3000,960
N30021,2,3/28/2023,RCS4TTCAG8,960,0
N30021,3,4/15/2023,RDF17ZR5Z7,500,4700
N30021,3,2/2/2028,RDR65ZSHTW,4700,0
N30021,4,5/31/2023,REV8UYFOFA,500,4940
N30021,4,6/8/2023,RF87IQMHSL,500,4440
N30021,4,6/10/2023,RFA0OYQH3G,500,3940
N30021,4,7/12/2023,RGC2D6O04A,200,3740
N30022,1,2/13/2023,RBD1J9JS01,1300,3700
N30022,1,2/20/2023,RBK3356JNH,1300,2400
N30022,1,2/27/2023,RBR4KVJDAQ,2400,0
N30022,2,3/7/2023,RC747XHG42,1300,4140
N30023,1,2/14/2023,RBE2N6LL06,8960,0
N30023,2,2/25/2023,RBP1G1QXPZ,450,9710
N30023,2,3/3/2023,RC34VOPYLY,300,9410
N30023,2,3/7/2023,RC707JY5M8,700,8710
N30023,2,3/11/2023,RCB1J784KD,8710,0
N30023,3,3/26/2023,RCQ0NGB6Y0,700,9700
N30023,3,3/28/2023,RCS0T6CS1O,300,9400
N30023,3,4/3/2023,RD32AL0QXW,500,8900
N30023,3,4/8/2023,RD82P0Q29A,8900,0
N30023,4,,,,12640
N30024,1,2/7/2023,RB785O83A8,100,4380
N30024,1,2/7/2023,RB7664ED6S,90,4290
N30024,1,2/8/2023,RB8386AIOR,100,4190
N30024,1,2/8/2023,RB858GUETX,75,4115
N30024,1,2/9/0203,RB92B35WEM,200,3915
N30024,1,2/10/2023,RBA8DWTG9O,100,3815
N30024,1,2/10/2023,RBA8DX089K,100,3715
N30024,1,2/11/2023,RBB6GQ4ZLE,200,3515
N30024,1,02/12/2023,RBC9J11779,100,3415
N30024,1,02/12/2023,RBC9J165D5,75,3340
N30024,1,02/14/2023,RBE4M7ZCVM,175,3165
N30024,1,02/14/2023,RBE4N51PC8,3165,0
N30024,2,2/15/2023,RBF3QPSBBR,90,5070
N30024,2,2/15/2023,RBF3QTDFV9,100,4970
N30024,2,2/17/2023,RBH2UX7M5K,100,4870
N30024,2,2/17/2023,RBH6W4SSDG,80,4790
N30024,2,2/19/2023,RBJ826XYT4,200,4590
N30024,2,2/21/2023,RBL86JK4JA,200,4390
N30024,2,2/24/2023,RBO6ENGC24,100,4290
N30024,2,2/25/2023,RBP5G766Z5,300,3990
N30024,2,2/26/2023,RBQ6K1O7B8,200,3790
N30024,2,1/28/2023,RBS5PEC8UV,200,3590
N30024,2,3/13/2023,RCD9O7ZSO1,3590,0
N30024,3,3/15/2023,RCF1VIZKQ1,250,5190
N30024,3,3/16/2023,RCG4YBNDTY,176,5014
N30024,3,3/23/2023,RCN0HOY8TS,500,4514
N30024,3,3/24/2023,RCO5KFFGBX,200,4314
N30024,3,3/26/2023,RCQ1PF0BP5,180,4134
N30024,3,3/27/2023,RCR2S0B530,200,3934
N30025,1,2/9/2023,RB92B0VM2G,304,8610
N30025,1,2/10/2023,RBA4E1Y000,304,8306
N30025,1,2/11/2023,RBB6GRP5TY,304,8002
N30025,1,2/12/2023,RBC6IOZFRW,304,7698
N30025,1,2/13/2023,RBD4LOGDPK,304,7394
N30025,1,2/14/2023,RBE5OCXB6T,304,7090
N30025,1,2/15/2023,RBF4QYKS2Y,304,6786
N30025,1,2/16/2023,RBG1TLSVMZ,304,6482
N30025,1,02/17/2023,RBH8W9MQK4,304,6178
N30025,1,02/18/2023,RBI5YU6E8D,304,5874
N30025,1,02/19/2023,RBJ329S6ML,304,5570
N30025,1,02/20/2023,RBK14VJWFZ,304,5266
N30025,1,02/21/2023,RBL37G6NYH,304,4962
N30025,1,02/22/2023,RBM09Y4WYW,304,4658
N30025,1,02/23/2023,RBN4CJJ1YY,304,4354
N30025,1,02/24/2023,RBO7F6LP69,304,4050
N30025,1,02/25/2023,RBP6I07330,304,3746
N30025,1,02/26/2023,RBQ0KDE3W8,304,3442
N30025,1,02/27/2023,RBR5N0WZZP,304,3138
N30025,1,02/28/2023,RBS3PPO2VV,304,2834
N30025,1,03/01/2023,RC12SHS766,304,2530
N30025,1,03/01/2023,RC12SHS7662,304,2226
N30025,1,03/02/2023,RC21T70DEX,2226,0
N30025,2,3/4/2023,RC44Y87MFI,304,9216
N30025,2,3/5/2023,RC554IBOLH,304,8912
N30025,2,3/6/2023,RC6379Z8EF,304,8608
N30025,2,3/7/2023,RC77A1G2FX,304,8304
N30025,2,3/8/2023,RC84CQQUDC,304,8000
N30025,2,3/9/2023,RC98FJ3FVA,304,7696
N30025,2,3/10/2023,RCA4IBDODA,304,7392
N30025,2,3/12/2023,RCC9L8WJBN,304,7088
N30025,2,3/13/2023,RCD0Q8M9EQ,304,6784
N30025,2,3/14/2023,RCE2SVY1DA,304,6480
N30025,2,03/16/2023,RCG9YAU85R,304,6176
N30025,2,03/17/2023,RCH4225VRM,304,5872
N30025,2,03/18/2023,RCI44UZ3G6,304,5568
N30025,2,03/19/2023,RCJ57D3UYD,304,5264
N30025,2,03/21/2023,RCL9CJEONH,304,4960
N30025,2,03/23/2023,RCN2HS60KQ,304,4656
N30025,2,03/24/2023,RCO3KG6IXP,304,4352
N30025,2,03/25/2023,RCP9N4GZ15,304,4048
N30025,2,03/27/2023,RCR5S2BZ2H,304,3744
N30025,2,03/28/2023,RCS8UQ9ZUS,304,3440
N30025,2,03/29/2023,RCT1XGFRJL,304,3136
N30025,2,03/30/2023,RCU510OTDX,304,2832
N30025,2,03/31/2023,RCV13TZFP9,304,2528
N30025,2,04/01/2023,RD126RQBCA,304,2224
N30025,2,04/02/2023,RD209AR1IU,304,1920
N30025,2,04/03/2023,RD32AF5ZHU,1000,920
N30025,2,04/05/2023,RD53HW83Y9,304,616
N30025,2,04/07/2023,RD71NIT7IB,619,-3
N30025,3,05/11/2023,REC9ESXUH7,700,6600
N30025,4,5/13/2023,RED8HS96EY,217,6383
N30025,4,5/14/2023,REE0KEJ2H8,217,6166
N30025,4,5/17/2023,REH1SMFREP,217,5949
N30025,4,5/18/2023,REI1VFLUUT,217,5732
N30025,4,5/19/2023,REJ1Y9SDVV,217,5515
N30025,4,5/21/2023,REL243QMVG,217,5298
N30025,4,5/24/2023,REO9CWBZA9,217,5081
N30025,4,5/25/2023,REP1FND2HV,217,4864
N30025,4,5/26/2023,REQ2IKZWWA,217,4647
N30025,4,05/27/2023,RER4LGZ412,217,4430
N30025,4,06/01/2023,RF12ZGEIZY,217,4213
N30025,4,06/13/2023,RFD6ZCHVP6,500,3713
N30025,4,06/14/2023,RFE037DBQA,500,3213
N30025,4,06/15/2023,RFF962007T,500,2713
N30025,4,06/19/2023,RFJ6H9XXCC,500,2213
N30025,4,06/20/2023,RFK0K3WQCW,500,1713
N30025,4,06/28/2023,RFS16QFW07,1000,713
N30025,4,06/30/2023,RFU3CMMPH5,730,-17
N30026,1,2/10/2023,RBB0E5HWDO,500,6800
N30026,1,2/20/2023,RBK63RH2V6,400,6400
N30026,1,3/2/2023,RC20U5P3GG,220,6180
N30026,1,3/6/2023,RC615VBH0R,700,5480
N30026,1,3/17/2023,RCH4ZSHZ18,210,5270
N30027,1,2/23/2023,RBN9AVR6IH,1100,6200
N30027,1,2/28/2023,RBS3NV4Y65,550,5650
N3028,1,2/21/2023,RBL75D7JJT,3250,9750
N3028,1,2/27/2023,RBR0M5UA2Q,3250,6500
N3028,1,3/8/2023,RC84AY2RC4,3250,3250
N3028,1,3/10/2023,RCA0GYJOCA,3250,0
N3029,1,3/11/2023,RCB4J77NK8,13000,0
N3029,2,4/24/2023,RDO7XEQNXD,200,14400
N3029,2,5/6/2023,RE69U7K4JJ,3000,11400
N3030,1,2/18/2023,RBI1YY83JN,600,6200
N3030,1,2/20/2023,RBK62J1ZSQ,450,5750
N3030,1,2/24/2023,RBO3F4HMZF,150,5600
N3030,1,2/25/2023,RBP7HX7SP7,500,5100
N3030,1,2/28/2023,RBS8NIO7GA,500,4600
N3030,1,3/2/2023,RC28V1AV2S,300,4300
N3030,1,3/4/2023,RC471RFO0P,450,3850
N3030,1,3/6/2023,RC6977W9Z9,600,3250
N3030,1,3/8/2023,RC88AKUEVS,780,2470
N3030,1,3/8/2023,RC86CRQ0ME,520,1950
N3030,1,3/9/2023,RC99DI7H3V,400,1550
N3030,1,3/11/2023,RCB8L3IAWO,650,900
N3030,1,3/12/2023,RCC7NJNGZB,190,710
N3030,1,3/13/2023,RCD6P58OZO,220,490
N3030,1,3/13/2023,RCD1PIKDAZ,490,0
N3030,2,3/24/2023,RCO7ITSCQJ,700,4500
N3030,2,3/28/2023,RCS8URQDCK,250,4250
N3030,2,3/30/2023,RCU2ZZQ4MA,450,3800
N3030,2,3/31/2023,RCV73RSZQD,150,3650
N3030,2,4/4/2023,RD41CFGUFN,600,3050
N3030,2,4/6/2023,RD63JANPZB,650,2400
N3030,2,4/7/2023,RD71NJHWJL,1000,1400
N3030,2,4/9/2023,RD95SL4ZR5,600,800
N3030,2,4/10/2023,RDA7VDPHIX,150,650
N3030,2,4/11/2023,RDB3W0FT4D,500,150
N3030,2,4/11/2023,RDB9WYQDF9,150,0
N3030,2,,,,0
N3030,3,4/20/2023,RDK0NMGZZE,700,3850
N3030,3,4/23/2023,RDN8VK5U5M,500,3350
N3030,3,4/26/2023,RDQ93FDJ9F,500,2850
N3030,3,5/1/2023,RE15I4ZWXN,1000,1850
N3030,3,5/8/2023,RE881SM8ZE,1000,850
N3030,3,5/9/2023,RE914DVVCZ,650,200
N3030,3,5/9/2023,RE9959TN6R,200,0
N3030,4,5/17/2023,REH3R6Z5DR,500,6300
N3030,4,5/18/2023,REI1VFX273,500,5800
N3030,4,5/23/2023,REN087U3KC,100,5700
N3030,4,5/23/2023,REN5A89DPP,350,5350
N3030,4,5/27/2023,RER6ITZP3G,1000,4350
N3030,4,6/2/2023,RF25158L0P,500,3850
N3030,4,6/3/2023,RF346GOHF6,600,3250
N3030,4,6/4/2023,RF418RT4DP,300,2950
N3030,4,6/5/2023,RF54BZE0SG,500,2450
N3030,4,6/7/2023,RF78GPWC4Y,300,2150
N3030,4,6/9/2023,RF97LAL7PN,500,1650
N3030,4,6/10/2023,RFA0R3P9E2,500,1150
N3030,4,6/12/2023,RFC4WH3N8Q,1150,0
N3030,5,7/10/2023 23:19,RGA58J42QL,400,4800
N3030,5,7/10/2023 14:14,RGA66U4Q5U,100,4700
N3030,5,7/10/2023 14:12,RGA86TZQWU,100,4600
N3030,5,7/10/2023 14:11,RGA36TT1UX,100,4500
N3030,5,7/8/2023 23:43,RG842WPGIG,100,4400
N3030,5,7/8/2023 23:41,RG832WN9IJ,100,4300
N3030,5,7/8/2023 23:38,RG872WKD9L,100,4200
N3030,5,7/8/2023 23:36,RG822WIB0E,100,4100
N3030,5,7/8/2023 23:34,RG852WG8XJ,100,4000
N3030,5,7/8/2023 23:32,RG832WE573,100,3900
N3030,5,7/6/2023 17:05,RG61UQTLOL,100,3800
N3030,5,7/6/2023 17:01,RG61UQFLQX,100,3700
N3030,5,7/6/2023 16:56,RG67UPU71J,100,3600
N3030,5,7/6/2023 16:44,RG62UOGKJS,100,3500
N3030,5,7/6/2023 16:43,RG66UO9NX2,100,3400
N3030,5,7/6/2023 10:47,RG68TO28J6,600,2800
N3030,5,7/4/2023 22:56,RG46PY77E4,800,2000
N3030,5,7/4/2023 10:39,RG46NMZ8O4,500,1500
N3030,5,7/3/2023 12:05,RG37KTXEAB,100,1400
N3030,5,7/3/2023 12:03,RG33KTTAAF,100,1300
N3030,5,7/3/2023 12:02,RG36KTO1QQ,100,1200
N3030,5,7/3/2023 11:58,RG37KTB1N3,100,1100
N3030,5,7/3/2023 11:57,RG31KT667D,100,1000
N3030,5,6/25/2023 20:33:18,RFP7Y5MQ3H,550,450
N3030,5,7/12/2023,RGC0CJHLMY,200,250
N3030,5,7/12/2023,RGC7DE76S9,250,0
N3030,6,8/1/2023,RH19153XWZ,1000,4200
N3030,6,8/2/2023,RH2942E7TX,1000,3200
N3030,6,8/5/2023,RH50DBE4NA,2000,1200
N3031,1,2/14/2023,RBE9OE3B1L,260,7060
N3031,1,2/15/2023,RBF4R133NC,260,6800
N3031,1,2/16/2023,RBG4TNURM8,260,6540
N3031,1,2/17/2023,RBH9W735GB,260,6280
N3031,1,2/18/2023,RBI2YX32IC,260,6020
N3031,1,2/20/2023,RBK24W2L08,260,5760
N3031,1,2/21/2023,RBL17FG7ZB,260,5500
N3031,1,2/22/2023,RBM99ZTO7Z,260,5240
N3031,1,2/23/2023,RBN0CKEAR2,260,4980
N3031,1,2/24/2023,RBO3F96AWV,260,4720
N3031,1,2/26/2023,RBQ0KEUTGQ,260,4460
N3031,1,2/27/2023,RBS8N23ICU,260,4200
N3031,1,3/1/2023,RC18SHR7K4,360,3840
N3031,1,3/3/2023,RC38V9CUYW,360,3480
N3031,1,3/3/2023,RC36Y3YISO,360,3120
N3031,1,3/6/2023,RC6357T2YL,3120,0
N3031,2,3/8/2023,RC81CR4X2X,260,7540
N3031,2,3/17/2023,RCH422VSXS,600,6940
N3031,2,3/18/2023,RCI14VA28V,360,6580
N3031,2,3/19/2023,RCJ57CDMHT,150,6430
N3031,2,3/22/2023,RCM9CXLEDB,360,6070
N3031,2,3/24/2023,RCO3KGKL3N,150,5920
N3031,2,3/25/2023,RCP3N2YM0R,360,5560
N3031,2,3/27/2023,RCR6RYY5II,400,5160
N3031,2,4/4/2023,RD46DLQM9A,4000,1160
N3031,2,4/4/2023,RD49DMBCZL,1060,100
N3031,2,4/4/2023,RD45DMNQW9,100,0
N3032,1,2/16/2023,RBG2TLLHAE,214,6236
N3032,1,2/16/2023,RBG9TLPZW7,3,6233
N3032,1,2/17/2023,RBH3W9NVIF,217,6016
N3032,1,2/19/2023,RBJ011J19Y,217,5799
N3032,1,2/22/2023,RBM17HG8M1,217,5582
N3032,1,2/26/2023,RBQ3IRCZLF,522,5060
N3032,1,3/1/2023,RC11PX7WTF,1000,4060
N3032,1,3/4/2023,RC491RZFV5,500,3560
N3032,1,3/7/2023,RC799P7GTD,217,3343
N3032,1,3/8/2023,RC89CR618F,217,3126
N3032,1,3/9/2023,RC98FKP576,217,2909
N3032,1,3/10/2023,RCA5ID5GO9,217,2692
N3032,1,3/13/2023,RCE3RNZGU7,2650,42
N3032,1,3/13/2023,RCE5RONX85,42,0
N3032,2,4/5/2023,RD57HTR2MP,220,6580
N3032,2,4/14/2023,RDE45ZKOJQ,2000,4580
N3032,2,4/16/2023,RDG0C04YQE,220,4360
N3032,2,4/25/2023,RDP8YIXWFG,495,3865
N3032,2,4/26/2023,RDQ63DHB4I,400,3465
N3032,2,4/28/2023,RDS47Z6M1I,400,3065
N3032,2,5/1/2023,RE13FYZIVF,700,2365
N3032,2,5/5/2023,RE59R9A0PD,210,2155
N3032,2,5/9/2023,RE9642JMZO,400,1755
N3032,2,5/10/2023,REA36ZALYH,1755,0
N3032,3,5/24/2023,REO3BVVTAV,1000,6900
N3032,3,5/25/2023,REP1DPUV11,400,6500
N3032,3,6/13/2023,RFD6XZLWTQ,1000,5500
N3032,3,6/28/2023,RFS16IK10B,500,5000
N3032,3,6/28/2023,RFS46UE80Q,300,4700
N3032,3,6/29/2023,RFT19QPM6N,300,4400
N3032,3,7/5/2023,RG59QRQ05Z,500,3900
N3032,3,7/8/2023,RG87ZBQWMV,1000,2900
N3032,3,7/9/2023,RG965D9OSM,1100,1800
N3032,3,7/13/2023,RGD2ERP5BA,750,1050
N3032,3,7/17/2023,RGH0Q4VN38,200,850
N3032,3,7/21/2023,RGL54EFNN1,200,650
N3032,3,7/23/2023,RGN2A1A4C0,250,400
N3032,3,7/28/2023,RGS7O85XI9,200,200
N3032,3,8/9/2023,RH92OY4A14,200,0
N3033,1,2/24/2023,RBO2EEXEZ2,1625,5175
N3033,1,3/8/2023,RC84CMTJW0,600,4575
N3033,1,3/18/2023,RCI53AMLJ5,4575,0
N3033,2,4/22/2023,RDM0QXRSLA,1000,5800
N3033,2,4/24/2023,RDO9Y8U8U9,800,5000
N3033,2,5/11/2023,REB3AUTJKF,500,4500
N3033,2,5/16/2023,REG4NFFHV8,300,4200
N3033,2,5/31/2023,REV3VHIPUH,500,3700
N3033,2,6/1/2023,RF10ZBKAIG,500,3200
N3033,2,6/5/2023,RF59B6J9AJ,1000,2200
N3033,2,6/7/2023,RF72G9JEQI,500,1700
N3033,2,6/13/2023,RFD2XN3DCS,1000,700
N3033,2,6/23/2023,RFN0RLXK0E,700,0
N3034,1,3/27/2023,RCR3QIIECF,1000,5800
N3034,1,4/1/2023,RD175H6P77,1000,4800
N3035,1,3/13/2023,RCD3Q3IQ6T,1500,13100
N3035,1,3/29/2023,RCT0WH5EDO,11500,1600
N3036,1,2/24/2023,RBO4DPHW20,1625,4325
N3036,1,3/6/2023,RC685760VY,4325,0
N3037,1,3/9/2023,RC99E0AOMD,5750,50
N3037,1,3/9/2023,RC99E110OJ,50,0
N3037,2,3/22/2023,RCM8DY58TE,5750,0
N3037,3,4/21/2023,RDL6PDEE28,6500,300
N3037,4,5/12/2023,REC6DMNWJM,500,6000
N3037,4,5/19/2023,REI0VC69G6,6300,-300
N3038,1,3/8/2023,RC92D5QRLK,975,3105
N3039,1,3/3/2023,RC37X1ZEWR,217,5383
N3039,1,3/4/2023,RC4911WAKF,217,5166
N3039,1,3/5/2023,RC574A0VQB,217,4949
N3039,1,3/6/2023,RC636MUOGZ,217,4732
N3039,1,3/8/2023,RC89CCK181,217,4515
N3039,1,3/10/2023,RCA9HEX2V7,217,4298
N3039,1,3/11/2023,RCB6K9USFO,4260,38
N3039,1,3/13/2023,RCD0PJ3V9S,38,0
N3039,2,3/27/2023,RCR5RHNIZF,1625,5175
N3040,1,4/8/2023,RD81O4FKTJ,1000,13600
N3040,1,4/11/2023,RDA8VEF7HO,450,13150
N3040,1,4/12/2023,RDC7ZPGDVR,650,12500
N3040,1,4/14/2023,RDE65SJDVU,450,12050
N3040,1,5/13/2023,RED8F4W8DQ,1000,11050
N3041,1,3/17/2023,RCH6ZJTWGU,1625,4875
N3041,1,3/24/2023,RCO1K19ROF,1625,3250
N3041,1,3/31/2023,RCV43F39S6,1625,1625
N3041,1,4/7/2023,RD73N787MV,1625,0
N3042,1,3/18/2023,RCI64WFTNI,1300,4140
N3042,1,4/12/2023,RDC4ZPRBV0,500,3640
N3042,1,4/15/2023,RDF293V6RQ,500,3140
N3042,1,4/20/2023,RDK0M61FRO,400,2740
N3042,1,4/21/2023,RDL5QF3YY3,200,2540
N3042,1,5/15/2023,REC0DLJPF2,200,2340
N3043,1,3/21/2023,RCL4ALSNUC,1500,3700
N3043,1,3/28/2023,RCS8TGS4F6,1300,2400
N3043,1,4/4/2023,RD46EMQ54A,1400,1000
N3043,1,4/11/2023,RDB0XQXAEO,1000,0
N3044,1,3/22/2023,RCM1ER3ARZ,900,5600
N3044,1,3/27/2023,RCR1Q1G11B,500,5100
N3044,1,4/2/2023,RD278VJMFR,800,4300
N3044,1,4/7/2023,RD70NAB06K,1000,3300
N3044,1,4/12/2023,RDC5ZS98X3,3300,0
N3044,2,5/7/2023,RE70XZH98I,100,7200
N3044,2,5/7/2023,RE71Y4KCKL,900,6300
N3044,2,5/12/2023,REC2DGZW6U,1500,4800
N3044,2,5/19/2023,REJ5WUBJS5,4800,0
N3045,1,3/21/2023,RCL0CL3ZKY,170,6180
N3045,1,3/23/2023,RCN5HS9JWP,217,5963
N3045,1,3/25/2023,RCP2N4ZA8W,217,5746
N3045,1,3/28/2023,RCS2S3PWWM,220,5526
N3045,1,4/7/2023,RD77NMDWPR,300,5226
N3045,1,4/9/2023,RD91SSE32L,230,4996
N3045,1,4/14/2023,,4000,996
N3045,1,4/14/2023,,500,496
N3045,1,4/14/2023,,496,0
N3046,1,3/25/2023,RCP1N5HT2Z,300,5600
N3046,1,3/26/2023,RCQ3PH30VH,300,5300
N3046,1,3/28/2023,RCS6UQCHHO,300,5000
N3046,1,3/31/2023,RCV13S6PX1,300,4700
N3046,1,4/1/2023,RD116UGXL5,300,4400
N3046,1,4/2/2023,RD249GLEF4,300,4100
N3046,1,4/4/2023,RD43F09X5B,300,3800
N3046,1,4/5/2023,RD58HVLITW,300,3500
N3046,1,4/7/2023,RD70LQR81W,3500,0
N3047,1,4/4/2023,RD46CD2E8C,3250,10350
N3047,1,4/21/2023,RDL9O4B9I3,1500,8850
N3047,1,5/5/2023,RE51RCIJAF,8250,600
N3048,1,4/7/2023,RD77MZNLFB,1625,5175
N3048,1,4/20/2023,RDK9NNDH1R,1625,3550
N3048,1,4/27/2023,RDR35TJ24J,3250,300
N3049,1,4/5/2023,RD56FV6SF6,1800,4000
N3049,1,4/12/2023,RDC3ZIXXC7,3950,50
N3049,1,4/12/2023,RDC5ZK5HFX,50,0
N3049,2,4/19/2023,RDJ6JLUC3Q,1625,4875
N3049,2,4/26/2023,RDQ23JGACW,1625,3250
N3049,2,5/3/2023,RE32MQBCI8,1625,1625
N3049,2,5/10/2023,REA1872GSF,1625,0
N3049,1,7/22/2023,RGM56JM0WL,1820,4080
N3049,1,7/29/2023,RGT6QJ4OPS,1820,2260
N3049,1,7/31/2023,RGV4VPRX8A,2260,0
N3050,1,4/29/2023,RDT0BD005G,13600,0
N3051,1,4/15/2023,RDF08BR8JC,3250,10350
N3051,1,5/7/2023,RE68UPWVIC,10350,0
N3051,2,5/31/2023,REV4V0H2AY,200,10200
N3051,2,6/3/2023,RF354GPEXN,10200,0
N3052,1,4/20/2023,RDK7NBWUN3,11500,0
N3052,2,5/24/2023,REO1C9NMZ5,6150,0
N3052,3,6/24/2023,RFO2TVJPYO,6500,0
N3052,4,7/24/2023,RGO5B9TLU5,9520,0
N3053,1,5/6/2023,RE66TZEC10,200,6600
N3053,1,5/13/2023,RED0FKHRYC,1600,5000
N3053,1,5/15/2023,REF6LERFTA,760,4240
N3054,1,5/15/2023,REF2KJGJOO,500,6000
N3055,1,5/18/2023,REI1VAUNY3,1520,5280
N3055,1,5/10/2023,REA88V1YQS,1520,3760
N3055,1,5/31/2023,REV9TZNWOL,1500,2260
N3055,1,6/1/2023,RF14WMYHQI,1000,1260
N3055,1,6/3/2023,RF353K9GYX,1000,260
N3056,1,5/12/2023,REC5E5SAL7,1000,5800
N3056,1,5/14/2023,REE9IGTP6F,630,5170
N3056,1,5/26/2023,REQ1IFDIM5,1600,3570
N3056,1,6/2/2023,RF24ZOTJES,2000,1570
N3056,1,6/4/2023,RF436Y24MF,1580,-10
N3056,2,7/12/2023,RGC3E3A3KX,2800,4500
N3056,2,7/18/2023,RGI4USBRJY,700,3800
N3056,2,7/24/2023,RG03APFFVH,3800,0