Application ID,Loan No.,Repaid Date,Mpesa Code,Amount,Balance
W2001,1,10/15/2021,PJF6AEVGYG,412,11938
W2001,1,10/17/2021,PJH1D77H4D,412,11526
W2001,1,10/17/2021,PJH3E1IBJP,400,11126
W2001,1,10/18/2021,PJI8FJLO40,412,10714
W2001,1,10/18/2021,PJI7FJS8TN,12,10702
W2001,1,10/20/2021,PJK5IN1UJ9,750,9952
W2001,1,10/21/2021,PJL5K4FDP3,412,9540
W2001,1,10/21/2021,PJL0K4NQD4,74,9466
W2001,1,10/24/20231,PJO5OT5JN5,650,8816
W2001,1,10/24/20231,PJO6OT996E,30,8786
W2001,1,11/5/2021,PK518TP2IT,3000,5786
W2001,1,11/10/2021,PKA9GMZWKT,4500,1286
W2001,1,11/12/2021,PKC6KNJPS6,1286,0
W2001,2,12/28/2021,PLS2SS4M9G,12160,0
W2001,3,2/15/2022,QBF68HIMG0,1150,11200
W2001,3,2/15/2022,QBF18ILOV9,11000,200
W2001,3,2/16/2022,QBG898GYI8,200,0
W2001,4,4/12/2022,QDC6965C9A,1400,17450
W2002,1,11/13/2021,PKD3MIHCZT,10500,3100
W2002,1,11/15/2021,PKF4OH0IN2,3100,0
W2002,2,12/14/2021,PLE546TOMP,13000,0
W2003,1,10/27/2021,PJR8S1FFMW,1900,9300
W2003,1,10/28/2021,PJS8UPIP5A,9300,0
W2003,2,12/16/2021,PLG98XE6ZX,12000,200
W2004,1,10/27/2021,PJR6TK2I1G,950,9450
W2004,1,10/28/2021,PJS1UHOOWT,1000,8450
W2004,1,10/28/2021,PJS0V6RUG0,100,8350
W2004,1,10/29/2021,PJT7V8VN0J,600,7750
W2004,1,11/2/2021,PK244JCI5Q,200,7550
W2004,1,11/3/2021,PK3767KQB7,1050,6500
W2004,1,11/4/2021,PK477UDF0R,1000,5500
W2004,1,11/4/2021,PK447UFRZ0,15,5485
W2004,1,11/5/2021,PK5081SM2O,100,5385
W2004,1,11/5/2021,PK588FOWMW,100,5285
W2004,1,11/5/2021,PK579K005D,80,5205
W2004,1,11/10/2021,PKA7HNY0QH,400,4805
W2004,1,11/11/2021,PKB1ICM3CT,100,4705
W2004,1,11/11/2021,PKB0ICO12S,100,4605
W2004,1,11/11/2021,PKB8IMPJUY,500,4105
W2004,1,11/11/2021,PKB6J6XDZK,500,3605
W2004,1,11/12/2021,PKC2JFK9GI,100,3505
W2004,1,11/12/2021,PKC5JFLH4T,100,3405
W2004,1,11/12/2021,PKC0JFNOQI,100,3305
W2004,1,11/12/2021,PKC2JPXK7S,100,3205
W2004,1,11/12/2021,PKC9JREFO5,100,3105
W2004,1,11/12/2021,PKC0K28E9W,100,3005
W2004,1,11/12/2021,PKC8K2B06O,100,2905
W2004,1,11/14/2021,PKE2N9QU4K,100,2805
W2004,1,11/16/2021,PKG0PY5ELQ,100,2705
W2004,1,11/16/2021,PKG9PY80C5,100,2605
W2004,1,11/17/2021,PKH0RO8AJW,100,2505
W2004,1,11/17/2021,PKH9RRJT9N,100,2405
W2004,1,11/17/2021,PKH8RRP9AU,100,2305
W2004,1,11/17/2021,PKH3RS4LRV,100,2205
W2004,1,11/17/2021,PKH5SPMANH,500,1705
W2004,1,11/18/2021,PKI8T0FP36,500,1205
W2004,1,11/18/2021,PKI0THEW6C,100,1105
W2004,1,11/18/2021,PKI4THW9W0,80,1025
W2004,1,11/18/2021,PKI0TKXBMA,100,925
W2004,1,11/18/2021,PKI9U1I4MJ,100,825
W2004,1,11/18/2021,PKI1U2B3VJ,70,755
W2004,1,11/18/2021,PKI7UD00BX,750,5
W2004,1,11/18/2021,PKI0UD2FEG,30,25
W2004,2,11/24/2021,PKO05MSNSE,100,10300
W2004,2,11/24/2021,PKO15MTG5T,100,10200
W2004,2,11/25/2021,PKP160NDIV,100,10100
W2004,2,11/25/2021,PKP078NGX8,600,9500
W2004,2,11/26/2021,PKQ87RFF5O,500,9000
W2004,2,11/26/2021,PKR599UQFV,100,8900
W2004,2,11/28/2021,PKS4BCHPPY,100,8800
W2004,2,11/28/2021,PKS4BOQURG,100,8700
W2004,2,12/1/2021,PL17FYW7DL,100,8600
W2004,2,12/1/2021,PL18FYZKJU,100,8500
W2004,2,12/3/2021,PL34JIJ37S,100,8400
W2004,2,12/3/2021,PL39JJ1I4N,100,8300
W2004,2,12/4/2021,PL49MT2H8B,100,8200
W2004,2,12/4/2021,PL57N2IONR,100,8100
W2004,2,12/4/2021,PL64QBO67K,300,7800
W2004,2,12/8/2021,PL86SR0PXI,100,7700
W2004,2,12/9/2021,PL91UHVGHZ,250,7450
W2004,2,12/8/2021,PL85T51LYZ,100,7350
W2004,2,12/8/2021,PL82T56J4E,100,7250
W2004,2,12/10/2021,PLA8VWWAT4,100,7150
W2004,2,12/10/2021,PLA4VY8DO4,100,7050
W2004,2,12/12/2021,PLC8217Z6W,300,6750
W2004,2,12/14/2021,PLE158MBG9,1000,5750
W2004,2,12/15/2021,PLF67688O8,800,4950
W2004,2,12/17/2021,PLH59KH8B5,500,4450
W2004,2,12/17/2021,PLH69RZGJU,3700,750
W2004,2,12/17/2021,PLH19SCIL3,800,50
W2004,3,12/17/2021,PLH19SCIL32,50,10350
W2004,3,1/11/2022,QAB7H7MDRL,900,9450
W2004,3,1/13/2022,QAD0KIEYOA,400,9050
W2004,3,1/14/2022,QAE5LBTDKV,690,8360
W2004,3,1/14/2022,QAE7LD2EED,100,8260
W2004,3,1/14/2022,QAE3LE6T2B,100,8160
W2004,3,1/14/2022,QAE5LGAA3F,8160,0
W2004,4,2/3/2022,QB31LNJZLH,200,10200
W2004,4,2/10/2022,QBA0YGAZXC,500,9700
W2004,4,2/10/2022,QBA1XT4CWV,500,9200
W2004,4,2/11/2022,QBB6ZBTNVW,600,8600
W2004,4,2/11/2023,QBB7ZIYFA5,8200,400
W2004,4,2/11/2023,QBB3ZK3ZEV,400,0
W2004,5,3/15/2022,QCF0Q55SHO,10400,480
W2004,5,3/15/2022,QCF9Q6M5KF,480,0
W2004,6,4/8/2022,QD8321W1EX,250,10150
W2004,6,4/12/2022,QDC29F382U,10150,0
W2004,7,5/10/2022,QEA7R0QNXX,7000,3400
W2004,7,5/10/2022,QEA3R5UUJH,3400,0
W2004,8,6/6/2022,QF63A2AA6F,1000,12000
W2004,8,6/6/2022,QF67A2PXVV,2000,10000
W2004,8,6/7/2022,QF74BDAV8G,730,9270
W2004,8,6/7/2022,QF70BQ8CCQ,1350,7920
W2004,8,6/7/2022,QF73CN2L3R,7920,0
W2004,9,7/2/2022,QG21PUERS7,3500,9500
W2004,9,7/3/2022,QG36TDRIE0,2500,7000
W2004,9,7/4/2022,QG48UQQHBI,300,6700
W2004,9,7/4/2022,QG47UR3MIH,2800,3900
W2004,9,7/4/2022,QG42US895W,3900,0
W2004,10,7/28/2022,QGS69M1DEC,100,12700
W2004,10,7/28/2022,QGS79M3XXH,1400,11300
W2004,10,7/30/2022,QGU8BXGARQ,2000,9300
W2004,10,7/30/2022,QGU2CQP87E,9300,0
W2004,11,8/19/2022,QHJ6GMNG18,500,12400
W2004,11,8/23/2022,QHN5NMUADR,350,12050
W2004,11,8/23/2022,QHN1NPR1H3,100,11950
W2004,11,8/26/2022,QHQ4U4JMA4,7950,4000
W2004,11,8/26/2022,QHQ3TPMHOV,4000,0
W2004,12,9/20/2022,QIK7D1KE5J,500,13100
W2004,12,9/22/2022,QIM5HBNWBB,600,12500
W2004,12,9/24/2022,QIO8KGEB98,6700,5800
W2004,12,9/26/2022,QIQ9OLO4P,5650,150
W2004,12,9/26/2022,QIQ9OPNC2N,150,0
W2004,13,10/25/2022,QJP4KWN0ZO,7000,6600
W2004,13,10/26/2022,QJQ9M8ZWFR,1000,5600
W2004,13,10/26/2022,QJQ5MGXJ1J,100,5500
W2004,13,10/27/2022,QJR5OAQ0UP,600,4900
W2004,13,10/27/2022,QJR3PC5CS1,4900,0
W2004,14,11/16/2022,QKG61BZU68,200,12800
W2004,14,11/17/2022,QKH942XNCZ,100,12700
W2004,14,11/17/2022,QKH4437QIQ,100,12600
W2004,14,11/19/2022,QKJ288JSPO,100,12500
W2004,14,11/19/2022,QKJ089UQG6,100,12400
W2004,14,11/22/2022,QKM5F2DSEN,480,11920
W2004,14,11/24/2022,QKO6JM1QAI,6350,5570
W2004,14,11/24/2022,QKO1KPZF1P,4670,900
W2004,14,11/24/2022,QKO3K4ZBAN,400,500
W2004,14,11/24/2022,QKO1K2YM99,500,0
W2004,15,12/21/2022,QLL2NX04X4,500,12400
W2004,15,12/21/2022,QLL8O4A622,9800,2600
W2004,15,12/21/2022,QLL4O577RO,100,2500
W2004,15,12/21/2022,QLL7OBPZQL,2500,0
W2004,16,1/30/2023,RAU0IHAV4K,420,14180
W2004,16,2/1/2023,RB16P1UG2C,400,13780
W2004,16,2/3/2023,RB32S1DAS2,250,13530
W2004,16,2/8/2023,RB847A4W10,400,13130
W2004,16,2/10/2023,RBA9BY5TK5,100,13030
W2004,16,2/10/2023,RBA5BYJEPH,100,12930
W2004,16,2/15/2023,RBF7POPORR,100,12830
W2004,16,2/28/2023,RBS1OBFAO7,300,12530
W2004,16,3/22/2023,RCM9DSSRFN,200,12330
W2004,16,6/6/2023,RF68DL6OCW,100,12230
W2004,16,6/24/2023,RFO4UCYXXW,100,12130
W2004,16,6/26/2023,RFQ62AVG4I,300,11830
W2004,16,7/1/2023,RG14F0ZG6C,270,11560
W2004,16,7/4/2023,RG41OV2SGZ,150,11410
W2005,1,10/22/2021,PJM2L0YRAK,282,8168
W2005,1,10/25/2021,PJP0P1P7CU,600,7568
W2005,1,10/28/2021,PJS0TW39RA,980,6588
W2005,1,11/4/2021,PK456IY9RV,2200,4388
W2005,1,11/12/2021,PKC3K66BLJ,1150,3238
W2005,1,11/17/2021,PKH8RG5NH0,740,2498
W2005,1,11/17/2021,PKH7SO9XIP,2550,52
W2005,2,11/26/2021,PKQ87D0XSW,100,8350
W2005,2,11/26/2021,PKQ67D1R1W,1050,7300
W2005,2,12/1/2021,PL12G77WD2,780,6520
W2005,2,12/6/2021,PL63ONFWP9,800,5720
W2005,2,12/8/2021,PL87SFE8S9,1350,4370
W2005,2,12/14/2021,PLE73SDVST,750,3620
W2005,2,12/16/2021,PLG189MX8B,3620,0
W2005,3,1/12/2022,QAC8HISC2G,3000,5450
W2005,3,1/13/2022,QAD7JDP8GL,2400,3050
W2005,3,1/14/2022,QAE2KU7XYS,1550,1500
W2005,3,1/14/2022,QAE6L6UWXY,1500,0
W2005,4,2/8/2022,QB87T4CWN7,1900,8500
W2005,4,2/9/2022,QB94UZ29QW,2000,6500
W2005,4,2/10/2022,QBA7X0I4M5,1300,5200
W2005,4,2/11/2022,QBB0YW3GJ6,4000,1200
W2005,4,2/11/2022,QBB8Z76ATG,1200,0
W2005,5,3/10/2022,QCA2G8LCOG,50,10350
W2005,5,3/10/2022,QCA6G8N8J2,1100,9250
W2005,5,3/10/2022,QCA0HB12O0,7900,1350
W2005,5,3/11/2022,QCB3HYVSLH,1350,0
W2005,6,4/5/2022,QD57V0WM9X,100,10300
W2005,6,4/6/2022,QD69W96C73,100,10200
W2005,6,4/6/2022,QD62W987QK,10300,100
W2005,7,5/2/2022,QE28B4MLCI,500,11180
W2005,7,5/6/2022,QE69IRF1KX,500,10680
W2005,7,5/7/2022,QE70LFTPFK,500,10180
W2005,7,5/9/2022,QE95ONY8I3,500,9680
W2005,7,5/9/2022,QE95PDH3NJ,500,9180
W2005,7,5/10/2022,QEA9RGLNB1,500,8680
W2005,7,5/13/2022,QED5WMY1HT,500,8180
W2005,7,5/14/2022,QEE3YZIRVD,500,7680
W2005,7,5/18/2022,QEI578GBX5,1000,6680
W2005,7,5/18/2022,QEI17LOTHN,700,5980
W2005,7,6/7/2022,QF71CA7RNR,500,5480
W2006,1,10/29/2021,PJT1V8GD7L,2400,10928
W2006,1,10/29/2021,PJT7V8P9EF,800,10128
W2006,1,11/1/2021,PK102NJZZG,500,9628
W2006,1,11/4/2021,PK407EPIAG,1600,8028
W2006,1,11/9/2021,PK97EW5SFX,2300,5728
W2006,1,11/11/2021,PKB2IXBFCS,690,5038
W2006,1,11/18/2021,PKI8U9TNRA,1550,3488
W2006,1,11/19/2021,PKJ5W4M8M7,3300,188
W2006,1,11/20/2021,PKK8WABM1C,188,0
W2006,2,12/1/2021,PL10GX7MRU,400,15400
W2006,2,12/5/2021,PL58NTXLY8,1050,14350
W2006,2,12/7/2021,PL73RGVWA7,1500,12850
W2006,2,12/8/2021,PL81TBH3CT,445,12405
W2006,2,12/11/2021,PLB3YUFFZJ,2820,9585
W2006,2,1/25/2022,QAP84Z5TNC,3000,6585
W2006,2,2/13/2023,RBE4LVD3JW,100,6485
W2006,2,2/15/2023,RBF4QV75IC,100,6385
W2006,2,2/26/2023,RBQ9K6387P,100,6285
W2006,2,2/27/2023,RBR2N0WNT0,100,6185
W2006,2,2/28/2023,RC17PT5EGD,100,6085
W2007,1,10/28/2021,PJS4V3B8YM,60,7620
W2007,1,10/29/2021,PJT4WRKU4G,60,7560
W2007,1,10/30/2021,PJU5Y95CEL,60,7500
W2007,1,11/1/2021,PK112RPCOB,60,7440
W2007,1,11/3/2021,PK325VAGCI,1000,6440
W2007,1,10/31/2021,PJV6154FZG,60,6380
W2007,1,11/5/2021,PK56821AF0,300,6080
W2007,1,11/8/2021,PK87E1G457,500,5580
W2007,1,11/10/2021,PKA9HJ63IL,1500,4080
W2007,1,11/11/2021,PKB5IC2FMV,300,3780
W2007,1,11/17/2021,PKH6S6O8EQ,500,3280
W2007,1,11/18/2021,PKI7U1MF81,1000,2280
W2007,1,11/19/2021,PKJ1VKGPNB,200,2080
W2007,1,11/22/2021,PKM2ZQ4SOA,2080,0
W2007,2,11/29/2021,PKT8DPED3A,950,6850
W2007,2,12/1/2021,PL15HDNQCT,950,5900
W2007,2,12/2/2021,PL26IM3F6C,50,5850
W2007,2,12/8/2021,PL82T5TLLC,550,5300
W2007,2,12/13/2021,PLD13E07QV,1400,3900
W2007,2,12/16/2021,PLG17BBXG3,1550,2350
W2007,2,12/20/2021,PLK2EB0L74,2350,0
W2007,3,12/21/2021,PLL6GORQ6M,160,7220
W2007,3,12/28/2021,PLS9T8818P,1040,6180
W2007,3,1/10/2022,QAA7E7NO3L,6180,0
W2007,4,1/18/2022,QAI3SCSP0F,500,7300
W2007,4,2/4/2022,QB43M98W2F,7300,0
W2007,5,2/23/2022,QBN9M1ONX1,1500,6300
W2007,5,3/3/2022,QC3422KU0A,6300,0
W2007,6,3/16/2022,QCG2SOADW0,3000,7400
W2007,6,3/27/2022,QCR1DPWNYT,3200,4200
W2007,6,3/30/2022,QCU4IPTSWM,4200,0
W2007,7,4/26/2022,QDQ1ZKWBMB,4000,6400
W2007,7,4/27/2022,QDR23FUA7W,6400,0
W2007,8,5/24/2022,QEO9IXARQ5,10320,0
W2007,9,6/16/2022,QFG0TZF1FU,9220,780
W2007,9,6/16/2022,QFG5U5UHAD,780,0
W2007,10,7/14/2022,QGE2GTDAX6,13000,0
W2007,11,8/11/2022,QHB32D8ULJ,480,15320
W2007,11,8/16/2022,QHG9A3U457,520,14800
W2007,11,8/22/2022,QHM8LRWQNE,520,14280
W2007,11,9/20/2022,QIK5BWX36P,100,14180
W2007,11,9/20/2022,QIK6BX0E76,100,14080
W2007,11,9/20/2022,QIK3BX3DD5,100,13980
W2007,11,12/15/2022,QLF47VSN50,250,13730
W2008,1,11/4/2021,PK477DBR5J,1710,1710
W2008,1,11/10/2021,PKA6H6TLAI,1710,0
W2008,2,11/23/2021,PKN03JUJPY,975,2925
W2008,2,11/29/2021,PKT3CUL9JR,975,1950
W2008,2,12/7/2021,PL75RVAPHZ,975,975
W2008,2,12/13/2021,PLD32AJ1DD,975,0
W2008,3,1/11/2022,QAB9H5QARJ,975,3105
W2008,3,1/19/2022,QAJ7UB3MS3,975,2130
W2008,3,1/26/2022,QAQ475CMIA,975,1155
W2008,3,2/2/2022,QB20JTR8Z2,975,180
W2008,3,2/12/2022,QBC11SO92R,180,0
W2008,4,2/19/2022,QBJ4F29LD4,975,2925
W2008,4,2/26/2022,QBQ1R9E0FL,975,1950
W2008,4,3/6/2022,QC628L89HE,975,975
W2008,4,3/12/2022,QCC4L6BU0G,975,0
W2008,5,3/31/2022,QCV0KFK4QU,650,1950
W2008,5,4/7/2022,QD79ZG6CSR,650,1300
W2008,5,4/14/2022,QDE5D3L1E3,650,650
W2008,5,4/16/2022,QDG2GX94XM,650,0
W2008,6,4/26/2022,QDQ51635NH,975,2925
W2008,6,5/17/2022,QEH95K75B1,2925,0
W2008,7,5/23/2022,QEN5HLPL97,975,2925
W2008,7,6/6/2022,QF63AGTI2D,975,1950
W2008,7,6/13/2022,QFD5NYVCYB,1950,0
W2008,8,6/24/2022,QFO29ZZS4Q,975,2925
W2008,8,7/5/2022,QG59XKDRSD,975,1950
W2008,8,7/13/2022,QGD3F43MBD,1950,0
W2008,9,9/30/2022,QIU2XUDGKK,975,3105
W2009,1,11/6/2021,PK68AVSFXQ,500,3445
W2009,1,11/12/2021,PKC3K0L453,430,3015
W2009,1,11/12/2021,PKC7K0O8EB,45,2970
W2009,1,11/24/2021,PKO344F5PP,900,2070
W2009,1,11/25/2021,PKP36A5AHP,700,1370
W2009,1,11/29/2021,PKT3CGCIUZ,400,970
W2009,1,12/1/2021,PL19G7HY9V,200,770
W2009,1,12/4/2021,PL47LFAT9X,100,670
W2009,1,12/6/2021,PL60P2CUSI,600,70
W2009,1,12/6/2021,PL60P2JOO6,30,40
W2009,1,12/6/2021,PL67PERBR3,40,0
W2010,1,11/30/2021,PKU9EMPDEV,12800,0
W2010,2,12/21/2021,PLL0GE3USE,9760,0
W2010,3,2/2/2022,QB29JA7BED,8000,5600
W2010,3,2/3/2022,QB35KMY1CB,5000,600
W2010,3,2/3/2022,QB39KVS2XP,600,0
W2010,4,3/2/2022,QC29YTRJ0F,19500,0
W2010,5,3/30/2022,QCU5I9RQHD,19500,0
W2010,6,4/25/2022,QDP1XZBSA9,18900,0
W2010,7,5/25/2022,QEP3KZ4OT,26000,0
W2010,8,6/22/2022,QFM766O2KT,25800,0
W2010,9,7/19/2022,QGJ3Q79ZOR,32500,0
W2010,10,8/11/2022,QHB72NEJ31,3000,31000
W2010,10,8/18/2022,QHI5F0JTHP,1000,30000
W2010,10,8/20/2022,QHK8HOXXY2,1000,29000
W2010,10,8/25/2022,QHP0SBCB1W,1000,28000
W2010,10,9/16/2022,QIF72BD44D,1000,27000
W2010,10,9/28/2022,QIS9SIOFJP,500,26500
W2010,10,11/18/2022,QKI0629YE0,1000,25500
W2010,10,11/24/2022,QKO7JW2329,200,25300
W2010,10,11/26/2022,QKQ0OYEO90,1000,24300
W2010,10,1/31/2023,RAV8KZTV12,500,23800
W2011,1,11/6/2021,PK63BALBHD,100,3800
W2011,1,11/6/2021,PK62BAO4CG,30,3770
W2011,1,11/7/2021,PK79C3QJWR,100,3670
W2011,1,11/7/2021,PK78C3TVJY,30,3640
W2011,1,11/8/2021,PK85EGGUGX,100,3540
W2011,1,11/8/2021,PK89EGJR8Z,30,3510
W2011,1,11/9/2021,PK97FX27HN,100,3410
W2011,1,11/9/2021,PK91FX77I1,30,3380
W2011,1,11/10/2021,PKA7HI7997,30,3350
W2011,1,11/10/2021,PKA3HIF61V,100,3250
W2011,1,11/11/2021,PKB3IT66F9,100,3150
W2011,1,11/11/2021,PKB2ITBNBK,30,3120
W2011,1,11/12/2021,PKC9KN3GBL,100,3020
W2011,1,11/12/2021,PKC8KNHNWS,30,2990
W2011,1,11/14/2021,PKE2NR1MHC,100,2890
W2011,1,11/14/2021,PKE3NR5GSJ,30,2860
W2011,1,11/13/2021,PKD8M3G7LY,100,2760
W2011,1,11/13/2021,PKD8M3LF7U,30,2730
W2011,1,11/15/2021,PKF5PBTQ09,100,2630
W2011,1,11/15/2021,PKF9PC0M0F,30,2600
W2011,1,11/16/2021,PKG0QR79JM,30,2570
W2011,1,11/16/2021,PKG1QRD8PH,100,2470
W2011,1,11/17/2021,PKH7SHF0BV,100,2370
W2011,1,11/17/2021,PKH3SHMCWR,30,2340
W2011,1,11/18/2021,PKI5U7I681,100,2240
W2011,1,11/18/2021,PKI9U7Q1Q9,30,2210
W2011,1,11/19/2021,PKJ6UZDJKO,100,2110
W2011,1,11/19/2021,PKJ2UZH5F0,30,2080
W2011,1,11/20/2021,PKK5XTKJ1N,100,1980
W2011,1,11/20/2021,PKK7XTQCT3,30,1950
W2011,1,11/21/2021,PKL2ZCIQVK,100,1850
W2011,1,11/21/2021,PKL9ZCL2S1,30,1820
W2011,1,11/22/2021,PKM31Y6DHH,100,1720
W2011,1,11/22/2021,PKM71YCYVF,30,1690
W2011,1,11/23/2021,PKN33UOEHP,100,1590
W2011,1,11/23/2021,PKN83USUHU,30,1560
W2011,1,11/24/2021,PKO35F0S4L,100,1460
W2011,1,11/24/2021,PKO05F4LAU,30,1430
W2011,1,11/25/2021,PKP177CQZJ,100,1330
W2011,1,11/25/2021,PKP877FDWY,30,1300
W2011,1,11/26/2021,PKQ58T61ID,100,1200
W2011,1,11/26/2021,PKQ38TAA0L,30,1170
W2011,1,11/27/2021,PKR6AJJQC0,100,1070
W2011,1,11/27/2021,PKR0AJPEHU,30,1040
W2011,1,11/29/2021,PKT9DI9GQH,100,940
W2011,1,11/29/2021,PKT3DIK15V,100,840
W2011,1,11/29/2021,PKT4DIP8SW,30,810
W2011,1,11/29/2021,PKT9DIXD25,30,780
W2011,1,11/30/2021,PKU4FGEZE0,100,680
W2011,1,11/30/2021,PKU1FGJM5J,30,650
W2011,1,12/1/2021,PL11H6ZWQ5,100,550
W2011,1,12/1/2021,PL18H77XK4,30,520
W2011,1,12/2/2021,PL29IZ4YAN,100,420
W2011,1,12/2/2021,PL21IZBA9N,30,390
W2011,1,12/3/2021,PL36JQDY2W,390,0
W2012,1,11/10/2021,PKA1G50PF5,1000,10700
W2012,1,11/12/2021,PKC7JJCK8T,2250,8450
W2012,1,11/18/2021,PKI5TWVETZ,1900,6550
W2012,1,11/18/2021,PKI8U9ISMG,500,6050
W2012,1,11/19/2021,PKJ8W6SYHQ,550,5500
W2012,1,11/20/2021,PKK9WKJ1AH,5500,0
W2012,2,11/28/2021,PKS7ARIQLF,650,15670
W2012,2,12/6/2021,PL61OWPPE1,1000,14670
W2012,2,12/8/2021,PL88SL5RS4,500,14170
W2012,2,12/17/2021,PLH7AI0HWF,5000,9170
W2012,2,12/20/2021,PLK4F6H9J8,9170,0
W2013,1,11/9/2021,PK91F3L3JP,434,7466
W2013,1,11/10/2021,PKA9GWFOF7,100,7366
W2013,1,11/10/2021,PKA7GWODGL,100,7266
W2013,1,11/10/2021,PKA2GWRERQ,17,7249
W2013,1,11/11/2021,PKB7ILPX5Z,217,7032
W2013,1,11/12/2021,PKC8K4S29U,100,6932
W2013,1,11/12/2021,PKC3K4WF4D,17,6915
W2013,1,11/12/2021,PKC8K4ZFPY,100,6815
W2013,1,11/19/2021,PKJ2UX1EYK,540,6275
W2014,1,11/17/2021,PKH0RZHZYC,2000,11600
W2014,1,11/19/2021,PKJ1V6UP63,1250,10350
W2014,1,11/23/2021,PKN335O5VF,1000,9350
W2014,1,11/26/2021,PKQ87J0RGE,700,8650
W2014,1,11/29/2021,PKT6CEE1N2,1500,7150
W2014,1,12/5/2021,PL55OIVAQ1,1500,5650
W2014,1,12/7/2021,PL72QHE2SU,1000,4650
W2014,1,12/7/2021,PL77QL6BN5,400,4250
W2014,1,12/8/2021,PL86SC63GG,1500,2750
W2014,1,12/10/2021,PLA1VZBC3T,1000,1750
W2014,1,12/13/2021,PLD52B8IFV,1600,150
W2014,1,12/13/2021,PLD52E4XW5,150,0
W2015,1,11/17/2021,PKH3R8AP4T,200,6600
W2015,1,11/15/2021,PKF3P193KP,1000,5600
W2015,1,11/18/2021,PKI8TKZX56,400,5200
W2015,1,11/25/2021,PKP96LMR2B,300,4900
W2015,1,11/27/2021,PKR199XLMR,200,4700
W2015,1,12/6/2021,PL62PNPKZY,3000,1700
W2015,1,12/7/2021,PL75RF4WXJ,200,1500
W2015,1,12/8/2021,PL84TFMU7G,1500,0
W2015,2,1/29/2022,QAT7BCH3QN,100,6400
W2015,2,1/29/2022,QAT9BCJRUP,100,6300
W2015,2,2/3/2022,QB31KDR29P,1425,4875
W2015,2,2/9/2022,QB97VVQ17V,1625,3250
W2015,2,2/16/2022,QBG59RID8F,1625,1625
W2015,2,2/23/2022,QBN7LQ45W9,1625,0
W2015,3,3/3/2022,QC331SFLQH,800,5700
W2015,3,3/9/2022,QC94EDTYDG,1000,4700
W2015,3,3/16/2022,QCG0S0ZDS6,1625,3075
W2015,3,3/19/2022,QCJ0WPSRY4,3075,0
W2015,4,4/5/2022,QD54UVOKTK,1650,5650
W2015,4,4/13/2022,QDD9BF5TGD,500,5150
W2015,4,4/19/2022,QDJ0NDXUZQ,1500,3650
W2015,4,4/20/2022,QDK4NM97IU,500,3150
W2015,4,4/20/2022,QDK9P8REYB,250,2900
W2015,4,4/22/2022,QDM2S6Z23S,300,2600
W2015,4,4/26/2022,QDQ2Z6D26U,200,2400
W2015,4,4/28/2022,QDS34LYESH,200,2200
W2015,4,5/14/2022,QEE8Z0J5QI,300,1900
W2015,4,5/16/2022,QEG43A1P3C,200,1700
W2015,4,5/17/2022,QEH556FNQZ,200,1500
W2015,4,5/17/2022,QEH85DHSDC,100,1400
W2015,4,5/17/2022,QEH75DKTXR,100,1300
W2015,4,5/17/2022,QEH15DPA5D,100,1200
W2015,4,5/17/2022,QEH65DE82E,100,1100
W2015,4,5/17/2022,QEH25EUASU,500,600
W2015,4,5/17/2022,QEH75F7S25,100,500
W2015,4,5/17/2022,QEH45J6RAW,400,100
W2015,4,5/17/2022,QEH25JC128,100,0
W2015,5,5/20/2022,QEK4AT6M4I,100,3560
W2015,5,5/20/2022,QEK0AT7ZEK,100,3460
W2015,5,5/20/2022,QEK0ATC9J6,50,3410
W2015,5,5/21/2022,QEL6DMKET8,100,3310
W2015,5,5/21/2022,QEL3DMN703,100,3210
W2015,5,5/23/2022,QEN0HKRILW,100,3110
W2015,5,5/24/2022,QEO6IZVA20,100,3010
W2015,5,5/31/2022,QEV3W3EVU3,500,2510
W2015,5,6/6/2022,QF65A4J4KN,2510,0
W2015,6,6/24/2022,QFO29RHQI0,3900,0
W2015,7,7/31/2022,QGV8EKSFKQ,7300,0
W2016,1,11/16/2021,PKG3R009JD,100,4280
W2016,1,11/16/2021,PKG6R01V9I,30,4250
W2016,1,11/27/2021,PKR099XHBG,50,4200
W2016,1,11/23/2021,PLN3JMRG4F,100,4100
W2016,1,11/23/2021,PLN3JMO4PJ,100,4000
W2016,1,12/23/2021,PLN5J0EXPF,3520,480
W2017,1,11/18/2021,PKI9UBKTLD,1750,11850
W2017,1,11/19/2021,PKJ9V19J9P,800,11050
W2017,1,11/19/2021,PKJ2W3P0LQ,700,10350
W2017,1,11/26/2021,PKQ87N8U8C,1200,9150
W2017,1,11/26/2021,PKQ18W1YGP,650,8500
W2017,1,11/30/2021,PKU7F97WJP,500,8000
W2017,1,11/30/2021,PKU2FL62IK,900,7100
W2017,1,12/1/2021,PL13H5G2KD,2500,4600
W2017,1,12/3/2021,PL35JPVQL3,750,3850
W2017,1,12/9/2021,PL94U78J32,3850,0
W2018,1,11/18/2021,PKI4UF6A94,1950,5850
W2018,1,11/27/2021,PKR0AORPUY,1000,4850
W2018,1,11/30/2021,PKU6EI8DAS,950,3900
W2018,1,12/5/2021,PL57NSE71T,1950,1950
W2018,1,12/7/2021,PL78QTLDRC,1950,0
W2018,2,12/13/2021,PLD62PZB3A,1500,7980
W2018,2,12/24/2021,PLO2N1927K,1000,6980
W2018,2,12/25/2021,PLP0O8V3MM,450,6530
W2018,2,12/26/2021,PLQ8PV81EO,650,5880
W2018,2,1/4/2022,QA405JXTFY,200,5680
W2018,2,1/4/2022,QA495JZF4B,1500,4180
W2018,2,1/6/2022,QA6887KLSY,1000,3180
W2018,2,1/10/2022,QAA7EBWIMP,500,2680
W2018,2,1/14/2022,QAE7M6BLL1,400,2280
W2018,2,1/20/2022,QAK6UZTG74,600,1680
W2018,2,1/20/2022,QAK8W8A7DI,300,1380
W2018,2,1/21/2022,QAL3XWCU65,200,1180
W2018,2,2/3/2022,QB36LMSHYO,200,980
W2018,2,2/4/2022,QB47M35MUP,260,720
W2018,3,2/12/2022,QBC82FB28U,400,6100
W2018,3,2/14/2022,QBE06SG3UW,1100,5000
W2018,3,2/25/2022,QBP0QO67IE,500,4500
W2018,3,3/3/2022,QC332BFEHJ,1625,2875
W2018,3,3/5/2022,QC577MS2GR,1500,1375
W2018,3,3/6/2022,QC628OUTRE,1375,0
W2018,4,3/22/2022,QCM34UQ7WT,1000,6800
W2018,4,3/31/2022,QCV6KPF45M,2000,4800
W2018,4,4/4/2022,QD48SWNB4U,2800,2000
W2018,4,4/4/2022,QD48SZ9VM,2000,0
W2018,5,4/21/2022,QDL8QARUDM,2000,5700
W2018,5,4/25/2022,QDP2XIOYKI,2000,3700
W2018,5,4/29/2022,QDT261EJUM,3700,0
W2018,6,5/26/2022,QEQ2MTDGRU,7800,0
W2018,7,6/15/2022,QFF7S5LZ8P,3000,4800
W2018,7,6/21/2022,QFL745L83L,2000,2800
W2018,7,6/21/2022,QFL64BQLCW,2800,0
W2018,8,7/18/2022,QGI9NP8ZBH,9100,0
W2018,9,8/9/2022,QH96XC1FKU,1000,8520
W2018,9,8/11/2022,QHB31RRC6P,4000,4520
W2018,9,8/15/2022,QHF28HV8HG,2000,2520
W2018,9,8/15/2022,QHF999TR55,2100,420
W2018,10,9/16/2022,QIG63OK0P4,1000,8520
W2018,10,9/17/2022,QIH46QSBBM,2000,6520
W2018,10,9/19/2022,QIJ49H7C7W,6100,420
W2018,10,9/19/2022,QIJ79N93UX,420,0
W2018,11,10/18/2022,QJI75MPM85,9100,0
W2018,12,11/14/2022,QKE0WHUM6S,9030,0
W2018,13,11/28/2022,QKS5V5CQD3,1000,8520
W2018,13,12/14/2022,QLE15J3CQL,8520,0
W2018,14,1/11/2023,RAB46G94MC,9100,0
W2018,15,3/3/2023,RC38W1IAK2,1500,7600
W2018,15,3/8/2023,RC82B2FTW8,7600,0
W2018,16,4/5/2023,RD55G5WJQR,9100,0
W2018,17,5/4/2023,RE41PJ19LL,10880,0
W2018,18,6/2/2023,RF271YNZ9P,10880,0
W2018,19,7/6/2023,RG69TEEO4J,500,10380
W2018,19,7/10/2023,RGA76BPFM3,10380,0
W2018,20,8/2/2023,RH292QBGT5,5200,5200
W2019,1,11/15/2021,PKF3OIGYAL,5,9515
W2019,1,11/15/2021,PKF9OIN8YH,500,9015
W2019,1,11/15/2021,PKF1OIXAPB,450,8565
W2019,1,11/18/2021,PKI7T80O3D,650,7915
W2019,1,11/20/2021,PKK3WBUK37,750,7165
W2019,1,11/21/2021,PKL8Z53RX0,650,6515
W2019,1,11/23/2021,PKN63UF1DY,500,6015
W2019,1,11/25/2021,PKP95PM24V,500,5515
W2019,1,11/27/2021,PKR19D7GB5,300,5215
W2019,1,11/28/2021,PKS3B72QGV,250,4965
W2019,1,12/3/2021,PL35K5GUKT,300,4665
W2019,1,12/5/2021,PL53OJLEFP,1300,3365
W2019,1,12/7/2021,PL71RJ4TNJ,500,2865
W2019,1,12/10/2021,PLA2XJ5B4U,750,2115
W2019,1,12/11/2021,PLB3ZCNTL3,500,1615
W2019,1,12/13/2021,PLD12QYF9F,1195,420
W2019,2,1/28/2022,QAS29XVRFW,100,5100
W2019,2,1/28/2022,QAS89XZZR4,100,5000
W2019,2,1/29/2022,QAT5B1JCN9,100,4900
W2019,2,1/29/2022,QAT8B1L9ZQ,100,4800
W2019,2,1/30/2022,QAU0E3NNKC,10,4790
W2019,2,1/30/2022,QAU3E3SP8Z,90,4700
W2019,2,1/30/2022,QAU8E3VXWA,100,4600
W2019,2,1/31/2022,QAV4G5TMXY,100,4500
W2019,2,1/31/2022,QB17G5UA4R,100,4400
W2019,2,2/2/2022,QB27I316YZ,100,4300
W2019,2,2/2/2022,QB29I332NP,100,4200
W2019,2,2/2/2022,QB27J8XGSD,100,4100
W2019,2,2/2/2022,QB28J96LCG,100,4000
W2019,2,2/3/2022,QB30LMGEQ6,100,3900
W2019,2,2/3/2022,QB32LMIK4C,100,3800
W2019,2,2/7/2022,QB77SZ8K1Z,100,3700
W2019,2,2/7/2022,QB77SZEBBX,100,3600
W2019,2,2/7/2022,QB75SZH7CV,100,3500
W2019,2,2/7/2022,QB75SZKN2R,100,3400
W2019,2,2/7/2022,QB73SZNRGJ,100,3300
W2019,2,2/8/2022,QB82UK4BFC,100,3200
W2019,2,2/8/2022,QB83UKDNBB,100,3100
W2019,2,2/9/2022,QB99WMLBY9,100,3000
W2019,2,2/9/2022,QB99WMDTGH,100,2900
W2019,2,2/11/2022,QBB0Z5XOVW,100,2800
W2019,2,2/11/2022,QBB6Z615G8,100,2700
W2019,2,2/13/2022,QBD83X5ZFC,100,2600
W2019,2,2/13/2022,QBD93X9N8D,100,2500
W2019,2,2/13/2022,QBD63XGM2A,100,2400
W2019,2,2/13/2022,QBD73XKHJP,100,2300
W2019,2,2/13/2022,QBD73XNI7D,100,2200
W2019,2,2/16/2022,QBG19I1ELN,100,2100
W2019,2,2/17/2022,QBH8ANW4WW,100,2000
W2019,2,2/18/2022,QBI1D3LSO7,100,1900
W2019,2,2/18/2022,QBI1D3O23B,100,1800
W2019,2,2/20/2022,QBK5GEU8SJ,100,1700
W2019,2,2/20/2022,QBK2GEWEAQ,100,1600
W2019,2,2/20/2022,QBK7GF1IYD,50,1550
W2019,2,2/21/2022,QBL3I36A0B,1000,550
W2019,2,2/22/2022,QBM4KUJQZ4,100,450
W2019,2,2/22/2022,QBM1L6BS8R,100,350
W2019,2,2/22/2022,QBM6L6NH5Y,100,250
W2019,2,2/22/2022,QBM1L6YH3Z,100,150
W2019,2,2/22/2022,QBM3L7CDLT,100,50
W2019,2,2/22/2022,QBM3L7I2JV,50,0
W2019,3,2/24/2022,QBO9O956Y1,100,5100
W2019,3,2/24/2022,QBO8O9PEPQ,100,5000
W2019,3,2/26/2022,QBQ5SKKDB3,100,4900
W2019,3,2/26/2022,QBQ8SKMCHE,100,4800
W2019,3,2/27/2022,QBR9T2FOB3,100,4700
W2019,3,2/27/2022,QBR6T2JHHW,100,4600
W2019,3,2/28/2022,QBS8USSECG,100,4500
W2019,3,2/28/2022,QBS7USWBLP,100,4400
W2019,3,3/3/2022,QC392NRT7B,100,4300
W2019,3,3/3/2022,QC352NUAHN,100,4200
W2019,3,3/4/2022,QC40422CP0,100,4100
W2019,3,3/4/2022,QC434263KD,100,4000
W2019,3,3/6/2022,QC6787RWHB,100,3900
W2019,3,3/6/2022,QC6287V3VM,100,3800
W2019,3,3/8/2022,QC82D8KAZQ,100,3700
W2019,3,3/8/2022,QC89D8NPGT,100,3600
W2019,3,3/9/2022,QC96F8P14S,100,3500
W2019,3,3/9/2022,QC92F8RGGK,100,3400
W2019,3,3/12/2022,QCC4JDYVQQ,100,3300
W2019,3,3/12/2022,QCC5JDZYFJ,100,3200
W2019,3,3/13/2022,QCD3MSACFL,100,3100
W2019,3,3/13/2022,QCD8MSY61C,100,3000
W2019,3,3/13/2022,QCD5MT82OZ,100,2900
W2019,3,3/13/2022,QCD9MX9393,100,2800
W2019,3,3/13/2022,QCD4MXDIPI,100,2700
W2019,3,3/14/2022,QCE5OO2DGB,100,2600
W2019,3,3/14/2022,QCE7OO7HFF,100,2500
W2019,3,3/17/2023,QCH1SU4J69,100,2400
W2019,3,3/17/2023,QCH3SU2WV5,100,2300
W2019,3,3/17/2023,QCH6UFRAN6,1000,1300
W2019,3,3/18/2022,QCI8WCR4T4,100,1200
W2019,3,3/18/2022,QCI1WCVK4R,100,1100
W2019,3,3/18/2022,QCI4WD168E,100,1000
W2019,3,3/18/2022,QCI5WD5PLT,100,900
W2019,3,3/21/2022,QCL72A40RJ,100,800
W2019,3,3/21/2022,QCL62AKJVO,100,700
W2019,3,3/21/2022,QCL32AOEFD,100,600
W2019,3,3/21/2022,QCL02PPOWW,100,500
W2019,3,3/21/2022,QCL32Q8E1R,100,400
W2019,3,3/21/2022,QCL42QEVDI,100,300
W2019,3,3/21/2022,QCL92QKSPN,50,250
W2019,3,3/22/2022,QCM23Q2LAU,130,120
W2019,3,3/25/2022,QCP4A08RZE,20,100
W2019,3,3/25/2022,QCP8A0CJ8E,100,0
W2019,4,4/3/2022,QD30RWHTPU,100,5020
W2019,4,4/3/2022,QD33RWJVVN,100,4920
W2019,4,4/3/2022,QD36RWLWC2,100,4820
W2019,4,4/3/2022,QD35RWNPYT,100,4720
W2019,4,4/5/2022,QD57UKQG23,100,4620
W2019,4,4/5/2022,QD55UKT7IL,100,4520
W2019,4,4/5/2022,QD57UKWBQX,100,4420
W2019,4,4/5/2022,QD50UL4YEW,100,4320
W2019,4,4/8/2022,QD882X6HNW,100,4220
W2019,4,4/8/2022,QD882XDTW4,100,4120
W2019,4,4/8/2022,QD872XGTOD,100,4020
W2019,4,4/8/2022,QD822XJ1GG,100,3920
W2019,4,4/15/2022,QDF5GHHM5X,100,3820
W2019,4,4/15/2022,QDF7GHJD39,100,3720
W2019,4,4/27/2022,QDR11X88N3,1050,2670
W2019,4,4/27/2022,QDR71Y3KSV,1700,970
W2019,4,4/28/2022,QDS34AWMJV,970,0
W2019,5,6/1/2022,QF17ZXSYHZ,400,4800
W2019,5,6/15/2022,QFF2SVW6DW,100,4700
W2019,5,6/15/2022,QFF2SW2D2U,500,4200
W2019,5,6/19/2022,QFJ5ZEAKBZ,100,4100
W2019,5,6/19/2022,QFJ7ZEFMIX,100,4000
W2019,5,6/19/2022,QFJ5ZEK16T,100,3900
W2019,5,6/19/2022,QFJ8ZENBW8,100,3800
W2019,5,6/19/2022,QFJ915XF3R,100,3700
W2019,5,6/27/2022,QFR7FDRRV9,1000,2700
W2019,5,6/29/2022,QFT6JFCRY4,1450,1250
W2019,5,6/29/2022,QFT9JTNC1Z,1300,50
W2019,6,8/2/2022,QH28IKWTBS,2000,3200
W2019,6,8/2/2022,QH25K3SHUH,10,3190
W2019,6,8/2/2022,QH29K4MFU3,3190,0
W2019,7,8/7/2022,QH76STFG9O,100,5340
W2019,7,8/12/2022,QHC13YIVZ5,550,4790
W2019,7,8/17/2022,QHH0DCVFH2,500,4290
W2019,7,8/22/2022,QHM2LWAXME,500,3790
W2019,7,8/27/2022,QHR0V40YYM,500,3290
W2019,7,8/30/2022,QHU926SHQZ,500,2790
W2019,7,8/31/2022,QHV13SGVZX,1000,1790
W2019,7,9/4/2022,QI49CE5VC5,500,1290
W2019,7,9/6/2022,QI66GEVTJ2,550,740
W2019,7,9/6/2022,QI63GP6H1D,740,0
W2019,8,1/21/2023,RAL4VP9OYG,300,4900
W2019,8,1/23/2023,RAN5YPLA5P,300,4600
W2019,8,1/24/2023,RAO24PUBRU,300,4300
W2019,8,1/26/2023,RAQ47H3AN4,300,4000
W2019,8,1/27/2023,RAR9A7ELYN,300,3700
W2019,8,1/31/2023,RAV0LQY92I,350,3350
W2019,8,2/3/2023,RB36RXXG34,360,2990
W2019,8,2/4/2023,RB59YYDG5R,350,2640
W2019,8,2/7/2023,RB79647ABB,900,1740
W2019,8,2/9/2023,RB908TSR9O,600,1140
W2019,8,2/10/2023,RBA5D688A5,500,640
W2019,8,2/11/2023,RBB2E5D83Y,360,280
W2019,8,2/12/2023,RBC7GU3GST,500,220
W2019,9,3/2/2023,RC22SI2X38,200,4520
W2019,9,3/3/2023,RC33X6OM85,100,4420
W2019,9,3/3/2023,RC38X9PNTE,100,4320
W2019,9,3/6/2023,RC605ISJ6Y,400,3920
W2019,9,3/7/2023,RC719E24J3,400,3520
W2019,9,3/11/2023,RCB2IEAPW8,500,3020
W2019,9,3/15/2023,RCF6VAK1Z4,300,2720
W2019,9,3/16/2023,RCG3WHS3XF,250,2470
W2019,9,3/16/2023,RCG5WY3SBR,2470,0
W2019,10,3/19/2023,RCJ05698PC,500,6000
W2019,10,3/20/2023,RCK39BHEJX,500,5500
W2019,10,3/27/2023,RCR1PWWIAJ,500,5000
W2019,10,4/3/2023,RD31AJG7NB,500,4500
W2019,10,4/4/2023,RD40EBM4XQ,500,4000
W2019,10,4/5/2023,RD50HJ4JBA,500,3500
W2019,10,4/8/2023,RD88OAEIZW,700,2800
W2019,10,4/10/2023,RDA8SUET3Y,500,2300
W2019,10,4/13/2023,RDD51WRO1P,1000,1300
W2019,10,4/14/2023,RDE24LTSBE,500,800
W2019,10,4/14/2023,RDE15NC8RL,730,70
W2019,10,4/14/2023,RDE163SM5R,70,0
W2019,11,4/27/2023,RDR07HF6FK,500,4940
W2019,11,5/2/2023,RE23IEN1Q1,500,4440
W2019,11,5/6/2023,RE73WWRXS1,1000,3440
W2019,11,5/12/2023,REC1ES9HF3,450,2990
W2019,11,5/16/2023,REG3O9AMY9,700,2290
W2019,11,5/17/2023,REH0R83CYQ,500,1790
W2019,11,5/18/2023,REI5URO4IH,1790,0
W2019,12,6/15/2023,RFF45XAHY0,300,5140
W2019,12,6/16/2023,RFG88KFD98,200,4940
W2019,12,6/23/2023,RFN0ST3XDO,500,4440
W2019,12,6/29/2023,RFT78QF1CF,500,3940
W2019,12,7/12/2023,RGC2C49U0W,500,3440
W2019,12,7/10/2023,RGA96LM573,700,2740
W2019,12,7/12/2023,RGC3DXN2EN,1000,1740
W2019,12,7/13/2023,RGD0FZP4AG,1500,240
W2019,12,7/14/2023,RGE5K2WXWV,240,0
W2019,13,7/27/2023,RGR9JGFJ6T,200,5000
W2019,13,8/5/2023,RH55D2GHO3,500,4500
W2020,1,11/30/2021,PKU7F70ZA5,500,4240
W2020,1,12/9/2021,PL95UD5X5T,300,3940
W2020,1,10/13/2022,QJD3SR7D85,150,3790
W2021,1,11/23/2021,PKN42A4Q02,800,9600
W2021,1,12/10/2021,PLA0XM7DOG,4200,5400
W2021,1,12/14/2021,PLE64SO366,2600,2800
W2021,1,12/16/2021,PLG382S62R,2800,0
W2022,1,11/23/2021,PKN528QFK9,3250,12550
W2022,1,12/7/2021,PL75RIJO5R,300,12250
W2022,1,12/18/2021,PLI5BSE1G5,500,11750
W2022,1,12/20/2021,PLK1F30KFX,507,11243
W2022,1,12/22/2021,PLM9IHXG0F,217,11026
W2022,1,12/28/2021,PLS1SPTNVP,527,10499
W2022,1,1/10/2022,QAA3F5P4D1,500,9999
W2022,1,1/20/2022,QAK6VS75VE,350,9649
W2022,1,1/24/2022,QAO93IFFRB,350,9299
W2022,1,1/24/2022,QAO53HGHV1,300,8999
W2022,1,1/24/2022,QAO53KKGAV,400,8599
W2022,1,1/28/2022,QAS1A43KOF,1000,7599
W2022,1,2/2/2022,QB25J6G4T1,1000,6599
W2022,1,2/3/2022,QB35L0ZXB5,1000,5599
W2022,1,2/8/2022,QB84U5T8PW,540,5059
W2022,1,2/9/2022,QB94W4QH96,550,4509
W2022,1,2/16/2022,QBG69T8WPI,450,4059
W2022,1,2/28/2022,QBS9VO4LSV,500,3559
W2022,1,3/1/2022,QC17XMF33V,220,3339
W2022,1,3/10/2022,QCA3GMW4OP,300,3039
W2022,1,4/1/2022,QD17MAXE3F,3040,1
W2023,1,11/22/2021,PKM31BIQSJ,1625,4580
W2023,1,11/30/2021,PKU8EF5H02,1000,3580
W2023,1,11/30/2021,PKU9EF9WV3,600,2980
W2023,1,11/30/2021,PKU6EFDB12,30,2950
W2023,1,12/7/2021,PL74QRA3YY,2900,50
W2023,1,12/7/2021,PL79QRC8IN,50,0
W2023,2,12/9/2021,PL90UJAH4K,434,6066
W2023,2,12/14/2021,PLE74J5ELJ,500,5566
W2023,2,12/15/2021,PLF770X3MH,500,5066
W2023,2,12/15/2021,PLF36128FL,500,4566
W2023,2,12/18/2021,PLI1B6ZDGZ,500,4066
W2023,2,12/18/2021,PLI6C8CT28,500,3566
W2023,2,12/24/2021,PLO1MI2FZT,500,3066
W2023,2,12/24/2021,PLO5MIATZL,300,2766
W2023,2,12/29/2021,PLT6THNKKW,217,2549
W2023,2,12/30/2021,PLU1V3UK93,217,2332
W2023,2,12/31/2021,PLV6WQNOII,217,2115
W2023,2,1/3/2022,QA342FESJ6,550,1565
W2023,2,1/4/2022,QA405F8MQO,1900,335
W2023,2,1/6/2022,QA697QOFHZ,215,550
W2024,2,11/16/2021,PKG8QPWPRS,100,6400
W2024,2,11/16/2021,PKG4QQ1WQ,100,6300
W2024,2,11/16/2021,PKG6QQ66FM,17,6283
W2024,2,11/18/2021,PKI5U2PAI5,100,6183
W2024,2,11/18/2021,PKI6U2WCV4,100,6083
W2024,2,11/18/2021,PKI0U326LS,100,5983
W2024,2,11/18/2021,PKI1U378PD,100,5883
W2024,2,11/18/2021,PKI8U3P9VK,30,5853
W2024,1,11/19/2021,PKJ5VS85QH,100,5753
W2024,1,11/19/2021,PKJ6VSG5GU,100,5653
W2024,1,11/19/2021,PKJ3VSRSYP,20,5633
W2024,1,11/20/2021,PKK5XDDZSX,100,5533
W2024,1,11/20/2021,PKK3XDHQU9,100,5433
W2024,1,11/20/2021,PKK6XDM0T4,100,5333
W2024,1,11/20/2021,PKK6XDQAQS,30,5303
W2024,1,11/22/2021,PKM21YQW18,300,5003
W2024,1,11/24/2021,PKO553T6GL,434,4569
W2024,1,11/25/2021,PKP970B21D,417,4152
W2024,1,11/28/2021,PKS9BUBJKN,434,3718
W2024,1,11/30/2021,PKU1FHADLF,1900,1818
W2024,1,12/1/2021,PL10H2MO3C,100,1718
W2024,1,12/1/2021,PL16H2SBEY,10,1708
W2024,1,12/2/2021,PL27J2EWG9,100,1608
W2024,1,12/2/2021,PL26J28R00,100,1508
W2024,1,12/2/2021,PL22J2J1C4,17,1491
W2024,1,12/5/2021,PL56OARTNI,100,1391
W2024,1,12/5/2021,PL57OAYA9F,100,1291
W2024,1,12/5/2021,PL50OB4C8G,17,1274
W2024,1,12/6/2021,PL65Q80SCV,100,1174
W2024,1,12/6/2021,PL61Q859HB,10,1164
W2024,1,12/7/2021,PL70RU682W,100,1064
W2024,1,12/7/2021,PL75RUCYDJ,10,1054
W2024,1,12/8/2021,PL89TO70KT,100,954
W2024,1,12/8/2021,PL85TOBPM9,10,944
W2024,1,12/9/2021,PL91VPQMEX,100,844
W2024,1,12/9/2021,PL92VPSEDQ,10,834
W2024,1,12/10/2021,PLA3X96KLT,100,734
W2024,1,12/10/2021,PLA0X9D1CM,10,724
W2024,1,12/11/2021,PLB0Z4V2S0,100,624
W2024,1,12/11/2021,PLB4Z5SETI,10,614
W2024,1,12/12/2021,PLC61WFI6Y,100,514
W2024,1,12/12/2021,PLC31WJWIL,10,504
W2024,1,12/14/2021,PLE13YG9LD,504,0
W2025,1,12/15/2021,PLF96FOLWV,13600,0
W2025,2,1/10/2022,QAA1EJRCTF,12800,0
W2025,3,1/26/2022,QAQ065M89A,11700,0
W2025,4,2/28/2022,,20500,100
W2025,5,3/28/2022,QCS5EPAQAP,19500,0
W2025,6,4/13/2022,QDD7BJ351D,17850,0
W2025,7,5/14/2022,QEE7YYK0ZT,1000,26200
W2025,8,5/18/2022,QEI87UIXDW,26200,0
W2025,9,6/28/2022,QFT2K1BZEQ,25000,0
W2025,10,7/30/2022,QGU5CIAVOZ,2000,37500
W2025,10,10/22/2022,QJM0DQJHAU,3000,34500
W2025,10,11/9/2022,QK93KC32D3,2000,32500
W2026,1,11/23/2021,PKN53V13ZR,1100,5050
W2026,1,11/30/2021,PKU9FMOYSB,1750,3300
W2026,1,12/7/2021,PL79QUFMZB,3300,0
W2027,1,11/23/2021,PKN53X8QLT,1000,4200
W2027,1,11/26/2021,PKQ07V2IE8,300,3900
W2027,1,12/5/2021,PL57OH1SG1,1000,2900
W2027,1,12/11/2021,PLB7YZXQOZ,377,2523
W2027,1,12/22/2021,PLM1IILA9F,200,2323
W2027,1,1/20/2022,QAK3VAE99Z,200,2123
W2027,1,1/25/2022,QAP546F4Z1,200,1923
W2027,1,1/28/2022,QAS2A62RXY,100,1823
W2027,1,1/28/2022,QAS8A6CTYW,100,1723
W2027,1,2/1/2022,QB10H9ZIS8,100,1623
W2027,1,2/3/2022,QB32KFBEUC,150,1473
W2027,1,2/8/2022,QB82U67X6K,100,1373
W2027,1,2/16/2022,QBG99O44CL,100,1273
W2027,1,2/16/2022,QBG49O80LC,100,1173
W2027,1,2/25/2022,QBP2Q0W13U,100,1073
W2027,1,3/3/2022,QC342BG8DO,100,973
W2027,1,3/10/2022,QCA3GM9MEZ,100,873
W2027,1,4/5/2022,QD50UYMKK4,60,813
W2027,1,8/31/2022,QHV84SAX9Y,50,763
W2027,1,9/5/2022,QI52F9NDGQ,50,713
W2027,1,9/8/2022,QI89LXKWRB,50,663
W2027,1,10/18/2022,QJI35H4LFB,100,563
W2027,1,2/23/2023,RBN3ANAM53,50,513
W2027,1,2/28/2023,RBS7O2YOQH,50,463
W2027,1,3/1/2023,RC16QWA0V2,50,413
W2027,1,3/22/2023,RCM0DMFTOC,100,313
W2027,1,3/27/2023,RCR9R9MY2Z,50,263
W2027,1,3/28/2023,RCS5TVVZMR,50,213
W2027,1,4/4/2023,RD49DYH9DX,100,113
W2027,1,4/4/2023,RD42DYQSLK,100,13
W2027,1,4/4/2023,RD49DZGOZ1,13,0
W2028,1,11/25/2021,PKP26COWQM,1625,6275
W2028,1,12/3/2021,PL30KC4U2W,1096,5179
W2028,1,12/4/2021,PL44LEUH3E,380,4799
W2028,1,12/14/2021,PLE84MBYL6,377,4422
W2028,1,12/20/2021,PLK9ELHR2X,500,3922
W2028,1,12/24/2021,PLO8LFVZVK,1000,2922
W2028,1,10/13/2022,QJD7TBTM3N,300,2622
W2029,1,12/14/2021,PLE94D9JSV,13000,0
W2029,2,1/10/2022,QAA8EF961I,13000,0
W2029,3,2/8/2022,QB89TJOFNJ,19500,0
W2029,4,3/9/2022,QC94DXW1VY,19500,0
W2029,5,4/5/2022,QD57VRMJXP,19500,0
W2029,6,5/5/2022,QE55HEZWWP,26000,0
W2029,7,6/3/2022,QF373ZI6BJ,26000,0
W2029,8,6/30/2022,QFU5LVM53N,26000,0
W2029,9,7/28/2022,QGS98HV8HX,26000,0
W2029,10,8/26/2022,QHQ0TBWNRS,3000,28600
W2029,10,10/16/2022,QJG724CJGT,1000,27600
W2029,10,11/11/2022,QKB9PC6HJF,1000,26600
W2029,10,11/18/2022,QLI8HRGSFK,500,26100
W2030,1,11/30/2021,PKU8EEI7BE,500,4240
W2030,1,12/15/2021,PLF26GNQHE,2000,2240
W2031,1,11/30/2021,PKU2EEZVSK,975,2925
W2031,1,12/7/2021,PL72R95H90,975,1950
W2031,1,12/17/2021,PLH59E6T0R,1950,0
W2031,2,3/1/2022,QC13Y7POAD,800,3100
W2031,2,3/16/2022,QCG1R8M7ED,1000,2100
W2031,2,3/17/2022,QCH4TLVXFA,2100,0
W2032,1,12/17/2021,PLH99MDKN7,12800,0
W2032,2,1/18/2022,QA13RYME4R,7000,7600
W2032,2,1/21/2022,QAL4X1G8ZQ,2500,5100
W2032,2,1/28/2022,QAS0AD061K,5100,0
W2032,3,3/24/2022,QCO17IW2B1,13000,0
W2032,4,4/22/2022,QDM3RVI241,10800,2200
W2032,4,4/22/2022,QDM6S8JJVG,2200,0
W2032,5,5/20/2022,QEK3CBF6A9,13000,0
W2032,6,5/24/2022,QEO4J0IDZO,6250,4950
W2032,6,5/25/2022,QEP1KPAR45,4950,0
W2032,7,6/20/2022,QFK52FG3PJ,12800,0
W2032,8,6/22/2022,QFM667YRK2,15500,1300
W2032,8,6/23/2022,QFN67UZMVQ,1300,0
W2032,9,7/30/2022,QGU8C6TMO0,6100,50
W2032,9,7/30/2022,QGU3C7TTJR,50,0
W2032,10,8/22/2022,QHM0LNQEB0,12400,0
W2033,1,11/29/2021,PKT2D65MTC,500,3400
W2033,1,12/8/2021,PL87T3CTUJ,400,3000
W2033,1,12/16/2021,PLG17C3CI9,500,2500
W2033,1,12/18/2021,PLI8B5TP30,250,2250
W2033,1,12/20/2021,PLK0EVLBYY,2250,0
W2034,1,11/24/2021,PKO75GJH05,100,6400
W2034,1,11/24/2021,PKO45GUSBO,17,6383
W2034,1,11/24/2021,PKO65JZIQ8,100,6283
W2034,1,11/24/2021,PKO643GSBE,100,6183
W2034,1,11/24/2021,PKO143KACR,117,6066
W2034,1,11/24/2021,PKO65JZIQ82,100,5966
W2034,1,11/25/2021,PKP16S31XP,100,5866
W2034,1,11/25/2021,PKP86S7AU2,17,5849
W2034,1,11/25/2021,PKP56TDEOT,100,5749
W2034,1,11/26/2021,PKQ48B4TCK,100,5649
W2034,1,11/26/2021,PKQ98B88M7,17,5632
W2034,1,11/26/2021,PKQ88CLS36,100,5532
W2034,1,,,,5532
W2034,1,11/27/2021,PKR19XMWQ9,100,5432
W2034,1,11/27/2021,PKR09XPEUE,17,5415
W2034,1,11/27/2021,PKR99XUV0B,100,5315
W2034,1,11/29/2021,PKT3CZ2VBH,100,5215
W2034,1,11/29/2021,PKT9CZ9YNL,17,5198
W2034,1,11/29/2021,PKT6CZC4N0,100,5098
W2034,1,11/29/2021,PKT0DV2KC2,100,4998
W2034,1,11/29/2021,PKT1DV57SH,17,4981
W2034,1,11/29/2021,PKT7DVAOA9,100,4881
W2034,1,11/30/2021,PKU9F3X1K7,100,4781
W2034,1,11/30/2021,PKU3F41689,17,4764
W2034,1,11/30/2021,PKU2F487IA,100,4664
W2034,1,12/2/2021,PL26IM0812,100,4564
W2034,1,12/2/2021,PL26IMF4TS,100,4464
W2034,1,12/7/2021,PL72RVMNDG,100,4364
W2034,1,12/7/2021,PL72RVSBLO,100,4264
W2034,1,12/9/2021,PL96V59JCU,1014,3250
W2034,1,12/11/2021,PLB9Y4I18J,400,2850
W2034,1,12/11/2021,PLB4Y4L2U8,50,2800
W2034,1,12/14/2021,PLE04FVU8M,100,2700
W2034,1,12/14/2021,PLE04ORM3U,100,2600
W2034,1,12/14/2021,PLE457WGTK,100,2500
W2034,1,12/15/2021,PLF5776Z9V,875,1625
W2034,1,12/17/2021,PLH59GO7P9,1625,0
W2034,2,1/1/2022,QA15YPVUQJ,1625,4875
W2034,2,1/5/2022,QA506DLLC2,1625,3250
W2034,2,1/11/2022,QAB9G60YUX,3250,0
W2034,3,1/18/2022,QAI9SOD1Q7,1625,4875
W2034,3,1/25/2022,QAP35OEKXH,1625,3250
W2034,3,2/1/2022,QB19GV2B1X,3250,0
W2034,4,2/10/2022,QBA3WRLE6D,1000,11640
W2034,4,2/10/2022,QBA8YKNOFC,600,11040
W2034,4,2/14/2022,QBE26B844Y,500,10540
W2034,4,2/21/2022,QBL5IJNY8X,1000,9540
W2034,4,2/24/2022,QBO0OJACEG,500,9040
W2034,4,3/2/2022,QC2919PGB7,200,8840
W2034,4,3/3/2022,QC483KFGP4,100,8740
W2034,4,3/5/2022,QC526OBRJ0,100,8640
W2034,4,2/7/2022,QC72BFF056,200,8440
W2034,4,3/8/2022,QCA6HC85EA,100,8340
W2034,4,3/15/2022,QCF0PXHWBW,100,8240
W2034,4,3/15/2022,QCF2PXL14I,100,8140
W2034,4,3/15/2022,QCF8PXNYIU,70,8070
W2034,4,3/16/2022,QCG5S87VAB,100,7970
W2034,4,3/16/2022,QCG3S8H9Z1,100,7870
W2034,4,3/16/2022,QCG0SC1HES,100,7770
W2034,4,3/17/2022,QCH4UMF9DK,100,7670
W2034,4,3/17/2022,QCH2UMHH6K,100,7570
W2034,4,3/18/2022,QCI6WELWIY,100,7470
W2034,4,3/18/2022,QCI4WEOVYO,100,7370
W2034,4,3/19/2022,QCJ3XTZ3MB,100,7270
W2034,4,3/19/2022,QCJ8XU70DA,100,7170
W2034,4,,,,7170
W2035,1,11/30/2021,PKU5FHWQU5,813,2587
W2035,1,12/8/2021,PL84TEWAMW,513,2074
W2035,1,12/11/2021,PLB9Y9PW6X,250,1824
W2035,1,12/14/2021,PLE25BZIVW,550,1274
W2035,1,12/21/2021,PLL8HBZOL0,195,1079
W2035,1,12/22/2021,PLM8J1DG4A,930,149
W2035,2,4/20/2022,QDK9P9PU9V,750,2940
W2035,2,4/27/2022,QDR52PAAT9,1050,1890
W2035,2,4/27/2022,QDR22PR95O,150,1740
W2035,2,4/29/2022,QDT370KWEP,70,1670
W2035,2,4/29/2022,QDT672ZUE8,400,1270
W2035,2,5/5/2022,QE53HXDRVH,1270,0
W2036,1,12/22/2021,PLM0HY6NYQ,500,12140
W2036,1,12/28/2021,PLS6S3PUGY,500,11640
W2036,1,12/28/2021,PLS3SYF0HT,500,11140
W2036,1,12/29/2021,PLT2TXCMO2,500,10640
W2036,1,12/30/2021,PLU1W0XZXX,500,10140
W2036,1,1/3/2022,QA303HQHF2,500,9640
W2036,1,1/5/2022,QA526RJXD4,500,9140
W2036,1,1/10/2022,QAA7EUXUGJ,100,9040
W2036,1,1/11/2022,QAB6G00082,400,8640
W2036,1,1/12/2022,QAC3HG8WHD,500,8140
W2036,1,1/13/2022,QAD4JF729W,500,7640
W2036,1,1/15/2022,QAF0MMUL46,400,7240
W2036,1,1/17/2022,QAH0R26DVG,500,6740
W2036,1,1/21/2022,QAL1XRD3M3,400,6340
W2036,1,1/25/2022,QAP04JAYL2,300,6040
W2036,1,2/2/2022,QB28J5FHIY,100,5940
W2036,1,2/2/2022,QB27J5MLFP,100,5840
W2036,1,2/2/2022,QB27J5SC03,100,5740
W2036,1,2/19/2022,QBJ6G0M57Q,500,5240
W2036,1,2/22/2022,QBM6JYH3N0,500,4740
W2036,1,2/23/2022,QBN7MTJ05R,100,4640
W2036,1,2/23/2022,QBN4MTNC1W,100,4540
W2036,1,2/23/2022,QBN3MTW5TL,100,4440
W2036,1,2/25/2022,QBP1P4S45P,100,4340
W2036,1,2/25/2022,QBP1P4UIIV,100,4240
W2036,1,2/25/2022,QBP8P4XDK8,100,4140
W2036,1,3/8/2022,QC89BRXEZJ,100,4040
W2036,1,3/8/2022,QC86BS0R5A,100,3940
W2036,1,3/8/2022,QC83BSJWGR,100,3840
W2036,1,3/17/2022,QCH0TFU39O,500,3340
W2036,1,3/25/2022,QCP592XICB,100,3240
W2036,1,3/25/2022,QCP39316FT,100,3140
W2036,1,4/7/2022,QD76Z3VV2Y,900,2240
W2037,1,12/22/2021,PLM3I25DBT,13000,0
W2037,2,1/20/2022,QAK5VKHORV,"13000",0
W2037,3,2/18/2022,QBI4CJAI46,"13000",0
W2037,4,3/21/2022,QCL524GRVP,"4850",15550
W2037,4,3/25/2022,QCP69GUF9M,15550,0
W2038,1,12/6/2021,PL66ONHQHO,700,6100
W2038,1,12/16/2021,PLG87ZQD34,1000,5100
W2038,1,12/17/2021,PLH39YSSX1,500,4600
W2038,1,12/18/2021,PLI5BNAX2V,1000,3600
W2038,1,12/21/2021,PLL0HCVJKG,500,3100
W2038,1,12/22/2021,PLN1J9A7YR,2000,1100
W2038,1,12/23/2021,PLN1K9GN6R,800,300
W2038,2,6/17/2022,QFH7V1JL0Z,3200,2800
W2038,2,6/22/2022,QFM75YMQZZ,2800,0
W2038,3,7/15/2022,QGF9JGDSDF,3600,180
W2038,3,7/16/2022,QGG5K58651,180,0
W2038,4,8/13/2022,QHD058GLEQ,2600,0
W2039,1,12/3/2021,PL39K2688Z,975,3765
W2040,1,12/24/2021,PLO7LF9HU5,13000,0
W2040,2,1/21/2022,QAL6WHDY4Q,5000,8600
W2040,2,1/24/2022,QAO132WO1J,8000,600
W2040,2,1/26/2022,QAQ460J17G,600,0
W2040,3,2/14/2022,QBE0648QCY,12200,0
W2040,4,3/21/2022,QCL61HPFC6,2000,5680
W2040,4,3/28/2022,QCS3FDKMPD,5680,0
W2040,5,4/28/2022,QDDS54BQ2BL,12800,0
W2040,6,5/23/2022,QEN9GS8A07,12600,0
W2040,7,6/13/2022,QFD7OHVTYR,12100,200
W2040,7,6/23/2022,QFN28ZVH88,100,100
W2040,7,6/23/2022,QFN2903Q3Q,100,0
W2041,1,12/1/2021,PL22HK9MJ0,217,6283
W2041,1,12/3/2021,PL31JF9CC9,217,6066
W2041,1,12/6/2021,PL61OPNZ5J,651,5415
W2041,1,12/9/2021,PL97U6W3F1,651,4764
W2041,1,12/16/2021,PLG77UMCS3,646,4118
W2041,1,12/16/2021,PLG57G3MLB,868,3250
W2041,1,12/21/2021,PLL4FTOZQA,217,3033
W2041,1,12/21/2021,PLL4GPMKKQ,1408,1625
W2041,1,12/27/2021,PLR8RNED92,1625,0
W2041,2,1/6/2022,QA637HL0FX,100,6400
W2041,2,1/6/2022,QA697HOGTV,100,6300
W2041,2,1/6/2022,QA667HSCZC,100,6200
W2041,2,1/6/2022,QA637HUSAL,100,6100
W2041,2,1/6/2022,QA617HYC15,34,6066
W2041,2,1/10/2022,QAA5E8CALP,100,5966
W2041,2,1/10/2022,QAA3E8J7VT,100,5866
W2041,2,1/10/2022,QAA3E8S5XF,100,5766
W2041,2,1/11/2022,QAB7FV72F7,100,5666
W2041,2,1/11/2022,QAB8FVAUZM,34,5632
W2041,2,1/11/2022,QAB3FVFR87,100,5532
W2041,2,1/12/2022,QAC8HJD6KS,117,5415
W2041,2,1/17/2022,QAH1PVKESN,100,5315
W2041,2,1/17/2022,QAH9PVPCZB,100,5215
W2041,2,1/18/2022,QAI3RHF47N,100,5115
W2041,2,1/18/2022,QAI6RHI4MS,100,5015
W2041,2,1/18/2022,QAI8RHMCAU,34,4981
W2041,2,1/18/2022,QAI4S6TJT8,300,4681
W2041,2,1/19/2022,QAJ7TEVQTX,1000,3681
W2041,2,1/20/2022,QAK6UW1OFO,100,3581
W2041,2,1/20/2022,QAK4UW6RKO,100,3481
W2041,2,1/20/2022,QAK5UWCJQV,17,3464
W2041,2,1/21/2022,QAL9WGCNPV,100,3364
W2041,2,1/21/2022,QAL9WGFDFX,100,3264
W2041,2,1/21/2022,QAL6WGHBYQ,17,3247
W2041,2,1/25/2022,QAP34HXNTH,100,3147
W2041,2,1/25/2022,QAP24I1JQY,100,3047
W2041,2,1/25/2022,QAP64I6VYS,17,3030
W2041,2,1/26/2022,QAQ05VF9Y6,100,2930
W2041,2,1/26/2022,QAQ65VPOHY,100,2830
W2041,2,1/26/2022,QAQ75VTCHD,17,2813
W2041,2,1/27/2022,QAS1996PJD,100,2713
W2041,2,1/27/2022,QAS29998PW,100,2613
W2041,2,1/27/2022,QAS399BLUX,17,2596
W2041,2,1/31/2022,QAV9ESW6V3,1000,1596
W2041,2,2/1/2022,QB17HVSDWV,17,1579
W2041,2,2/1/2022,QB19HUZ27X,100,1479
W2041,2,2/1/2022,QB17HUU02D,100,1379
W2041,2,2/2/2022,QB22JSN71Y,1470,91
W2041,3,2/7/2022,QB74RIRHSW,100,6400
W2041,3,2/7/2022,QB77RIUF4D,100,6300
W2041,3,2/7/2022,QB79RIXBZ5,17,6283
W2041,3,2/8/2022,QB84TCI190,100,6183
W2041,3,2/8/2022,QB89TCLRSH,100,6083
W2041,3,2/8/2022,QB80TCQW5Q,17,6066
W2041,3,2/8/2022,QB97V5OSSV,100,5966
W2041,3,2/8/2022,QB99V5UP9T,100,5866
W2041,3,2/8/2022,QB98V5Z2E6,17,5849
W2041,3,2/16/2022,QBG49JCO82,1000,4849
W2041,3,2/21/2022,QBL5I3C6AV,100,4749
W2041,3,2/21/2022,QBL9I3EJN7,100,4649
W2041,3,2/21/2022,QBL6I3K2JE,17,4632
W2041,3,2/23/2022,QBN5LJX46H,100,4532
W2041,3,2/23/2022,QBN7LK0AAB,100,4432
W2041,3,2/23/2022,QBN2LK5I0S,17,4415
W2041,3,2/25/2022,QBP6PL87YQ,500,3915
W2041,3,3/3/2022,QC3529U9K5,3915,0
W2041,4,3/9/2022,QC93FCY34F,100,6400
W2041,4,3/9/2022,QC94FCZW6O,100,6300
W2041,4,3/9/2022,QC96FD3104,17,6283
W2041,4,3/16/2022,QCG9RM15JP,500,5783
W2041,4,3/23/2022,QCN366P1N7,100,5683
W2041,4,3/23/2022,QCN866UBXC,100,5583
W2041,4,3/23/2022,QCN36759MJ,17,5566
W2041,4,3/28/2022,QCS4FZLMJW,100,5466
W2041,4,3/28/2022,QCS9FZN1RN,100,5366
W2041,4,3/28/2022,QCS6FZS0L2,17,5349
W2041,4,3/29/2022,QCT4HSQALW,100,5249
W2041,4,3/29/2022,QCT2HSVNQW,100,5149
W2041,4,3/29/2022,QCT4HT2C5O,17,5132
W2041,4,3/30/2022,QCU1IWUIC1,5132,0
W2041,5,4/4/2022,QD45S2ZZHX,100,6400
W2041,5,4/4/2022,QD48S328LG,100,6300
W2041,5,4/4/2022,QD45S34L6N,17,6283
W2041,5,4/5/2022,QD59U0J0NH,100,6183
W2041,5,4/5/2022,QD50U0KGTA,100,6083
W2041,5,4/5/2022,QD59U0MS27,17,6066
W2041,5,4/7/2022,QD77YL0U6B,100,5966
W2041,5,4/7/2022,QD74YLESDO,100,5866
W2041,5,4/11/2022,QDB47A21JA,100,5766
W2041,5,4/11/2022,QDB07A59YK,100,5666
W2041,5,4/11/2022,QDB87ABARS,100,5566
W2041,5,4/13/2022,QDD7B1Q6DZ,100,5466
W2041,5,4/13/2022,QDD3B1VAIR,100,5366
W2041,5,4/13/2022,QDD1B23IBB,17,5349
W2041,5,4/20/2022,QDK3NUGK9P,500,4849
W2041,5,4/21/2022,QDL4R7IA8O,100,4749
W2041,5,4/21/2022,QDL2R7MSNU,100,4649
W2041,5,4/21/2022,QDL5R7O8LD,17,4632
W2041,5,4/23/2022,QDN1TG0HZJ,500,4132
W2041,5,4/26/2022,QDQ4Z0K8OC,100,4032
W2041,5,4/26/2022,QDQ1ZAT6TH,4032,0
W2041,6,5/4/2022,QE42EYDKI8,100,6400
W2041,6,5/4/2022,QE48EYGWOS,100,6300
W2041,6,5/4/2022,QE44EYLSXO,17,6283
W2041,6,5/9/2022,QE96OUJ2JC,100,6183
W2041,6,5/9/2022,QE97OUNAL9,100,6083
W2041,6,5/9/2022,QE93OUT3EX,17,6066
W2041,6,5/11/2022,QEB2SUYA14,100,5966
W2041,6,5/11/2022,QEB3SV0SHJ,100,5866
W2041,6,5/11/2022,QEB1SV590X,17,5849
W2041,6,5/11/2022,QEB4SVAEOW,100,5749
W2041,6,5/17/2022,QEH858QA72,100,5649
W2041,6,5/17/2022,QEH858U7US,100,5549
W2041,6,5/17/2022,QEH558Z7EL,17,5532
W2041,6,5/24/2022,QEO21JKB22,5500,32
W2041,6,5/24/2022,QEO4JTHGEE,32,0
W2041,7,7/2/2022,QG20RN0GLI,434,6016
W2041,7,7/13/2022,QGD7DJV8DN,100,5916
W2041,7,7/13/2022,QGD9DJY02L,100,5816
W2041,7,7/13/2022,QGD5DK7RHV,17,5799
W2041,7,7/21/2022,QGL3TJDNBN,100,5699
W2041,7,7/21/2022,QGL2TJH4FS,100,5599
W2041,7,7/21/2022,QGL3TJLVA3,17,5582
W2041,7,7/24/2022,QGO911OM8N,100,5482
W2041,7,7/24/2022,QGO613IYG4,100,5382
W2041,7,7/24/2022,QGO313QW65,17,5365
W2041,7,7/26/2022,QGQ94GPGDF,5365,0
W2041,8,8/19/2022,QHJ0G05NSI,400,6100
W2041,8,8/22/2022,QHM0LIZ8PI,500,5600
W2041,8,8/23/2022,QHN1NRE5NT,100,5500
W2041,8,8/23/2022,QHN4NRHDQ8,100,5400
W2041,8,8/23/2022,QHN7NRKDD1,17,5383
W2041,8,8/24/2022,QHO6P26L98,100,5283
W2041,8,8/24/2022,QHO0P279M0,100,5183
W2041,8,8/24/2022,QHO0P2828A,100,5083
W2041,8,8/24/2022,QHO1PLH4IV,5083,0
W2041,9,9/9/2022,QI94MY5B9S,100,6400
W2041,9,9/9/2022,QI98MY8H9I,100,6300
W2041,9,9/14/2022,QIE8XISVNK,100,6200
W2041,9,9/14/2022,QIE5XIVDUF,100,6100
W2041,9,9/14/2022,QIE4XJ15FQ,100,6000
W2041,9,9/19/2022,QIJ196E8S1,100,5900
W2041,9,9/19/2022,QIJ896I87K,100,5800
W2041,9,9/19/2022,QIJ696O1BA,17,5783
W2041,9,9/21/2022,QIL1E46G4H,5000,783
W2041,9,9/21/2022,QIL7E4BQ89,100,683
W2041,9,9/21/2022,QIL0E4ENBO,100,583
W2041,9,9/21/2022,QIL4E4OA7A,100,483
W2041,9,9/21/2022,QIL3E4TAOR,100,383
W2041,9,9/21/2022,QIL4E4Z1ZA,100,283
W2041,9,9/21/2022,QIL3E52M8H,100,183
W2041,9,9/21/2022,QIL1E5A9HB,100,83
W2041,9,9/21/2022,QIL5E6866P,83,0
W2041,10,10/11/2022,QJB5NN9K1T,100,6400
W2041,10,10/11/2022,QJB8NNDZ8Q,100,6300
W2041,10,10/11/2022,QJB2NNIXYG,17,6283
W2041,10,10/15/2022,QJF4YEHS1A,3000,3283
W2041,10,10/19/2022,QJJ074A9JG,3066,217
W2041,10,10/17/2022,QJH32GX0H5,100,117
W2041,10,10/17/2022,QJH92H1D15,100,17
W2041,10,10/17/2022,QJH02H78JM,17,0
W2041,11,10/28/2022,QJS0QRG1HI,100,6400
W2041,11,10/28/2022,QJS2QRKS6K,100,6300
W2041,11,10/28/2022,QJS6QROJQO,17,6283
W2041,11,11/7/2022,QK75F84WOH,100,6183
W2041,11,11/7/2022,QK71F85KFD,100,6083
W2041,11,11/16/2022,QKG71I6FB1,100,5983
W2041,11,11/16/2022,QKG31MMWHJ,100,5883
W2041,11,11/16/2022,QKG21MTAVE,100,5783
W2041,11,11/16/2022,QKG21N0D28,100,5683
W2041,11,11/16/2022,QKG11NB0B5,100,5583
W2041,11,11/17/2022,QKH8402UYS,5000,583
W2041,11,11/17/2022,QKH740E26B,100,483
W2041,11,11/17/2022,QKH240PH60,483,0
W2041,12,11/29/2022,QKT7WL1P0X,100,6400
W2041,12,11/30/2022,QKU3Y2ESX7,100,6300
W2041,12,11/30/2022,QKU3Y2Z03T,100,6200
W2041,12,12/5/2022,QL55FA6EE1,100,6100
W2041,12,12/5/2022,QL55FAG4BT,100,6000
W2041,12,12/5/2022,QL55FBI9QL,50,5950
W2041,12,12/9/2022,QL95R59QW1,100,5850
W2041,12,12/9/2022,QL93R5MF1X,90,5760
W2041,12,12/13/2022,QLD638U1CW,100,5660
W2041,12,12/13/2022,QLD13DFCP3,100,5560
W2041,12,12/13/2022,QLD23I7PQ8,100,5460
W2041,12,12/16/2022,QL95R59QW12,5460,0
W2041,13,1/14/2023,RAE4DDY56I,6500,0
W2041,14,2/11/2023,RBB8ESDOD6,6450,0
W2041,15,3/14/2023,RCE2QWPN5G,6800,0
W2041,16,4/12/2023,RDC6YZCY9W,6500,0
W2042,1,12/8/2021,PL87U1OE8P,3250,12550
W2042,1,12/22/2021,PLM3IA6RON,1000,11550
W2042,1,12/23/2021,PLN7L2P7F7,400,11150
W2042,1,12/28/2021,PLS8SF1Z04,1000,10150
W2042,1,12/29/2021,PLT8TU6BJ8,400,9750
W2042,1,12/30/2021,PLU8VMZTN8,500,9250
W2042,1,1/3/2022,QA362UGH10,500,8750
W2042,1,1/6/2022,QA607ANEME,500,8250
W2042,1,1/10/2022,QAA6F3NJ42,500,7750
W2042,1,1/21/2022,QAL5WUSG3B,1500,6250
W2042,1,1/21/2022,QAL7WYG4SX,1505,4745
W2042,1,1/25/2022,QAP94J1Y5B,700,4045
W2042,1,1/28/2022,QAS29KX3T8,500,3545
W2042,1,1/29/2022,QAT8BI8QYG,500,3045
W2042,1,3/3/2022,QB32KEARYW,3045,0
W2042,2,2/12/2022,QBC21HTD0W,600,5900
W2042,2,2/15/2022,QBF97JJAJ5,800,5100
W2042,2,3/7/2022,QC73A65ZS9,5100,0
W2042,3,3/25/2022,QCP08OZJSG,500,6000
W2042,3,3/28/2022,QCS7EK87OT,300,5700
W2042,3,3/29/2022,QCT3HCA4FZ,500,5200
W2042,3,3/30/2022,QCU5J12UO9,500,4700
W2042,3,3/31/2022,QCV5L5O74J,500,4200
W2042,3,3/31/2022,QCV6L8XU7C,500,3700
W2042,3,4/2/2022,QD25OEKN8L,400,3300
W2042,3,4/4/2022,QD46TE03FK,500,2800
W2042,3,4/5/2022,QD58UKGVJW,2800,0
W2042,3,4/5/2022,QD59U7ZTIF,200,200
W2042,4,4/27/2022,QDR11WYEE1,1000,5500
W2042,4,5/2/2022,QE28B3NVFK,1000,4500
W2042,4,5/3/2022,QE30EFDUC6,500,4000
W2042,4,5/4/2022,QE49FLHAS3,2460,1540
W2042,4,5/4/2022,QE42FM4F74,1450,90
W2042,4,5/4/2022,QE41FQ1OMN,280,190
W2042,4,5/4/2022,QE49G5B51L,90,280
W2042,5,5/30/2022,QEU0UZSPQG,6500,0
W2042,6,6/28/2022,QFS5I8HVND,6500,0
W2042,7,7/26/2022,QGQ352TQSX,6500,0
W2042,8,8/22/2022,QHM5LXATO3,1000,5800
W2042,8,8/23/2022,QHN6O05IPO,400,5400
W2042,8,8/24/2022,QHO0POIJFE,5100,300
W2042,8,8/24/2022,QHO3PRFI2L,300,0
W2043,1,12/7/2021,PL71QL3JBB,1625,5175
W2043,1,12/18/2021,PLI0BLKF3A,1625,3550
W2043,1,12/21/2021,PLL7HA2I1T,1625,1925
W2043,1,12/29/2021,PLT2TCQ7DA,1625,300
W2044,1,12/7/2021,PL75QM30W7,2275,7245
W2044,1,12/18/2021,PLI1B1WJNP,2275,4970
W2044,1,12/31/2021,PLV5WOUYFF,4550,420
W2045,1,12/8/2021,PL89U1UT6D,1625,4875
W2045,1,12/15/2021,PLF177513D,1625,3250
W2045,1,12/22/2021,PLM1J8QWXX,1625,1625
W2045,1,12/29/2021,PLT7TIOF83,1625,0
W2045,2,1/5/2022,QA5678ZQXC,1625,4425
W2045,2,1/12/2022,QAC1ITL6N9,1625,2800
W2045,2,1/17/2022,QAH0Q7SEVY,2800,0
W2045,3,1/23/2022,QAN025UW9C,1625,4175
W2045,3,1/26/2022,QAQ869GQF6,4175,0
W2045,4,2/2/2022,QB28JTL4M8,2200,7560
W2045,4,2/9/2022,QB90WPSM1W,2200,5360
W2045,4,2/14/2022,QBE75IEMSF,5360,0
W2045,5,2/20/2022,QBK5HRQQ7R,1000,8840
W2045,5,2/27/2022,QBR3UD4Z6Z,1300,7540
W2045,5,3/6/2022,QC629HD7VA,2000,5540
W2045,5,3/7/2022,QC77AGM0X1,5540,0
W2045,6,3/14/2022,QCE3OY81B5,1000,9080
W2045,6,3/25/2022,QCP59I7X21,1000,8080
W2045,6,3/31/2022,QCV2L2PUX6,8000,80
W2045,6,3/31/2022,QCV5LAOC9T,80,0
W2045,7,4/21/2022,QDL2QFC914,9060,780
W2045,7,4/21/2022,QDL2QMRLMY,780,0
W2045,8,5/19/2022,QEJ59W369V,600,10280
W2045,8,5/20/2022,QEK7BT77TJ,10280,0
W2045,9,6/14/2022,QFE9PJQ8H9,10400,0
W2045,10,7/8/2022,QG863SLNYM,10160,0
W2046,1,12/9/2021,PL97VS0WW9,522,4678
W2046,1,,,,4678
W2046,1,,,,4678
W2046,1,12/7/2021,PL78S4W9QY,100,4578
W2046,1,12/7/2021,PL77S57MG9,74,4504
W2046,1,12/6/2021,PL65QBJETV,100,4404
W2046,1,12/6/2021,PL62QBLR0W,74,4330
W2046,1,12/5/2021,PL58N3MGW2,100,4230
W2046,1,12/5/2021,PL50N3Q0QM,74,4156
W2046,1,12/3/2021,PL37JH6BMR,174,3982
W2046,1,12/11/2021,PLB0XQTM8C,100,3882
W2046,1,12/11/2021,PLB0XQVHN0,100,3782
W2046,1,12/12/2021,PLC2ZN6UKS,100,3682
W2046,1,12/12/2021,PLC3ZNNNQN,50,3632
W2046,1,12/12/2021,PLC822Q2FQ,100,3532
W2046,1,12/12/2021,PLC022R5JA,74,3458
W2046,1,12/14/2021,PLE43ZRP7M,100,3358
W2046,1,12/14/2021,PLE13ZWN8Z,74,3284
W2046,1,12/14/2021,PLE654U9EO,100,3184
W2046,1,12/14/2021,PLE7553EF5,74,3110
W2046,1,12/15/2021,PLF17725B9,74,3036
W2046,1,12/15/2021,PLF57514KX,100,2936
W2046,1,12/18/2021,PLI5AU8PWZ,100,2836
W2046,1,12/18/2021,PLI2AUFBHY,100,2736
W2046,1,12/18/2021,PLI1AUIXWX,100,2636
W2046,1,12/18/2021,PLI3AUTM9N,48,2588
W2046,1,12/19/2021,PLJ4COAXU0,100,2488
W2046,1,12/19/2021,PLJ4CODS66,74,2414
W2046,1,12/19/2021,PLJ9E1RNSV,100,2314
W2046,1,12/20/2021,PLK6EJUUUS,74,2240
W2046,1,12/22/2021,PLM4HNQ6CA,100,2140
W2046,1,12/22/2021,PLM4HNUX4C,100,2040
W2046,1,12/22/2021,PLM9HNZMQB,48,1992
W2046,1,12/22/2021,PLM5J81ZAR,100,1892
W2046,1,12/22/2021,PLM7J82TSV,100,1792
W2046,1,12/22/2021,PLM8J86W5I,74,1718
W2046,1,12/23/2021,PLO3L37RP5,90,1628
W2046,1,12/25/2021,PLP6O8DWW2,100,1528
W2046,1,12/25/2021,PLP4O9S96S,100,1428
W2046,1,12/26/2021,PLQ9PDXL2F,100,1328
W2046,1,12/27/2021,PLR3QAUKMP,100,1228
W2046,1,12/27/2021,PLR2QB235U,100,1128
W2046,1,12/27/2021,PLR6QBOCR6,100,1028
W2046,1,12/27/2021,PLR1QCX84X,100,928
W2046,1,12/28/2021,PLS6S1GIYE,260,668
W2046,1,12/29/2021,PLT6TFYQ66,100,568
W2046,1,12/29/2021,PLT7TH06Z5,100,468
W2046,1,12/29/2021,PLT7UNNUS3,23,445
W2046,1,12/30/2021,PLU5WDPB45,100,345
W2046,1,12/30/2021,PLU2WDT382,100,245
W2046,1,12/30/2021,PLU1WDVFJB,100,145
W2046,1,12/30/2021,PLU3WDX73P,45,100
W2046,1,2/7/2022,QB72RLF2UW,100,0
W2046,2,2/9/2022,QB97VLJE9N,400,4800
W2046,2,2/10/2022,QBA8XB2AAM,100,4700
W2046,2,2/11/2022,QBB7YOAOX7,100,4600
W2046,2,2/11/2022,QBB1YZKZ39,100,4500
W2046,2,2/11/2022,QBB5YZV2VH,100,4400
W2046,2,2/12/2022,QBC6298VWY,100,4300
W2046,2,2/12/2022,QBC929IJFL,100,4200
W2046,2,2/16/2022,QBG6AI5ZTY,600,3600
W2046,2,2/21/2022,QBL1I76RIP,600,3000
W2046,2,2/22/2022,QBM6JTP17A,100,2900
W2046,2,2/22/2022,QBM9JTT90X,100,2800
W2046,2,3/1/2022,QC10XL9K2U,1200,1600
W2046,2,3/2/2022,QC201EU2W6,100,1500
W2046,2,3/2/2022,QC211ER6YT,100,1400
W2046,2,3/7/2022,QC779M42PP,1400,0
W2046,3,3/15/2022,QCF6PS9ME8,1300,3900
W2046,3,3/26/2022,QCQ9AOYG73,3200,700
W2046,3,3/28/2022,QCS3EBUZ8F,700,0
W2046,4,4/8/2022,QD8931PJTH,100,5340
W2046,4,4/8/2022,QD8031TOX0,100,5240
W2046,4,4/8/2022,QD8531WPSL,100,5140
W2046,4,4/8/2022,QD8731Y8C9,1000,4140
W2046,4,4/13/2022,QDD0B9YCXQ,100,4040
W2046,4,4/13/2022,QDD7BA28PV,100,3940
W2046,4,4/13/2022,QDD1BA77WT,100,3840
W2046,4,4/24/2022,QDO8WOAOK8,450,3390
W2046,4,4/27/2022,QDR93H4AY1,530,2860
W2046,4,4/28/2022,QDS74MTEKX,280,2580
W2046,4,4/30/2022,QDU37D9ULD,580,2000
W2046,4,4/30/2022,QDU37Y0XTP,2000,0
W2046,5,5/2/2022,QE20BCYNQY,100,5340
W2046,5,5/2/2022,QE21BD24YH,75,5265
W2046,5,5/9/2022,QE94OJNE8G,740,4525
W2046,5,5/14/2022,QEE31BV0YL,350,4175
W2046,5,5/23/2022,QEN4IAABSW,1100,3075
W2046,5,05/26/2022,QEQ1O1LYZB,1300,1775
W2046,5,5/28/2022,QES7QEL6LT,800,975
W2046,5,5/30/2022,QEU5V3EPRZ,700,275
W2046,5,5/30/2022,QEU4V57K4C,40,235
W2046,5,6/2/2022,QF241EOCL2,240,5
W2046,6,7/1/2022,QG11NIWP2V,3200,2000
W2046,6,7/4/2022,QG41USUJJZ,2000,0
W2046,7,12/10/2022,QLA0VTDIMM,800,4400
W2046,7,1/4/2023,RA40O59GXS,4400,0
W2046,8,1/5/2023,RA51RQ4JV9,100,4700
W2046,8,1/5/2023,RA55RQ84DH,74,4626
W2046,8,1/8/2023,RA86X1HHF8,100,4526
W2046,8,1/8/2023,RA80X1XEV8,74,4452
W2046,8,1/11/2023,RAB37G5YOR,100,4352
W2046,8,1/23/2023,RAN5Z774ZR,4352,0
W2046,9,2/3/2023,RB31SXZ7PX,175,5025
W2046,9,2/22/2023,RBM78N7NPL,1000,4025
W2046,9,2/22/2023,RBM48QQFEU,4025,0
W2046,10,3/23/2023,RCN0GB1YLC,5200,0
W2046,11,3/26/2023,RCQ7NFQF9J,400,4760
W2046,11,4/3/2023,RD36C6MGRS,100,4660
W2046,11,4/5/2023,RD68HWXUO2,100,4560
W2046,11,4/19/2023,RDJ9IJUD2R,4560,0
W2046,12,7/7/2023,RG78Y60DA0,5200,0
W2046,13,7/31/2023,RGV1ULH5K3,6500,0
W2047,1,2/14/2022,QBE65M9FPU,13000,0
W2047,2,3/10/2022,QCA4G9HZV6,12600,0
W2047,3,4/8/2022,QD812S41S3,9500,4100
W2047,3,4/10/2022,QDA36QYOXP,3500,600
W2047,3,4/11/2022,QDB379FNTZ,600,0
W2048,1,2/14/2022,QBE25PL10A,13000,0
W2048,2,3/17/2022,QCH0SZXG6W,13600,0
W2048,3,4/14/2022,QDE2DJG1QM,13000,0
W2048,4,5/14/2022,QEE0YSV098,13000,600
W2048,4,5/14/2022,QEE3YWE23X,600,0
W2048,5,6/14/2022,QFE9P9D0R5,13600,0
W2048,6,7/21/2022,QGL0U6TLVS,2000,13800
W2048,6,7/23/2022,QGN4XDERDE,500,13300
W2048,6,8/25/2022,QHP0R29CB4,1300,12000
W2049,1,1/23/2022,QAN6271G9G,608,8492
W2049,1,1/24/2022,QAO63VB4CK,400,8092
W2049,1,1/25/2022,QAP45KYC8U,336,7756
W2049,1,1/26/2022,QAQ76MRKR5,304,7452
W2049,1,1/27/2022,QAR28YCFQW,304,7148
W2049,1,1/28/2022,QAS49YLNAM,304,6844
W2049,1,1/30/2022,QAU7EAWVK5,304,6540
W2049,1,1/31/2022,QAV8ES3JB8,304,6236
W2049,1,2/3/2022,QB33K7LWWL,304,5932
W2049,1,2/4/2022,QB47MD20Z5,304,5628
W2049,1,2/6/2022,QB61R33QLL,304,5324
W2049,1,2/8/2022,QB89T69NYX,304,5020
W2049,1,2/10/2022,QBA9YJBR6R,1000,4020
W2049,1,2/14/2022,QBE55TAXUN,4020,0
W2049,2,2/23/2022,QBN9LT2YYT,304,8512
W2049,2,2/26/2022,QBQ6R7EU7G,304,8208
W2049,2,3/2/2022,QC28ZFGUPW,500,7708
W2049,2,3/4/2022,QC454PI9AT,304,7404
W2049,2,3/5/2022,QC50710D90,304,7100
W2049,2,3/8/2022,QC83C4XX3D,7100,0
W2049,3,3/18/2022,QCI6UQX5I4,400,7790
W2049,3,3/19/2022,QCJ6WZ27ZA,304,7486
W2049,3,3/21/2022,QCL31NSYP7,304,7182
W2049,3,3/24/2022,QCO681LOFW,7182,0
W2049,4,4/2/2022,QD22PFDN9W,1000,10700
W2049,4,4/9/2022,QD973J1SQZ,390,10310
W2049,4,4/11/2022,QDB07F9072,10310,0
W2049,5,4/24/2022,QDO8WM96HC,400,10620
W2049,5,4/28/2022,QDS14KPV8,10620,0
W2049,6,5/21/2022,QEL1DA6IHR,11070,0
W2049,7,6/15/2022,QFF6RJSPB6,11250,180
W2049,7,6/15/2022,QFF6S1O56M,180,0
W2049,8,7/12/2022,QGC5COXNCB,15600,0
W2049,9,8/11/2022,QHB51JC0V7,16320,0
W2050,1,1/21/2022,QAL3X3OBND,434,6066
W2050,1,1/27/2022,QAR47WQR9S,500,5566
W2050,1,1/27/2022,QAR0908L3E,500,5066
W2050,1,1/28/2022,QAT1COT5PB,217,4849
W2050,1,1/29/2022,QAS49HVR3C,217,4632
W2050,1,2/1/2022,QB12H0B4AA,434,4198
W2050,1,2/4/2022,QB49NK1K5P,300,3898
W2050,1,2/7/2022,QB78RJ3D2O,651,3247
W2050,1,2/9/2022,QB91WLC55V,434,2813
W2050,1,2/12/2022,QBC01ZQYOU,1300,1513
W2050,1,2/14/2022,QBE05TL4LK,1513,0
W2050,2,2/18/2022,QBI3DB1Z1H,868,5490
W2050,2,2/28/2022,QBS7V6X7T1,500,4990
W2050,2,3/1/2022,QC12XMV7MM,500,4490
W2050,2,3/6/2022,QC679C6GHH,490,4000
W2050,2,3/7/2022,QC74B205OM,400,3600
W2050,2,3/8/2022,QC80CPL6II,3600,0
W2050,3,3/18/2022,QCI7V2GRZB,1650,4250
W2050,3,3/24/2022,QCO17B473J,1650,2600
W2050,3,3/24/2022,QCO67YU2CG,2600,0
W2050,4,4/22/2022,QDM7RMZ3JV,4000,5520
W2050,4,4/22/2022,QDM4S33OGA,5520,0
W2050,5,5/11/2022,QEB4TPKEME,2500,7020
W2050,5,5/18/2022,QEI774BRS5,1000,6020
W2050,5,5/19/2022,QEJ7AMHXJ1,2000,4020
W2050,5,5/21/2022,QEL4D60H8K,1250,2770
W2050,5,5/21/2022,QEL7D9BEFF,2770,0
W2050,6,6/15/2022,QFF3S6ACWZ,8890,0
W2050,7,7/12/2022,QGC1CQB30T,9100,0
W2050,8,8/6/2022,QH62RIAVYM,8870,20
W2050,8,8/6/2022,QH63RIUKPN,20,0
W2050,9,9/23/2022,QIN2IIJVSI,2000,9060
W2050,9,9/26/2022,QIP2NISO6S,4500,4560
W2050,9,9/28/2022,QIS9SX03PF,2500,2060
W2050,9,9/29/2022,QIT5V6PHYH,100,1960
W2051,1,1/20/2022,QAK5VXP3GH,140,3760
W2051,1,1/24/2022,QAO83WCAOC,550,3210
W2051,1,1/28/2022,QAS2A005H0,650,2560
W2051,1,2/3/2022,QB38K0K3NM,550,2010
W2051,1,2/14/2022,QBE452XW1Q,2010,0
W2051,2,2/19/2022,QBJ7ECDH47,700,4040
D10139,1,6/11/2021,PFB7ZP80TP,"11250",50
D10139,2,6/25/2021,PFP1KNQS6N,"10000",1600
D10139,2,6/26/2021,PFQ5M43C3B,"1550",50
D10139,2,6/11/2021,PFB7ZP80TP2,50,0
D10139,3,7/27/2021,PGR7U7VCQL,"3500",2950
D10139,3,7/27/2021,PGR3U7Z37V,"3000",50
D10139,4,9/23/2021,PIN2B09H1O,"6400",50
D10139,4,7/27/2021,PGR3U7Z37V2,50,0
D10139,5,12/16/2021,PLG47O2MG8,"3630",0
D10139,6,1/13/2022,QAD9JD1TQ1,"6450",0
D10139,7,2/8/2022,QB87U8R5D9,"3250",0
D10139,8,3/3/2022,QC313A69ZN,"3200",
D10139,9,5/17/2022,QEH9635RU3,"3360",0
D10139,10,6/8/2022,QF85ENJUGN,"3630",0
D10139,11,12/13/2022,QLD42KNZO0,975,2715
D10139,11,12/20/2022,QLK6LT751S,975,1740
D10139,11,12/27/2022,QLR94MH0OR,"1740",0
D10139,12,1/5/2023,RA59Q60D09,"1300",3900
D10139,12,1/12/2023,RAC88OMPD6,"1300",2600
D10139,12,1/19/2023,RAJ4PZNI3K,"1300",1300
D10139,12,1/26/2022,RAQ97XMJH1,"1300",0
D10139,13,2/2/2023,RB24QJARU2,"1300",3900
D10139,13,2/9/2023,RBA3BIACN9,"1300",2600
D10139,13,2/16/2023,RBG7SJLZJF,"1300",1300
D10139,13,2/23/2023,RBN0B3QEWE,"1300",0
D10139,14,3/2/2023,RC21U4HWRL,"1300",3900
D10139,14,3/9/2023,RC99CWJUZV,"1300",2600
D10139,14,3/17/2023,RCH3YHUVFB,"1300",1300
D10139,14,3/23/2023,RCN2G3E0S6,"1300",0
D10139,15,3/30/2023,RCU9YTIAYJ,"1300",3900
D10139,15,4/6/2023,RD67JMAOMP,"1300",2600
D10139,15,4/13/2023,RDD235ZRCK,"1300",1300
D10139,15,4/20/2023,RDK0LVZKBW,"1300",0
D10139,16,4/27/2023,RDR368CJRB,"1300",3660
D10139,16,5/4/2023,RE44PFH0WA,"1300",2360
D10139,16,5/11/2023,REB3AJR7D7,"2360",0
D10139,17,5/18/2023,REI8U3B3AQ,"1300",3900
D10139,17,5/26/2023,REQ2FX835S,"1300",2600
D10139,17,6/5/2023,RF589BWYU2,"1300",1300
D10139,17,6/7/2023,RF73HBIPBB,"1300",0
D10139,18,6/16/2023,RFG268W7OK,"1300",4140
D10139,18,6/23/2023,RFN3QP9G11,"1300",2840
D10139,18,7/1/2023,RG15EITKSL,"1300",1540
D10139,18,7/10/2023,RGA15WZPKJ,"1300",240
D10139,19,7/18/2023,RGI6T5PE6W,"1300",3900
D10139,19,7/25/2023,RGP3DICUPP,"1300",2600
D10139,19,8/4/2023,RH4279NFRQ,"1300",1300
D10139,19,8/7/2023,RH77H4JZ1L,"1300",0
W2052,1,2/1/2022,QB10GLX3FC,1600,9280
W2052,1,2/4/2022,QB41M5QJ7H,1000,8280
W2052,1,2/16/2022,QBG0AHYT4G,4100,4180
W2052,1,2/17/2022,QBH0CE6VCU,4180,0
W2052,2,3/17/2022,QCH2TFCJWU,10400,0
W2052,3,4/21/2022,QDL9QJ6GDJ,10880,0
W2053,1,1/29/2022,QAT6BKYJ8O,"1000",5500
W2053,1,2/5/2022,QB52O9LT9A,"1000",4500
W2053,1,1/15/2022,QBF97NZUC7,"4500",0
W2053,2,2/24/2022,QBO9O0CR6P,"1625",4575
W2053,2,3/4/2022,QC4446U5W2,"2000",2575
W2053,2,3/14/2022,QCE9NZ1GJZ,"2175",400
W2053,2,3/15/2022,QCF6PWOQC2,400,0
W2053,3,3/30/2022,QCU9IZ5L1T,"1650",4850
W2053,3,4/16/2022,QDG4H58FOA,"4850",0
W2053,4,5/7/2022,QE76L9JPZM,"2300",4200
W2053,4,5/11/2022,QEB1TQNATT,250,3950
W2053,4,5/13/2022,QED2WJOLOM,3950,0
W2053,5,6/5/2022,QF568OAIZQ,"2000",4800
W2053,5,6/11/2022,QFB1KZXV8J,"4500",300
W2053,5,6/13/2022,QFD6NHTFIE,300,0
W2053,6,7/21/2022,QGL9U8ZOFR,"1500",5300
W2053,6,7/22/2022,QGM2X1H65A,"5300",0
W2054,1,1/31/2022,QAV6FRCZWU,"3250",9350
W2054,1,2/8/2022,QB83T73U8L,"3250",6100
W2054,1,2/14/2022,QBE66IO67A,"3250",2850
W2054,1,2/16/2022,QBG29G6RX6,"2850",0
W2054,2,2/22/2022,QBM4KGNG6I,"3250",8750
W2054,2,3/1/2022,QC15X1OR9V,"8750",0
W2054,3,3/21/2022,QCL61EUWOA,"1000",18500
W2054,3,3/23/2022,QCN35ZOHHP,"2000",16500
W2054,3,3/28/2022,QCS6E91G2E,"3000",13500
W2054,3,3/29/2022,QCT4GIY1HS,13500,0
W2054,4,4/12/2022,QDC490953I,"2000",21700
W2054,4,7/20/2022,QGK1RLSJLP,"1000",20700
W2054,4,7/23/2022,QGN1XQGHQD,"1000",19700
W2055,1,2/3/2022,QB30JVBH4S,"1000",13600
W2055,1,2/3/2022,QB37LOQ2JF,"1600",12000
W2055,1,2/7/2022,QB71RJDYCL,650,11350
W2055,1,2/9/2022,QB99WQ30XP,600,10750
W2055,1,2/10/2022,QBA1YJQ1GP,1200,9550
W2055,1,2/16/2022,QBG68ZAYFO,1000,8550
W2055,1,2/24/2022,QBO8OTO196,950,7600
W2055,1,2/28/2023,QBS7UMTSV,1000,6600
W2055,1,3/2/2022,QC25Z1VACB,1000,5600
W2055,1,3/7/2022,QC709R8IZI,1000,4600
W2055,1,4/8/2022,QD82127YEY,800,3800
W2055,1,4/25/2022,QDP5X6TEYT,3000,800
W2055,1,4/26/2022,QDQ7YZOIZL,800,0
W2056,1,2/2/2022,QB24IQC2LU,"2000",5550
W2056,1,2/9/2022,QB95W4JOND,"2000",3550
W2056,1,2/15/2022,QBF27IYBLG,"3550",0
W2056,2,2/22/2022,QBM8L9LO4Y,"1700",6460
W2056,2,2/26/2022,QBQ6RSYW8M,100,6360
W2056,2,2/26/2022,QBQ8RT506G,50,6310
W2056,2,2/26/2022,QBQ5RVX71L,100,6210
W2056,2,3/4/2022,QC415DY9QJ,1950,4260
W2056,2,3/11/2022,QCB1J1FJJ3,1000,3260
W2056,2,3/15/2022,QCF2PS1M6A,1200,2060
W2056,2,3/16/2022,QCG9SOC20X,1500,560
W2056,2,3/19/2022,QCJ3YE47JZ,100,460
W2056,2,3/19/2022,QCJ3YE83DV,100,360
W2056,2,3/19/2022,QCJ7YEBASF,100,260
W2056,2,3/22/2022,QCM7HH07T,100,160
W2056,2,3/22/2022,QCM03HKA3W,60,100
W2056,2,3/22/2022,QCM63HNIBY,100,0
W2056,3,3/31/2022,QCV2L884DI,"2000",6160
W2056,3,4/7/2022,QD76Z2YEZ6,"1900",4260
W2056,3,4/14/2022,QDE2EBK476,"1550",2710
W2056,3,4/18/2022,QDI4LJQF8A,100,2610
W2056,3,4/18/2022,QDI4LJYIGQ,100,2510
W2056,3,4/18/2022,QDI0LK3YE8,100,2410
W2056,3,4/18/2022,QDI2LK8WMO,100,2310
W2056,3,4/21/2022,QDL4R4S4VA,10,2300
W2056,3,4/21/2022,QDL4R4USBO,1000,1300
W2056,3,4/22/2022,QDM3S3E3IR,800,500
W2056,3,4/22/2022,QDM1STWXC7,140,360
W2056,3,4/24/2022,QDO2WPHMYM,100,260
W2056,3,4/26/2022,QDQ8YYC9F4,100,160
W2056,3,4/26/2022,QDQ3ZFVSJZ,100,60
W2056,3,4/26/2022,QDQ0ZFY7L8,60,0
W2056,4,5/6/2022,QE64KD5QFU,"1650",4850
W2056,4,5/18/2022,QEI28RH1W2,10,4840
W2056,4,5/18/2022,QEI68RMW4I,620,4220
W2056,4,5/19/2022,QEJ49KCNIC,1000,3220
W2056,4,5/26/2022,QEQ4NZM176,600,2620
W2056,4,5/28/2022,QES4QT97DU,1200,1420
W2056,4,5/28/2022,QES1R1WOMF,1420,0
W2056,5,6/30/2022,QFU5LY0QK9,"6400",0
W2056,6,7/25/2022,QGP62D5SFI,100,6400
W2056,6,7/25/2022,QGP62DCH84,"2000",4400
W2056,6,7/27/2022,QGR76Y9VNT,"4400",0
W2056,7,8/27/2022,QHR6VEARRW,"6450",850
W2056,7,8/27/2022,QHR0VH0K70,50,800
W2056,7,9/20/2022,QIK6BCE8M4,800,0
W2056,8,9/30/2022,QIU0Z8OS5A,"1500",5000
W2056,8,10/18/2022,QJI659OKJE,"5000",0
W2056,9,10/31/2022,QJV0XYN582,"1000",5500
W2056,9,11/15/2022,QKF9ZD2MTD,"5500",0
W2056,10,12/13/2022.,QLD22WCA1K,"6500",0
W2056,11,1/6/2023,RA65U4HR7F,500,6000
W2056,11,1/10/2023,RAA2301ARE,"6000",0
W2056,12,2/1/2023,RB13MZ9GT7,"1000",5500
W2056,12,2/6/2023,RB693EXF45,"1500",4000
W2056,12,2/7/2023,RB71465UJH,"4000",0
W2056,13,3/7/2023,RC748MDL46,"6500",0
W2056,14,3/25/2023,RCP0LJ28WS,400,6050
W2056,14,3/31/2023,RCV93WB5K3,"1600",4450
W2056,14,4/3/2023,RD38ASOI3A,"4450",0
W2056,15,4/25/2023,RDP51XXKFN,500,6000
W2056,15,4/26/2023,RDR04R4KXW,500,5500
W2056,15,5/1/2023,RE12GKURQS,"5500",0
W2056,16,5/30/2023,REU7QVQEOL,"6500",0
W2056,17,6/6/2023,RF68F0TNJW,"1000",5500
W2056,17,6/16/2023,RFG96S5Z4B,"5500",0
W2056,18,7/25/2023,RGP2FQLB04,500,6300
W2056,18,7/27/2023,RGR6JOIH0I,500,5800
W2056,18,7/30/2023,RGU0TYJFMG,500,5300
W2056,18,8/3/2023,RH3046FR0I,200,5100
W2056,18,8/3/2023,RH3473GC6U,100,5000
W2056,18,8/11/2023 2:30:08,RHB3SC6JET,200,4800
W2056,18,8/8/2023 23:02:55,RH89M5TSZP,100,4700
W2056,18,8/8/2023 23:01:14,RH87M5QYNH,100,4600
W2057,1,2/6/2022,QB65R7Q76R,"2300",6800
W2057,1,2/12/2022,QBC71IIMT9,500,6300
W2057,1,2/12/2022,QBC11ZLSIN,"6325",25
W2057,2,2/23/2022,QBN2LU9304,800,7800
W2057,2,2/28/2022,QBS6UVESM6,"1800",6000
W2057,2,3/1/2022,QC15Y090S9,500,5500
W2057,2,3/7/2022,QC719MBZV3,1500,4000
W2057,2,3/7/2022,QC75AGTHNZ,4000,0
W2057,3,3/17/2022,QCH3UJUPO5,400,9820
W2057,3,3/22/2022,QCM74MSCFB,500,9320
W2057,3,3/28/2022,QCS8ENZ5ME,550,8770
W2057,3,3/29/2022,QCT1H2DK7R,500,8270
W2057,3,4/1/2022,QD15M1NMYN,500,7770
W2057,3,4/4/2022,QD46TNP54K,700,7070
W2057,3,4/7/2022,QD77Z4RF0V,500,6570
W2057,3,4/14/2022,QDE2CS03MC,300,6270
W2057,3,4/16/2022,QDG8GTGPT8,350,5920
W2057,3,4/18/2022,QDI8L6ACNG,200,5720
W2057,3,4/18/2022,QDI9LHE8N1,150,5570
W2057,3,4/20/2022,QDK1P8ZJ9F,350,5220
W2057,3,4/25/2022,QDP0YCCF20,400,4820
W2057,3,4/30/2022,QDU07K7TXE,300,4520
W2059,1,2/3/2022,QB36LO9DBS,350,10050
W2059,1,2/4/2022,QB47NKSXM1,350,9700
W2059,1,2/5/2022,QB60R6Z8HW,350,9350
W2059,1,2/6/2022,QB51PHT0G9,350,9000
W2059,1,2/7/2022,QB71T1QMNF,350,8650
W2059,1,2/8/2022,QB81UV2805,350,8300
W2059,1,2/9/2022,QB99WQJVWJ,350,7950
W2059,1,2/10/2022,QBA8YLMAF6,350,7600
W2059,1,2/11/2022,QBB01H91PW,100,7500
W2059,1,2/11/2022,QBB51HA9W1,100,7400
W2059,1,2/11/2022,QBB21HFF68,100,7300
W2059,1,2/11/2022,QBB11HFPT9,50,7250
W2059,1,2/13/2022,QBD650WXLA,600,6650
W2059,1,2/14/2022,QBE76VM2JH,100,6550
W2059,1,2/14/2022,QBE56VNKJ1,100,6450
W2059,1,2/14/2022,QBE46VOFH6,100,6350
W2059,1,2/15/2022,QBF18PD7ML,100,6250
W2059,1,2/15/2022,QBF78PEDCP,100,6150
W2059,1,2/15/2022,QBF98PFI7V,70,6080
W2059,1,2/15/2022,QBF28PGYCM,80,6000
W2059,1,2/16/2022,QBG5AIN3GF,100,5900
W2059,1,2/16/2022,QBG1AION1P,100,5800
W2059,1,2/16/2022,QBG4AIPKBU,100,5700
W2059,1,2/16/2022,QBG7AIRHEB,50,5650
W2059,1,2/17/2022,QBH7CDXKTZ,100,5550
W2059,1,2/17/2022,QBH6CDYN4U,100,5450
W2059,1,2/17/2022,QBH0CDZKXC,100,5350
W2059,1,2/21/2022,QBL8IMCVLO,5350,0
W2059,2,2/22/2022,QBM3LBF2HR,350,8850
W2059,2,2/26/2022,QBQ2R1JWLC,"1050",7800
W2059,2,2/28/2022,QBS8UGCGWM,350,7450
W2059,2,2/28/2022,QBS5WAY045,350,7100
W2059,2,3/1/2022,QC11YBW51D,100,7000
W2059,2,3/1/2022,QC18YC06EC,100,6900
W2059,2,3/1/2022,QC13YC36XP,100,6800
W2059,2,3/4/2022,QC443MVPSA,700,6100
W2059,2,3/4/2022,QC425KL3T4,300,5800
W2059,2,3/7/2022,QC76AHCI8G,5800,0
W2059,3,3/8/2022,QC81DF567Z,350,10050
W2059,3,3/9/2022,QC97FE6RUP,100,9950
W2059,3,3/9/2022,QC96FE9V7K,100,9850
W2059,3,3/9/2022,QC91FEBSAX,100,9750
W2059,3,3/9/2022,QC92FECCLI,50,9700
W2059,3,3/12/2022,QCC6JC5RV2,350,9350
W2059,3,3/13/2022,QCD1N0H0DD,100,9250
W2059,3,3/13/2022,QCD6N0J41E,100,9150
W2059,3,3/13/2022,QCD2N0QQES,100,9050
W2059,3,3/13/2022,QCD6N0SB7W,100,8950
W2059,3,3/14/2022,QCE6OWOBTG,100,8850
W2059,3,3/15/2022,QCF3QSVLEN,100,8750
W2059,3,3/15/2022,QCF6QSWVCW,100,8650
W2059,3,3/15/2022,QCF9QSZ8VV,100,8550
W2059,3,3/15/2022,QCF2QT17P4,50,8500
W2059,3,3/16/2022,QCG8SOKHTK,100,8400
W2059,3,3/16/2022,QCG2SOMG8Y,100,8300
W2059,3,3/16/2022,QCG6SOP2JS,100,8200
W2059,3,3/17/2022,QCH2ULJNHM,100,8100
W2059,3,3/17/2022,QCH9ULMEKH,100,8000
W2059,3,3/18/2022,QCI1WIHE9L,100,7900
W2059,3,3/19/2022,QCJ3WO53F9,200,7700
W2059,3,3/20/2022,QCK514WOH7,200,7500
W2059,3,3/22/2022,QCM443OU30,7500,0
W2059,4,3/26/2022,QCQ2CEZ0UG,100,10300
W2059,4,3/26/2022,QCQ7CF1QIF,100,10200
W2059,4,3/26/2022,QCQ0CF4FNQ,100,10100
W2059,4,3/27/2022,QCR1E0W37F,100,10000
W2059,4,3/27/2022,QCR3E0Z9EV,100,9900
W2059,4,3/27/2022,QCR5E11VHL,100,9800
W2059,4,3/29/2022,QCT8HWFFS6,100,9700
W2059,4,3/29/2022,QCT5HWGUTL,100,9600
W2059,4,3/29/2022,QCT2HWIAKK,100,9500
W2059,4,3/29/2022,QCT4HWM12A,100,9400
W2059,4,3/30/2022,QCU9JVOOFL,100,9300
W2059,4,3/30/2022,QCU7JVPDO5,100,9200
W2059,4,3/30/2022,QCU3JVQUXJ,100,9100
W2059,4,3/30/2022,QCU1JVS7TR,50,9050
W2059,4,3/31/2022,QCV0KUR8Y6,260,8790
W2059,4,3/31/2022,QCV1LV6RM9,100,8690
W2059,4,3/31/2022,QCV6LV8TRA,100,8590
W2059,4,4/1/2022,QD19O02GLV,100,8490
W2059,4,4/2/2022,QD26O6EH64,100,8390
W2059,4,4/3/2022,QD37RUW9TZ,100,8290
W2059,4,4/3/2022,QD31RUY6EZ,100,8190
W2059,4,4/3/2022,QD35RV18YT,100,8090
W2059,4,4/3/2022,QD32RV310A,100,7990
W2059,4,4/4/2022,QD41TX69AT,100,7890
W2059,4,4/4/2022,QD41TX7SBD,100,7790
W2059,4,4/4/2022,QD45TX8PF5,100,7690
W2059,4,4/5/2022,QD54VX5GIG,100,7590
W2059,4,4/5/2022,QD59VX8435,100,7490
W2059,4,4/5/2022,QD59VXA69F,80,7410
W2059,4,4/6/2022,QD65XZ0BQ5,100,7310
W2059,4,4/6/2022,QD65XZ2DKR,100,7210
W2059,4,4/6/2022,QD60XZ4GPW,100,7110
W2059,4,4/7/2022,QD7910MZGF,100,7010
W2059,4,4/7/2022,QD7710O6H9,100,6910
W2059,4,4/7/2022,QD7210SU3A,100,6810
W2059,4,4/8/2022,QD8432LO5Y,100,6710
W2059,4,4/8/2022,QD8932M2JL,100,6610
W2059,4,4/8/2022,QD8732NPJF,100,6510
W2059,4,4/10/2022,QDA16UI7P5,100,6410
W2059,4,4/10/2022,QDA36ULYLB,100,6310
W2059,4,4/10/2022,QDA36UOOCR,100,6210
W2059,4,4/10/2022,QDA16UQXN3,50,6160
W2059,4,4/11/2022,QDB38U384F,100,6060
W2059,4,4/11/2022,QDB78U577F,100,5960
W2059,4,4/11/2022,QDB48U6IKW,100,5860
W2059,4,4/11/2022,QDB58UC2A3,50,5810
W2059,4,4/12/2022,QDC6AQETKC,100,5710
W2059,4,4/12/2022,QDC2AQFWXG,100,5610
W2059,4,4/12/2022,QDC3ARDKK3,100,5510
W2059,4,4/13/2022,QDD6CNVGHC,100,5410
W2059,4,4/14/2022,QDE2CRM3N0,100,5310
W2059,4,4/15/2022,QDF3GI1TQ3,100,5210
W2059,4,4/15/2022,QDF6GI36TY,100,5110
W2059,4,4/15/2022,QDF1GI46DT,100,5010
W2059,4,4/15/2022,QDF6GI59NU,50,4960
W2059,4,4/16/2022,QDG6IBWTF6,750,4210
W2059,4,4/17/2022,QDH1JX3K6Z,100,4110
W2059,4,4/17/2022,QDH5JX4PLD,100,4010
W2059,4,4/17/2022,QDH7JX6Q7B,10,4000
W2059,4,4/18/2022,QDI2LO7SRA,100,3900
W2059,4,4/18/2022,QDI0LO9330,100,3800
W2059,4,4/18/2022,QDI9LOAMIJ,100,3700
W2059,4,4/18/2022,QDI4LOC6RO,100,3600
W2059,4,4/20/2022,QDK7NZKIS3,3600,0
W2059,5,4/29/2022,QDT477YQ8W,"3000",9600
W2059,5,5/1/2022,QE12AWO1FK,100,9500
W2059,5,5/1/2022,QE14AWRVC2,50,9450
W2059,5,5/4/2022,QE43EO0N61,100,9350
W2059,5,05/08/2022,QE83OI0MQ3,3000,6350
W2059,5,5/13/2022,QED5WTHUZ7,6350,0
W2059,6,5/22/2022,QEM6G9CP22,"3000",10000
W2059,6,5/31/2022,QEV0W34L1O,"3000",7000
W2059,6,6/9/2022,QF98FHMC3O,"7000",0
W2059,7,7/6/2022,QG67YGRNTX,"12900",0
W2059,8,8/1/2022,QH11GI1PL5,"13000",0
W2060,1,2/7/2022,QB78SKH2Q0,"3250",9750
W2060,1,2/22/2022,QBM5JYG7EF,"6500",3250
W2060,1,2/23/2022,QBN0MUGYZS,500,2750
W2060,1,2/24/2022,QBO7OMC8TH,500,2250
W2060,1,2/26/2022,QBQ9R2NTN5,1800,450
W2060,1,2/27/2022,QBR6U914OI,450,0
W2060,2,3/27/2022,QCR2DWA85E,"3250",9750
W2060,2,4/3/2022,QD30RVD6U8,"3250",6500
W2060,2,4/10/2022,QDA46UZJWM,"3250",3250
W2060,2,4/11/2022,QDB78T0EQZ,3250,0
W2060,3,5/3/2022,QE39ECSTSD,"15000",4500
W2060,3,5/8/2022,QE82OC05WE,"4500",0
W2060,4,5/20/2022,QEK8B74C9A,"10000",8600
W2060,4,5/27/2022,QER4OHE144,"6000",2600
W2060,4,5/31/2022,QEV0X1ILT8,"2600",0
W2060,5,6/19/2022,QFJ61EPTHU,"15200",3100
W2060,5,6/20/2022,QFK92O4F7R,"3100",0
W2060,6,7/13/2022,QGD5DDS687,"10000",15000
W2060,6,7/13/2022,QGD6DNGELY,"10000",5000
W2060,6,7/14/2022,QGE3GN14AT,"5000",0
W2060,7,8/6/2022,QH65QZKTOB,"25000",0
W2060,8,9/7/2022,QI74K86GVI,"26000",0
W2060,9,9/29/2022,QIT7UXB9LN,"17000",15000
W2060,9,9/30/2022,QIU5Z5D6PL,"7000",8000
W2060,9,10/1/2022,QJ172KWE1N,"1000",7000
W2060,9,10/3/2022,QJ3359YG13,3000,4000
W2060,9,10/4/2022,QJ407SZSPM,4000,0
W2060,10,10/28/2022,QJS9SRCC7N,"31500",0
W2060,11,11/16/2022,QKG52958DD,"30250",0
W2060,12,12/14/2022,QLE75KOFNP,"32500",0
W2060,13,1/1/2023,RA10HONXH6,"1000",39800
W2060,13,1/11/2023,RAB673NTAO,"6000",33800
W2060,13,1/13/2022,RAD2B3U7VO,"33800",0
W2060,14,2/2/2023,RB25RFZ54J,"36600",0
W2060,15,3/3/2023,RC30XIWNJA,"32500",0
W2060,16,3/24/2023,RCO1IMNI5F,"36000",600
W2060,16,3/24/2023,RCO2IMU52A,600,0
W2060,17,4/19/2023,RDJ2KSY85C,"38400",0
W2060,18,5/18/2023,REI0T0X6M0,"44450",0
W2060,19,6/16/2023,RFG16631NR,"45500",0
W2060,20,7/12/2023,RGC2CSCVFY,"44800",0
W2061,1,2/4/2022,QB43MNBH19,100,3800
W2061,1,2/4/2022,QB46MN363Y,100,3700
W2061,1,2/8/2022,QB83TROX05,100,3600
W2061,1,2/8/2022,QB88TRTP0I,100,3500
W2061,1,2/11/2022,QBB5YUNLBL,100,3400
W2061,1,2/11/2022,QBB3YV1M0P,50,3350
W2061,1,2/14/2022,QBE0579OFK,100,3250
W2061,1,2/14/2022,QBE9580QBJ,100,3150
W2061,1,2/14/2022,QBE7583I9J,50,3100
W2061,1,2/15/2022,QBF07ED3IK,100,3000
W2061,1,2/16/2022,QBG698LZT4,100,2900
W2061,1,2/16/2022,QBG09A2M34,50,2850
W2061,1,2/28/2022,QBS3UHVYOR,100,2750
W2061,1,2/28/2022,QBS2UHYVUA,40,2710
W2061,1,3/1/2022,QC16WGAW2E,1040,1670
W2061,1,3/1/2022,,1690,20
W2061,2,3/14/2022,QCE1NYLT81,100,4640
W2061,2,3/14/2022,QCE1O5ZPJD,50,4590
W2061,2,3/29/2022,QCT3HI2J5H,"1500",3090
W2061,2,3/31/2022,QCV0L7WI2K,270,2820
W2061,2,4/4/2022,QD45SVL28Z,100,2720
W2061,2,5/30/2022,QEU9V5YXKB,100,2620
W2062,1,2/15/2022,QBF0734IEO,"3250",9450
W2062,1,2/24/2022,QBO3NHQOU3,"1600",7850
W2062,1,2/28/2022,QBS0UHMWOK,"2000",5850
W2062,1,2/28/2022,QBS6W614BC,"5850",0
W2062,2,3/13/2022,QCD8N1NM6S,"3250",9350
W2062,2,3/21/2022,QCL31IWJJT,"3300",6050
W2062,2,3/25/2022,QCP58WK7OJ,"6050",0
W2062,3,4/7/2022,QD73YL8I3J,"2000",10300
W2062,3,4/9/2022,QD983H45NQ,"1350",8950
W2062,3,4/10/2022,QDA65Q1XMY,"1200",7750
W2062,3,4/13/2022,QDD7B22UYD,2000,5750
W2062,3,4/15/2022,QDF6F5HXW4,1500,4250
W2062,3,4/19/2022,QDJ1M6LMO1,4050,200
W2062,3,4/19/2022,QDJ2MJ8PGC,100,100
W2062,3,4/19/2022,QDJ5MJCUB1,100,0
W2062,4,5/18/2022,QEI870WR84,"3250",10350
W2062,4,5/18/2022,QEI67R3W02,850,9500
W2062,4,5/18/2022,QEI886JHAI,"9500",0
W2062,5,6/14/2022,QFE4PZENZ2,"13000",0
W2062,6,7/12/2022,QGC0CEKR34,"13000",0
W2062,7,8/4/2022,QH45NBM2L1,"12400",0
W2063,1,2/9/2022,QB97WB3BTB,220,6580
W2063,1,2/10/2022,QBA6YC90VK,20,6560
W2063,1,2/10/2022,QBA0YC0JV4,100,6460
W2063,1,2/10/2022,QBA7YBSXVZ,100,6360
W2063,1,2/11/2022,QBB91A9TUZ,100,6260
W2063,1,2/11/2022,QBB11AGLAN,100,6160
W2063,1,2/11/2022,QBB41AOBJ4,20,6140
W2063,1,2/12/2022,QBC639JZAU,100,6040
W2063,1,2/12/2022,QBC939NSP1,100,5940
W2063,1,2/12/2022,QBC839U1Z0,20,5920
W2063,1,2/13/2022,QBD94YP0RJ,100,5820
W2063,1,2/13/2022,QBD94YT3RH,100,5720
W2063,1,2/13/2022,QBD64YZOEK,20,5700
W2063,1,2/14/2022,QBE86PGO2U,100,5600
W2063,1,2/14/2022,QBE66PV42S,100,5500
W2063,1,2/14/2022,QBE96Q2O0V,20,5480
W2063,1,2/15/2022,QBF78MOPNF,100,5380
W2063,1,2/15/2022,QBF38MT6JJ,100,5280
W2063,1,2/15/2022,QBF78N04WF,20,5260
W2063,1,2/16/2022,QBG3AHWNF1,100,5160
W2063,1,2/16/2022,QBG2AHZ14A,100,5060
W2063,1,2/16/2022,QBG8AI2L4I,20,5040
W2063,1,2/17/2022,QBH5CCRPXB,100,4940
W2063,1,2/17/2022,QBH6CCWAFU,100,4840
W2063,1,2/17/2022,QBH9CCYUJ7,20,4820
W2063,1,2/18/2022,QBI1E6DGJX,100,4720
W2063,1,2/18/2022,QBI8E6OYHS,100,4620
W2063,1,2/18/2022,QBI8E6RO9S,20,4600
W2063,1,2/19/2022,QBJ4G27LV2,100,4500
W2063,1,2/19/2022,QBJ4G2AMAE,100,4400
W2063,1,2/19/2022,QBJ5G2G1OB,20,4380
W2063,1,2/20/2022,QBK8HPK8JO,100,4280
W2063,1,2/20/2022,QBK0HPNV1S,100,4180
W2063,1,2/20/2022,QBK8HPR02M,20,4160
W2063,1,2/21/2022,QBL8JHZQWE,100,4060
W2063,1,2/21/2022,QBL0JI4JM8,100,3960
W2063,1,2/21/2022,QBL3JI8H6F,20,3940
W2063,1,2/23/2022,QBN0N0GDTO,100,3840
W2063,1,2/23/2022,QBN8N0KSJ8,100,3740
W2063,1,2/23/2022,QBN9N0NQST,100,3640
W2063,1,2/23/2022,QBN0N0SGD0,100,3540
W2063,1,2/23/2022,QBN0N118WU,40,3500
W2063,1,2/24/2022,QBO3OV4TFP,100,3400
W2063,1,2/24/2022,QBO4OV875E,100,3300
W2063,1,2/24/2022,QBO2OVBVJG,40,3260
W2063,1,2/25/2022,QBP2QQ6OKK,100,3160
W2063,1,2/25/2022,QBP3QQ8WXD,100,3060
W2063,1,2/25/2022,QBQ9QQTX41,20,3040
W2063,1,2/26/2022,QBQ2SLNZZ0,100,2940
W2063,1,2/26/2022,QBQ8SLQT6I,100,2840
W2063,1,2/26/2022,QBQ6SLTOFO,20,2820
W2063,1,2/27/2022,QBR5U9UQP5,100,2720
W2063,1,2/27/2022,QBR2U9YI1A,100,2620
W2063,1,2/27/2022,QBR1UA6523,20,2600
W2063,1,3/1/2022,QC13WD8Z73,100,2500
W2063,1,3/1/2022,QC11WD9SFJ,100,2400
W2063,1,3/1/2022,QC17WDA4Y9,20,2380
W2063,1,3/1/2022,QC27YEM4U3,100,2280
W2063,1,3/1/2022,QC26YEMDIK,100,2180
W2063,1,3/1/2022,QC20YEMP8M,20,2160
W2063,1,3/2/2022,QC241DTC2M,20,2140
W2063,1,3/2/2022,QC271DD5T1,100,2040
W2063,1,3/2/2022,QC211CXWAN,100,1940
W2063,1,3/3/2022,QC363FTFVS,100,1840
W2063,1,3/3/2022,QC333G1X2N,100,1740
W2063,1,3/3/2022,QC323G3FNC,20,1720
W2063,1,3/5/2022,QC567KIIJE,100,1620
W2063,1,3/5/2022,QC537KP7IL,100,1520
W2063,1,3/5/2022,QC577LGVRP,100,1420
W2063,1,3/5/2022,QC557LJUUD,100,1320
W2063,1,3/5/2022,QC527LT4R4,40,1280
W2063,1,3/6/2022,QC689DQLY0,100,1180
W2063,1,3/6/2022,QC639FPP45,20,1160
W2063,1,3/8/2022,QC86BL84KM,100,1060
W2063,1,3/8/2022,QC80BLP7UQ,100,960
W2063,1,3/8/2022,QC86BLSH4U,20,940
W2063,1,3/7/2022,QC76A6TKRY,100,840
W2063,1,3/10/2022,QCA5FERTY1,400,440
W2063,1,3/10/2022,QCA3GUP3NB,100,340
W2063,1,3/10/2022,QCA3GUZATN,100,240
W2063,1,3/10/2022,QCA6GV9F5U,40,200
W2063,1,3/11/2022,QCB715RBDX,100,100
W2063,1,3/11/2022,QCB6I5YX24,100,0
W2063,2,3/12/2022,QCC9L1S3AV,100,6300
W2063,2,3/12/2022,QCC6L2BG7O,100,6200
W2063,2,3/12/2022,QCC5L2RALT,40,6160
W2063,2,3/13/2022,QCD4N0YUUC,100,6060
W2063,2,3/13/2022,QCD9N11R57,100,5960
W2063,2,3/13/2022,QCD7N144S7,20,5940
W2063,2,3/14/2022,QCE3OVI7Y9,100,5840
W2063,2,3/14/2022,QCE4OVLF4E,100,5740
W2063,2,3/14/2022,QCE0OWFLCQ,20,5720
W2063,2,3/15/2022,QCF4QSSN36,100,5620
W2063,2,3/15/2022,QCF9QSWRZB,100,5520
W2063,2,3/15/2022,QCF6QT0Q0A,20,5500
W2063,2,3/16/2022,QCG1SPZ463,100,5400
W2063,2,3/16/2022,QCG7SQA9RR,100,5300
W2063,2,3/17/2022,QCH5ULRZZR,100,5200
W2063,2,3/17/2022,QCH1ULVHL1,100,5100
W2063,2,3/17/2022,QCH5ULZI5L,20,5080
W2063,2,3/18/2022,QCI3WJWYQZ,100,4980
W2063,2,3/18/2022,QCI7WKIEL7,100,4880
W2063,2,3/19/2022,QCJ7YGQ4LL,100,4780
W2063,2,3/19/2022,QCJ8YGU8BO,100,4680
W2063,2,3/20/2022,QCK616S10K,100,4580
W2063,2,3/20/2022,QCK116TZ55,100,4480
W2063,2,3/20/2022,QCK816XTFY,20,4460
W2063,2,3/21/2022,QCL2314TQO,100,4360
W2063,2,3/21/2022,QCL13186JT,100,4260
W2063,2,3/21/2022,QCL431C7U6,20,4240
W2063,2,3/23/2022,QCN65GTHKY,100,4140
W2063,2,3/23/2022,QCN75H0K0Z,100,4040
W2063,2,3/23/2022,QCN85H8YBI,20,4020
W2063,2,3/23/2022,QCN96QWD7P,100,3920
W2063,2,3/23/2022,QCN66QYMTY,100,3820
W2063,2,3/23/2022,QCN36QZGOV,20,3800
W2063,2,3/24/2022,QCO88M0WXI,100,3700
W2063,2,3/24/2022,QCO18M270H,100,3600
W2063,2,3/24/2022,QCO08M34WQ,20,3580
W2063,2,3/27/2022,QCR5DT9MOD,100,3480
W2063,2,3/27/2022,QCR2DTHHJ2,100,3380
W2063,2,3/27/2022,QCR7DTS0FH,20,3360
W2063,2,3/28/2022,QCS7FZSXZB,220,3140
W2063,2,3/29/2022,QCT0HXBTRI,100,3040
W2063,2,3/29/2022,QCT5HXD5YD,100,2940
W2063,2,3/30/2022,QCU8JW963Y,100,2840
W2063,2,3/30/2022,QCU4JWA5A8,100,2740
W2063,2,3/31/2022,QCV9LWYJEJ,100,2640
W2063,2,3/31/2022,QCV8LX06TO,100,2540
W2063,2,3/31/2022,QCV5LX1299,20,2520
W2063,2,4/1/2022,QD10O1KRDA,100,2420
W2063,2,4/1/2022,QD16O1PAFQ,100,2320
W2063,2,4/2/2022,QD29Q4R3GX,100,2220
W2063,2,4/2/2022,QD25Q4T42F,100,2120
W2063,2,4/3/2022,QD30RXVMIY,100,2020
W2063,2,4/3/2022,QD32RXXDQ0,100,1920
W2063,2,4/4/2022,QD45TXOU3V,100,1820
W2063,2,4/4/2022,QD44TXROHE,100,1720
W2063,2,4/5/2022,QD55VYKAGJ,100,1620
W2063,2,4/5/2022,QD53VYLTUX,100,1520
W2063,2,4/5/2022,QD57VYMVYF,60,1460
W2063,2,4/7/2022,QD79Z9C8U5,1460,0
W2063,3,4/8/2022,QD8232KVME,100,6400
W2063,3,4/8/2022,QD8932OG9F,100,6300
W2063,3,4/8/2022,QD8232QVPK,20,6280
W2063,3,4/9/2022,QD9853FTFQ,100,6180
W2063,3,4/9/2022,QD9453HNXI,100,6080
W2063,3,4/9/2022,QD9253MVEC,20,6060
W2063,3,4/10/2022,QDA56TBOI7,100,5960
W2063,3,4/10/2022,QDA16TFRA9,100,5860
W2063,3,4/11/2022,QDB88UI6II,100,5760
W2063,3,4/11/2022,QDB88UK60E,100,5660
W2063,3,4/11/2022,QDB58UL9U7,20,5640
W2063,3,4/12/2022,QDC3ARQQW7,220,5420
W2063,3,4/13/2022,QDD4COIQ54,100,5320
W2063,3,4/13/2022,QDD8COK0VQ,100,5220
W2063,3,4/13/2022,QDD9COLOIF,20,5200
W2063,3,4/14/2022,QDE6ENL2J2,100,5100
W2063,3,4/14/2022,QDE5ENN96F,100,5000
W2063,3,4/14/2022,QDE2ENOHLI,20,4980
W2063,3,4/15/2022,QDF6GJ7VC6,220,4760
W2063,3,4/16/2022,QDG3ID768B,100,4660
W2063,3,4/16/2022,QDG0IDAX1U,100,4560
W2063,3,4/16/2022,QDG2IDBCF8,20,4540
W2063,3,4/17/2022,QDH2JZJPFO,100,4440
W2063,3,4/18/2022,QDI0JZM2M0,100,4340
W2063,3,4/18/2022,QDI8JZP414,20,4320
W2063,3,4/19/2022,QDJ1NJKX01,100,4220
W2063,3,4/19/2022,QDJ9NJLT9X,100,4120
W2063,3,4/19/2022,QDJ3NJNM7J,20,4100
W2063,3,4/21/2022,QDL3PKSO4H,100,4000
W2063,3,4/21/2022,QDL2PKZ4MG,100,3900
W2063,3,4/21/2022,QDL3R8Q54N,100,3800
W2063,3,4/21/2022,QDL0R8RR5Q,100,3700
W2063,3,4/23/2022,QDN4V1CY5G,100,3600
W2063,3,4/23/2022,QDN9V1EJHR,100,3500
W2063,3,4/23/2022,QDN3V1JDEF,20,3480
W2063,3,4/24/2022,QDO5WQ0P9X,220,3260
W2063,3,4/26/2022,QDQ6YNJ5K0,220,3040
W2063,3,4/28/2022,QDS95CX5N1,100,2940
W2063,3,4/28/2022,QDS55CZ6L1,100,2840
W2063,3,4/28/2022,QDS65D2SEE,70,2770
W2063,3,4/29/2022,QDT1795D61,100,2670
W2063,3,4/29/2022,QDT3796MI1,100,2570
W2063,3,4/30/2022,QDU0798U2O,40,2530
W2063,3,4/30/2022,QDU7974YVR,100,2430
W2063,3,4/30/2022,QDU1978CEB,100,2330
W2063,3,5/1/2022,QE25CTJ7AX,100,2230
W2063,3,5/1/2022,QE25CTKTH3,100,2130
W2063,3,5/4/2022,QE40EO4ABC,100,2030
W2063,3,5/4/2022,QE48EO73LO,100,1930
W2063,3,5/6/2022,QE66JCRR6A,1930,0
W2063,4,5/6/2022,QE61KNBAI9,100,9000
W2063,4,5/6/2022,QE66KNC57O,100,8900
W2063,4,5/6/2022,QE69KNEGLF,100,8800
W2063,4,5/8/2022,QE87MPPR67,100,8700
W2063,4,5/8/2022,QE85MPR1RX,100,8600
W2063,4,5/8/2022,QE81MPTKFP,100,8500
W2063,4,5/8/2022,QE82MPUSGQ,10,8490
W2063,4,5/9/2022,QE98OKMD7W,305,8185
W2063,4,5/10/2022,QEA9QIVHAH,100,8085
W2063,4,5/10/2022,QEA2QIW6BO,100,7985
W2063,4,5/10/2022,QEA9QIX5ZH,100,7885
W2063,4,5/11/2022,QEB0SMJFCE,305,7580
W2063,4,5/11/2022,QEB3UGJYQD,305,7275
W2063,4,5/14/2022,QEE6YE349M,305,6970
W2063,4,5/15/2022,QEF3342I33,305,6665
W2063,4,5/16/2022,QEG1505565,305,6360
W2063,4,5/17/2022,QEH16VVOOP,100,6260
W2063,4,5/17/2022,QEH56VYZ81,100,6160
W2063,4,5/17/2022,QEH06W1K3S,100,6060
W2063,4,5/19/2022,QEJ8ANS2SW,100,5960
W2063,4,5/19/2022,QEJ4ANTJIU,100,5860
W2063,4,5/21/2022,QEL3CMW04N,240,5620
W2063,4,5/23/2022,QEN9IB1ZWH,500,5120
W2063,4,5/24/2022,QEO8K7E1Z6,200,4920
W2063,4,5/30/2022,QEU0TZ607I,305,4615
W2063,4,6/3/2022,QF303QZB8M,4650,35
W2063,5,6/3/2022,QF384YC9AE,305,8725
W2063,5,6/4/2022,QF45731NF1,305,8420
W2063,5,6/5/2022,QF558XHPIT,305,8115
W2063,5,6/6/2022,QF64AZDAK6,305,7810
W2063,5,6/7/2022,QF73CZAZDD,305,7505
W2063,5,6/8/2022,QF83EZJM0X,100,7405
W2063,5,6/8/2022,QF81EZM915,95,7310
W2063,5,6/8/2022,QF88EZYLMC,10,7300
W2063,5,6/9/2022,QF91H052TD,305,6995
W2063,5,6/11/2022,QFB1J33097,100,6895
W2063,5,6/11/2022,QFB9J34F2B,95,6800
W2063,5,6/13/2022,QFD3MWWAGB,100,6700
W2063,5,6/13/2022,QFD2MWX0OG,100,6600
W2063,5,6/13/2022,QFD2MWXJGA,100,6500
W2063,5,6/13/2022,QFD5MWY1GF,100,6400
W2063,5,6/11/2022,QFB6L48SJG,315,6085
W2063,5,6/14/2022,QFE5OW21B5,100,5985
W2063,5,6/14/2022,QFE0OW2CY6,100,5885
W2063,5,6/14/2022,QFE4OW30NC,100,5785
W2063,5,6/14/2022,QFE7OW3HGZ,15,5770
W2063,5,6/14/2022,QFE9QV7QXV,100,5670
W2063,5,6/14/2022,QFE3QVB63V,100,5570
W2063,5,6/14/2022,QFE1QVCKT3,100,5470
W2063,5,6/15/2022,QFF4SWD470,100,5370
W2063,5,6/15/2022,QFF4SWDZB0,100,5270
W2063,5,6/17/2022,QFH0UWCL5U,305,4965
W2063,5,6/19/2022,QFJ9YYHW0H,100,4865
W2063,5,6/19/2022,QFJ0YYIFYA,100,4765
W2063,5,6/19/2022,QFJ5YYIZ1X,40,4725
W2063,5,6/20/2022,QFK93N4243,100,4625
W2063,5,6/20/2022,QFK53N5P6D,100,4525
W2063,5,6/22/2022,QFM17K0DU1,100,4425
W2063,5,6/22/2022,QFM07K1N36,100,4325
W2063,5,6/27/2022,QFR3GYSTOR,305,4020
W2063,5,6/30/2022,QFU6ML0SGY,4020,0
W2063,6,7/1/2022,QG17PBOZ8J,100,9000
W2063,6,7/1/2022,QG11PBX1VF,100,8900
W2063,6,7/1/2022,QG13PCH883,5,8895
W2063,6,7/2/2022,QG25RMS8TL,305,8590
W2063,6,7/4/2022,QG40VNC536,610,7980
W2063,6,7/6/2022,QG63ZWLYDD,305,7675
W2063,6,7/7/2022,QG7232ZFIY,305,7370
W2063,6,7/8/2022,QG8158C5UL,305,7065
W2063,6,7/9/2022,QG997DOUHX,305,6760
W2063,6,7/11/2022,QGB5BAEFUZ,305,6455
W2063,6,7/13/2022,QGD7DDKNY9,305,6150
W2063,6,7/14/2022,QGE4HEE3S8,100,6050
W2063,6,7/14/2022,QGE0HEGXX2,100,5950
W2063,6,7/14/2022,QGE2HEI724,100,5850
W2063,6,7/16/2022,QGG9JM4S65,305,5545
W2063,6,7/18/2022,QGI5P9XZ0N,305,5240
W2063,6,7/19/2022,QGJ3R7EUSH,305,4935
W2063,6,7/20/2022,QGK0T5ZTOS,305,4630
W2063,6,7/21/2022,QGL6V2WTMU,305,4325
W2063,6,7/22/2022,QGM9X1X2UZ,305,4020
W2063,6,7/23/2022,QGN9Z1SFB9,200,3820
W2063,6,7/24/2022,QGO81RRJDQ,100,3720
W2063,6,7/24/2022,QGO41RVLCM,100,3620
W2063,6,7/24/2022,QGO61RYQ9E,100,3520
W2063,6,7/27/2022,QGR55QDCPJ,250,3270
W2063,6,7/27/2022,QGR37L35QV,600,2670
W2063,6,7/29/2022,QGT0A5OY4S,2670,0
W2063,7,7/30/2022,QGU9DXH0YH,305,9215
W2063,7,7/31/2022,QGV9FVEYUZ,305,8910
W2063,7,8/1/2022,QH18I0HT72,305,8605
W2063,7,8/2/2022,QH29K4YD3Z,305,8300
W2063,7,8/4/2022,QH48OBO0J0,400,7900
W2063,7,8/5/2022,QH50QMFQ0Q,305,7595
W2063,7,8/8/2022,QH88VI7994,610,6985
W2063,7,8/10/2022,QHA1YM5AJV,400,6585
W2063,7,8/11/2022,QHB22TV27Q,200,6385
W2063,7,8/11/2022,QHB62TVHCK,50,6335
W2063,7,8/15/2022,QHF99BAOPF,500,5835
W2063,7,8/17/2022,QHH7DLGUG1,500,5335
W2063,7,8/18/2022,QHI5FJVESX,305,5030
W2063,7,8/22/2022,QHM0N4CVLY,400,4630
W2063,7,8/24/2022,QHO6QWZ8TG,300,4330
W2063,7,8/30/2022,QHU42T0BWA,4330,0
W2063,8,8/31/2022,QHV45QW9U2,217,6583
W2063,8,9/1/2022,QI107YC50M,217,6366
W2063,8,9/3/2022,QI32A6FYJI,100,6266
W2063,8,9/3/2022,QI33A6HCTJ,100,6166
W2063,8,9/3/2022,QI33A6J9CH,17,6149
W2063,8,9/3/2022,QI35CCZGBT,217,5932
W2063,8,9/4/2022,QI40EAZ6FK,217,5715
W2063,8,9/6/2022,QI63IJO7W3,217,5498
W2063,8,9/7/2022,QI75KN21OP,100,5398
W2063,8,9/7/2022,QI73KN32LJ,100,5298
W2063,8,9/7/2022,QI75KN4HRJ,17,5281
W2063,8,9/10/2022,QIA1R4XHG9,100,5181
W2063,8,9/10/2022,QIA9R4ZXR3,100,5081
W2063,8,9/13/2022,QID6X7KX4E,217,4864
W2063,8,9/16/2022,QIG52PMD21,100,4764
W2063,8,9/16/2022,QIG32PVM85,100,4664
W2063,8,9/19/2022,QIJ5AZ9TEX,100,4564
W2063,8,9/19/2022,QIJ9AZFLWB,100,4464
W2063,8,9/19/2022,QIJ0AZIKJ8,17,4447
W2063,8,9/21/2022,QIL4F6NASW,100,4347
W2063,8,9/21/2022,QIL0F6TDHU,100,4247
W2063,8,9/21/2022,QIL3F6Y9UT,60,4187
W2063,8,9/29/2022,QIT4VKAEI6,3600,587
W2063,8,10/3/2022,QJ3460RMMW,100,487
W2063,8,10/3/2022,QJ3060XG64,100,387
W2063,8,10/3/2022,QJ33615A8N,100,287
W2063,8,10/3/2022,QJ3061A1U2,100,187
W2063,8,10/3/2022,QJ3861GTEC,100,87
W2063,8,10/3/2022,QJ3462IK5I,80,7
W2063,8,10/3/2022,QJ316BREWB,7,0
W2064,8,2/11/2022,QBB61EYFQQ,100,6220
W2064,8,2/11/2022,QBB81F28SO,100,6120
W2064,8,2/12/2022,QBC53AZ16F,100,6020
W2064,8,2/12/2022,QBC63B1V0K,100,5920
W2064,1,2/15/2022,QBF58NTGAJ,200,5720
W2064,1,2/17/2022,QBH0CDSE2Q,100,5620
W2064,1,2/20/2022,QBK9HPDQ3F,100,5520
W2064,1,2/20/2022,QBK1HPHWF5,100,5420
W2064,1,2/20/2022,QBK9HPP6FV,100,5320
W2064,1,2/27/2022,QBR5U9UQP52,100,5220
W2064,1,2/27/2022,QBR4U9WV3Y,100,5120
W2064,1,3/10/2022,QCA1FIXYI3,100,5020
W2064,1,3/11/2022,QCB5J9NUXL,100,4920
W2064,1,3/11/2022,QCB1J9PDEL,100,4820
W2064,1,3/16/2022,QCG4RW87PU,300,4520
W2064,1,3/18/2022,QCI0WI79PO,100,4420
W2064,1,3/18/2022,QCI8WIB5VG,100,4320
W2064,1,3/20/2022,QCK015SE02,100,4220
W2064,1,3/20/2022,QCK715TKON,100,4120
W2064,1,3/25/2022,QCP0AGEJJC,100,4020
W2064,1,3/25/2022,QCP2AGIJPE,100,3920
W2064,1,4/1/2022,QD18M5P37Q,100,3820
W2064,1,4/1/2022,QD11M5TXNJ,100,3720
W2064,1,4/1/2022,QD16M5X40C,100,3620
W2064,1,4/4/2022,QD44TWTGM6,100,3520
W2064,1,4/4/2022,QD43TWV81H,100,3420
W2064,1,4/7/2022,QD70ZW8F5U,100,3320
W2064,1,4/13/2022,QDD0CLUB2E,100,3220
W2064,1,4/16/2022,QDG1IAVZRP,100,3120
W2064,1,4/16/2022,QDG4IAZ5WY,100,3020
W2064,1,4/22/2022,QDM9T07FSF,100,2920
W2064,1,4/23/2022,QDN8T93FRK,100,2820
W2064,1,5/2/2022,QE21B4FC9P,100,2720
W2064,1,5/2/2022,QE23CRL8MD,100,2620
W2064,1,5/6/2022,QE68KLLEEI,100,2520
W2064,1,5/6/2022,QE67KLOAKH,100,2420
W2064,1,5/6/2022,QE62KLRGGM,100,2320
W2064,1,5/9/2022,QE96QHF6CA,100,2220
W2064,1,5/12/2022,QEC1UQVCFH,100,2120
W2064,1,5/13/2022,QED1Y9FYLD,100,2020
W2064,1,5/18/2022,QEI97396HH,100,1920
W2064,1,5/23/2022,QEN8GLC4IW,100,1820
W2064,1,5/25/2022,QEP4L96B98,100,1720
W2064,1,5/25/2022,QEP3L99ZQ3,100,1620
W2064,1,5/25/2022,QEP0L9CMTM,50,1570
W2064,1,6/4/2022,QF426Z26XA,100,1470
W2064,1,6/4/2022,QF486Z57Q4,100,1370
W2064,1,6/4/2022,QF426Z87TC,100,1270
W2064,1,6/5/2022,QF598V8EI5,50,1220
W2064,1,6/17/2022,QFH5W3Y3MV,270,950
W2064,1,6/18/2022,QFI7X49VIR,50,900
W2065,1,2/16/2022,QBG3ABBVQT,975,2925
W2065,1,2/23/2022,QBN6M5H2GY,975,1950
W2065,1,3/2/2022,QC25Z8CKXH,975,975
W2065,1,3/7/2022,QC75NQB7J,975,0
W2065,2,3/13/2022,QCD3MZT9F3,"1000",2900
W2065,2,3/20/2022,QCK014UGOU,"1000",1900
W2065,2,3/27/2022,QCR9E2I8QL,"1000",900
W2065,2,4/4/2022,QD40SYB5RK,900,0
W2065,3,4/11/2022,QDA06SHV5I,"1000",2900
W2065,3,4/17/2022,QDH0JZGN02,"1000",1900
W2065,3,4/24/2022,QDO3WO3PWR,"1000",900
W2065,3,5/2/2022,QE24BEGLG6,900,0
W2065,4,5/10/2022,QEA4SF7OLE,"2000",4500
W2065,4,5/17/2022,QEH76UAM1D,"2000",2500
W2065,4,5/30/2022,QEU1VV9CSF,"2500",0
W2065,5,6/6/2022,QF68AXF6YK,"2000",4500
W2065,5,6/13/2022,QFD4OQU1EO,"1625",2875
W2065,5,6/27/2022,QFR4H386VY,"2875",0
W2065,6,7/6/2022,QG69XU00M9,"2000",4500
W2065,6,7/18/2022,QGI5NRFX8J,"3000",1500
W2065,6,7/26/2022,QGQ93WPKJF,"1500",0
W2065,7,8/23/2022,QHN9OOTYSF,"6500",0
W2066,1,2/16/2022,QBG5AHQNEP,"3250",9750
W2066,1,2/25/2022,QBP2OXT3PI,"3250",6500
W2066,1,3/7/2022,QC769KICT8,"3250",3250
W2066,1,3/9/2022,QC94ELHHUU,"3250",0
W2066,2,3/21/2022,QCL2186CQY,"3250",9750
W2066,2,4/1/2022,QD12NZZT5U,"6500",3250
W2066,2,4/6/2022,QD66XCQ7BW,"3250",0
W2066,3,4/14/2022,QDE7CY2L1H,"3250",9750
W2066,3,4/25/2022,QDP5WW0QPZ,"3250",6500
W2066,3,5/5/2022,QE51GRQSNV,"6500",0
W2066,4,5/23/2022,QEN1GK3Z3T,"6500",6500
W2066,4,5/31/2022,QEV1X4Q7R9,"6500",0
W2066,5,6/27/2022,QFR5FF7XY1,"6500",6500
W2066,5,6/27/2022,QFR7G0RH2Z,"6500",0
W2066,6,7/15/2022,QGF1I09EBT,"9750",9300
W2066,6,7/22/2022,QGM8VW7LTS,"9300",0
W2066,7,8/18/2022,QHI9EJYORB,"1750",21950
W2066,7,9/6/2022,QI66GKVRCA,500,21450
W2066,7,09/13/0202,QID2VA1Z14,500,20950
W2066,7,9/14/2022,QIE3XKIAC5,500,20450
W2066,7,9/17/2022,QIH1503X4L,500,19950
W2066,7,9/21/2022,QIL6DAD8LQ,1000,18950
W2066,7,10/3/2022,QJ3454Y2S6,500,18450
W2066,7,10/8/2022,QJ88HSDS20,1000,17450
W2066,7,10/13/2022,QJD2ST645K,1000,16450
W2066,7,10/27/2022,QJR3PMSF03,600,15850
W2066,7,11/3/2022,QK345XPVI2,500,15350
W2066,7,11/5/2022,QK70FMANX2,500,14850
W2066,7,11/10/2022,QKA9ML53NF,500,14350
W2066,7,11/17/2022,QKH24UA3IW,500,13850
W2066,7,11/29/2022,QKT7V6OHTP,500,13350
W2066,7,1/9/2023,RA90ZOC32O,500,12850
W2066,7,1/31/2023,RAV2MGS5P6,500,12350
W2066,7,4/21/2023,RDL8PB87PW,500,11850
W2066,7,4/28/2023,RDS77TAJQL,500,11350
W2066,7,5/30/2023,REU7R0JAGF,500,10850
W2067,1,2/17/2022,QBH5BNPUKV,"3250",8850
W2067,1,2/26/2022,QBQ7RNHPS7,"4000",4850
W2067,1,2/27/2022,QBR0TDI9F6,"4350",500
W2067,1,2/28/2022,QBS0UNC93I,500,0
W2067,2,3/11/2022,QCB6HFU4D2,"3500",8700
W2067,2,3/17/2022,QCH9SZ18BL,"2000",6700
W2067,2,3/18/2022,QCI3WKR5QN,"4200",2500
W2067,2,3/20/2022,QCK3YT0Z0P,2000,500
W2067,2,3/21/2022,QCL62ZNJWU,500,0
W2067,3,3/28/2022,QCS2EBYJKO,"6000",5200
W2067,3,3/29/2022,QCT4HX6D3W,"2000",3200
W2067,3,3/30/2022,QCU1ILEFYT,"3200",0
W2067,4,4/8/2022,QD811G2M9V,"4000",12800
W2067,4,4/9/2022,QD983CG1VU,"5000",7800
W2067,4,4/9/2022,QD953FKDEF,"7800",0
W2067,5,4/22/2022,QDM3SAIR3R,"16800",0
W2067,6,5/9/2022,QE94PG3UZA,"17550",0
W2067,7,5/18/2022,QEI57J25Q1,"16800",0
W2067,8,6/6/2022,QF639JR5ZX,"24000",0
W2067,9,6/23/2022,QFN19DFPV3,"8000",17600
W2067,9,6/27/2022,QFR4H3D1Z0,"8500",9100
W2067,9,6/28/2022,QFS8HYDLP8,"9100",0
W2067,10,7/15/2022,QGF1HXV4NN,"29500",0
W2067,11,8/5/2022,QH57P868AP,"31450",0
W2067,12,9/6/2022,QI64HIC8BS,"34000",0
W2067,13,10/4/2022,QJ4180G27N,"32250",250
W2067,13,10/4/2022,QJ4781F0MB,250,0
W2067,14,11/1/2022,QK122X24HO,"32500",0
W2067,15,12/6/2022,QL61HNNRV5,"15000",19000
W2067,15,12/6/2022,QL68I2SQW2,"19000",0
W2067,16,1/5/2023,RA56QNJP9Y,"34000",0
W2068,1,2/12/2022,QBC63AFHPQ,100,6700
W2068,1,2/13/2022,QBD04XQ2OQ,117,6583
W2068,1,2/13/2022,QBD44XNLLW,100,6483
W2068,1,2/14/2022,QBE66VFAWM,100,6383
W2068,1,2/14/2022,QBE46VKA8Y,217,6166
W2068,1,2/12/2022,QBC53AH2EJ,100,6066
W2068,1,2/12/2022,QBC03AKQRO,17,6049
W2068,1,2/15/2022,QBG68RCP2M,100,5949
W2068,1,2/16/2022,QBG5AHRTV1,100,5849
W2068,1,2/16/2022,QBG7AHTV0P,100,5749
W2068,1,2/17/2022,QBH8CCIYFW,100,5649
W2068,1,2/17/2022,QBH2CCKX28,100,5549
W2068,1,2/18/2022,QBI8E7RAE6,100,5449
W2068,1,2/18/2022,QBI2E7T45S,100,5349
W2068,1,2/18/2022,QBI0E7U6OE,17,5332
W2068,1,2/19/2022,QBJ7G0IX4V,100,5232
W2068,1,2/19/2022,QBJ8G0LA42,100,5132
W2068,1,2/21/2022,QBL0JH5WDY,217,4915
W2068,1,2/22/2022,QBM0LAN5MO,100,4815
W2068,1,2/22/2022,QBM2LAO9T4,100,4715
W2068,1,2/23/2022,QBN0N2YGU0,100,4615
W2068,1,2/23/2022,QBN2N302MC,100,4515
W2068,1,3/3/2022,QC373GIG63,100,4415
W2068,1,3/4/2022,QC475HC98V,100,4315
W2068,1,3/4/2022,QC465HEXHA,100,4215
W2068,1,3/8/2022,QC84D4F0PM,550,3665
W2068,1,3/9/2022,QC98FCWLLM,350,3315
W2068,1,3/11/2022,QCB1J9QJUX,1900,1415
W2068,1,3/12/2022,QCC9JND879,600,815
W2068,1,3/12/2022,QCC8K6Y4FY,815,0
W2068,2,3/13/2022,QCD4MXV4V8,100,6400
W2068,2,3/28/2022,QCS6F091GA,100,6300
W2068,2,3/28/2022,QCS8F0EBXA,100,6200
W2068,2,3/29/2022,QCT9GRX1VL,1200,5000
W2068,2,3/31/2022,QCV5L4NPGB,100,4900
W2068,2,4/1/2022,QD12NZFPM2,100,4800
W2068,2,4/4/2022,QD48SBWMFA,550,4250
W2068,2,4/6/2022,QD65XBHVCB,100,4150
W2068,2,4/6/2022,QD60XBO4MQ,100,4050
W2068,2,4/7/2022,QD77ZZ7AEB,100,3950
W2068,2,4/8/2022,QD811VKB99,1000,2950
W2068,2,4/8/2022,QD8428NCJK,2950,0
W2068,3,4/10/2022,QDA46TSYAM,100,6400
W2068,3,4/10/2022,QDA66U4FG0,270,6130
W2068,3,4/13/2022,QDD5CIOC45,100,6030
W2068,3,4/15/2022,QDF4F6MVS2,330,5700
W2068,3,4/18/2022,QDI8L2TV6Y,400,5300
W2068,3,4/20/2022,QDK5OKY71J,100,5200
W2068,3,4/25/2022,QDP5XAXFHH,480,4720
W2068,3,4/26/2022,QDQ81K4IZK,500,4220
W2068,3,5/6/2022,QE65JHO86V,4220,0
W2068,4,6/3/2022,QF363YXDPI,"6500",0
W2068,5,6/19/2022,QFJ1ZU1EPL,100,6400
W2068,5,6/23/2022,QFN080ZD7C,500,5900
W2068,5,6/25/2022,QFP4DESDR4,100,5800
W2068,5,6/26/2022,QFQ6F4AG9M,280,5520
W2068,5,6/29/2022,QFT6JJN3NY,500,5020
W2068,5,6/30/2022,QFU6M5I9ZC,3670,1350
W2068,5,6/30/2022,QFU0M8S7VO,100,1250
W2068,5,6/30/2022,QFU6M8UZHY,100,1150
W2068,5,6/30/2022,QFU2M907I6,100,1050
W2068,5,6/30/2022,QFU3M9GM9Z,100,950
W2068,5,6/30/2022,QFU2M9JXWW,100,850
W2068,5,6/30/2022,QFU3M9NGWB,850,0
W2068,6,11/14/2022,QKE0W6I0WW,200,6150
W2068,6,11/15/2022,QKF4Z2QLGO,200,5950
W2068,6,11/17/2022,QKH53TCU15,200,5750
W2068,6,11/18/2022,QKI081D28I,100,5650
W2068,6,11/22/2022,QKM5FEGVJZ,100,5550
W2068,6,11/22/2022,QKM0FEL4BU,100,5450
W2068,6,11/22/2022,QKM9FEQODR,100,5350
W2068,6,11/22/2022,QKM5FF12WF,100,5250
W2068,6,11/23/2022,QKN8JGJT4Q,600,4650
W2068,6,11/24/2022,QKP6M23TQE,100,4550
W2068,6,11/24/2022,QKP3M2DOKH,100,4450
W2068,6,11/27/2022,QKR6SS9K9C,300,4150
W2068,6,11/28/2022,QKS2V5B85C,300,3850
W2068,6,11/30/2022,QKU912XCMT,400,3450
W2068,6,12/1/2022,QL1845YGJA,100,3350
W2068,6,12/1/2022,QL18460ILO,100,3250
W2068,6,12/4/2022,QL42DZ1VJI,400,2850
W2068,6,12/6/2022,QL61ISLY3R,300,2550
W2068,6,12/7/2022,QL76LJQOHO,2400,150
W2068,6,12/7/2022,QL76LJQOHO2,50,100
W2068,6,12/7/2022,QL72LJIPSG,100,0
W2068,7,12/12/2022,QLC81LVUE6,400,6400
W2068,7,12/13/2022,QLD54ITTZZ,200,6200
W2068,7,12/28/2022,QLS48D5V98,300,5900
W2068,7,1/3/2023,RA34KW2R44,500,5400
W2068,7,1/6/2023,RA61SL7JPB,5400,0
W2068,8,1/8/2023,RA86Z2A4I2,100,6700
W2068,8,1/8/2023,RA88Z2BHTY,100,6600
W2068,8,1/9/2023,RA982I9N06,100,6500
W2068,8,2/6/2023,RB6319NSGL,5000,1500
W2068,8,2/6/2023,RB611B6H0V,1500,0
W2068,9,3/1/2023,RC12SHJIYQ,200,6600
W2068,9,3/7/2023,RC758J2O93,400,6200
W2069,1,2/15/2022,QBF38P8089,870,12730
W2069,1,2/16/2022,QBG5AGKJ23,850,11880
W2069,1,2/19/2022,QBJ9EAJXN5,775,11105
W2069,1,2/20/2022,QBK9G8JE57,765,10340
W2069,1,2/25/2022,QBP3QEZ2A1,750,9590
W2069,1,2/26/2022,QBQ0SNPW20,1790,7800
W2069,1,2/28/2022,QBS1UNP5C1,100,7700
W2069,1,2/28/2022,QBS5UNSI5B,100,7600
W2069,1,2/28/2022,QBS9UNVCIF,100,7500
W2069,1,2/28/2022,QBS5UNZ58T,100,7400
W2069,1,2/28/2022,QBS2UO1EMQ,100,7300
W2069,1,2/28/2022,QBS5UO4GRT,100,7200
W2069,1,2/28/2022,QBS0UO9LMO,100,7100
W2069,1,3/1/2022,QC15WGZ075,100,7000
W2069,1,3/7/2022,QC759X955J,3160,3840
W2069,1,3/13/2022,QCD6N22RO8,3240,600
W2069,1,3/14/2022,QCE5NHYUPB,100,500
W2069,1,3/14/2022,QCE9NHCVGP,100,400
W2069,1,3/14/2022,QCE9NYTBFH,100,300
W2069,1,3/14/2022,QCE8NZ6TDM,300,0
W2069,2,3/21/2022,QCL31AUCAP,100,12900
W2069,2,3/21/2022,QCL61AWGKM,100,12800
W2069,2,3/21/2022,QCL21AZCR2,100,12700
W2069,2,3/21/2022,QCL21B3MTG,100,12600
W2069,2,3/21/2022,QCL11B7N0J,100,12500
W2069,2,3/21/2022,QCL81B94YO,100,12400
W2069,2,3/21/2022,QCL71BBKF9,100,12300
W2069,2,3/21/2022,QCL91BDDW9,100,12200
W2069,2,3/21/2022,QCL51BF84V,100,12100
W2069,2,3/21/2022,QCL91BGLOV,100,12000
W2069,2,3/21/2022,QCL71O9A1R,2050,9950
W2069,2,3/27/2022,QCR2E06IZO,100,9850
W2069,2,3/29/2022,QCS8EDLVCW,100,9750
W2069,2,4/1/2022,QD11NR1MJ9,100,9650
W2069,2,4/2/2022,QD26P1BDVU,2000,7650
W2069,2,4/2/2022,QD25Q5B927,100,7550
W2069,2,4/3/2022,QD37Q5YEVR,100,7450
W2069,2,4/3/2022,QD39R2W0DP,200,7250
W2069,2,4/3/2022,QD33RO3SO7,100,7150
W2069,2,4/3/2022,QD31RO7RAL,100,7050
W2069,2,4/6/2022,QD63XL0CVB,100,6950
W2069,2,4/6/2022,QD66XL7WQ2,100,6850
W2069,2,4/7/2022,QD73YG2ULP,100,6750
W2069,2,4/7/2022,QD78Z1BVHI,100,6650
W2069,2,4/7/2022,QD75Z1GX3R,100,6550
W2069,2,4/11/2022,QDB57CQVGX,2850,3700
W2069,2,4/11/2022,QDB27PL6A8,3700,0
W2069,3,4/20/2022,QDK9NM8SZN,100,12900
W2069,3,5/6/2022,QE62JI2WIS,100,12800
W2069,3,5/6/2022,QE60JJBLMI,100,12700
W2069,3,5/6/2022,QE60KNHD1G,12700,0
W2069,4,5/25/2022,QEP2L9LIKS,100,12900
W2069,4,6/4/2022,QF426Z8P76,"12900",0
W2069,5,6/9/2022,QF97F20O0L,100,12700
W2069,5,7/2/2022,QG25Q97KHL,"12700",0
W2069,6,7/16/2022,QGG5JQ1G6H,100,12900
W2069,6,7/16/2022,QGG3JX6AH3,100,12800
W2069,6,7/17/2022,QGH9NAB38J,100,12700
W2069,6,7/18/2022,QGI5NCSUP7,100,12600
W2069,6,7/30/2022,QGU4COR2CM,3450,9150
W2069,6,7/30/2022,QGU2CU5SPQ,9150,0
W2070,1,2/15/2022,QBF28NP35S,290,12310
W2070,1,2/16/2022,QBG0A86IIU,310,12000
W2070,1,2/17/2022,QBH2CAI4EO,300,11700
W2070,1,2/18/2022,QBI6E4UYN6,200,11500
W2070,1,2/19/2022,QBJ3G04P67,250,11250
W2070,1,2/20/2022,QBK4HPC9PG,200,11050
W2070,1,2/21/2022,QBL1JINFWT,100,10950
W2070,1,2/22/2022,QBM2L83YAG,200,10750
W2070,1,2/23/2022,QBN1N19X3R,200,10550
W2070,1,2/24/2022,QBO3OSKY2Z,210,10340
W2070,1,2/25/2022,QBP8QO5YSG,200,10140
W2070,1,2/26/2022,QBQ5SLO0TN,100,10040
W2070,1,2/26/2022,QBQ2SLRJCU,70,9970
W2070,1,2/27/2022,QBR2U996SK,100,9870
W2070,1,2/27/2022,QBR1U9LREP,100,9770
W2070,1,3/1/2022,QC11Y8L69N,100,9670
W2070,1,3/1/2022,QC19Y8PERB,100,9570
W2070,1,3/2/2022,QC281CIHYG,100,9470
W2070,1,3/2/2022,QC281CFLIG,100,9370
W2070,1,3/4/2022,QC425GLFL4,100,9270
W2070,1,3/4/2022,QC415GWHWJ,100,9170
W2070,1,2/5/2022,QC597JL1L5,100,9070
W2070,1,2/6/2022,QC63967Y8J,500,8570
W2070,1,3/10/2022,QCA3G4BWDH,8570,0
W2070,2,3/11/2022,QCB8J8XBJI,200,11400
W2070,2,3/14/2022,QCE4OV4VCC,100,11300
W2070,2,3/14/2022,QCE7OV9FA3,100,11200
W2070,2,3/15/2022,QCF5QS0U83,100,11100
W2070,2,3/15/2022,QCF8QS2ZS4,100,11000
W2070,2,3/16/2022,QCG4SN9MGQ,200,10800
W2070,2,3/17/2022,QCH9ULTLZ3,100,10700
W2070,2,3/17/2022,QCH5ULWOLR,100,10600
W2070,2,3/19/2022,QCJ0YGPH6W,100,10500
W2070,2,3/19/2022,QCJ3YGREQV,100,10400
W2070,2,3/19/2022,QCJ4YGTLTK,100,10300
W2070,2,3/19/2022,QCJ7YGZJP3,100,10200
W2070,2,3/23/2022,QCN66NT5IA,100,10100
W2070,2,3/23/2022,QCN46NWG98,100,10000
W2070,2,3/23/2022,QCN36O1XIB,100,9900
W2070,2,3/23/2022,QCN16O47LJ,100,9800
W2070,2,3/23/2022,QCN06O6Z54,100,9700
W2070,2,3/24/2022,QCO77EAIHB,9600,100
W2070,2,3/24/2022,QCO07HU6ZU,100,0
W2070,3,3/25/2022,QCP2AFIUT0,300,12600
W2070,3,3/26/2022,QCQ7CE1QL3,100,12500
W2070,3,3/26/2022,QCQ1CE5Z6J,100,12400
W2070,3,3/26/2022,QCQ4CE8YN8,100,12300
W2070,3,3/28/2022,QCS6FZ7YDW,100,12200
W2070,3,3/28/2022,QCS7FZA4MB,100,12100
W2070,3,3/30/2022,QCU6JTSBS6,100,12000
W2070,3,4/1/2022,QD19NYJZMV,100,11900
W2070,3,4/1/2022,QD19NYMZ19,100,11800
W2070,3,4/20/2022,QDK0NTJZJK,11800,0
W2070,4,4/21/2022,QDL1R5D9FH,300,19200
W2070,4,4/22/2022,QDM5T29ZRN,300,18900
W2070,4,4/24/2022,QDO4WOBDEU,100,18800
W2070,4,4/24/2022,QDO3WOE97R,100,18700
W2070,4,4/24/2022,QDO0WOFGY4,100,18600
W2070,4,5/14/2022,QEE3YT3BKB,10000,8600
W2070,4,5/16/2022,QEG03S6E4U,8600,0
W2070,5,6/13/2022,QFD1NGJH9R,"19500",0
W2070,6,7/8/2022,QG833I5AS9,"19300",0
W2070,7,8/17/2022,QHH1BUPEKB,"19500",0
W2070,8,9/14/2022,QIE2XF9IHU,"13000",0
W2070,9,10/14/2022,QJE6WBZGV6,"17400",0
W2070,10,11/10/2022,QKA5NQNW3,"18900",0
W2070,11,12/2/2022,QL265V3WB4,"18600",0
W2070,12,12/30/2022,QLU0B19UBS,"19500",0
W2070,13,1/30/2022,,"18750",0
W2070,14,2/17/2023,RBH6U5FLI2,"18000",0
W2070,15,3/18/2023,RCI636PXO0,"19500",0
W2070,16,4/15/2023,RDF79VA5Y3,"19500",0
W2070,17,5/15/2023,REF6LCYT32,"26000",0
W2070,18,5/31/2023,REV5UF9PY7,"23600",0
W2070,19,6/20/2023,RFK6I5N5M8,"24400",0
W2070,20,7/14/2023,RGE6HXI1D4,"25200",0
W2070,21,8/12/2023,RHC0X8507W,"26000",0
W2071,1,2/22/2022,QBM0L2HZIW,"1625",5175
W2071,1,3/1/2022,QC15Y4S50J,700,4475
W2071,1,3/2/2022,QC23Z12RZ3,925,3550
W2071,1,3/13/2022,QCD6LGDSSA,425,3125
W2071,1,3/13/2022,QCD1LTQJTH,800,2325
W2071,1,3/18/2022,QCI8VFK7PA,2325,0
W2071,2,3/26/2022,QCQ6B9S4FY,"1000",5500
W2071,2,4/14/2022,QDE6E1FMEU,"5500",0
W2071,3,5/6/2022,QE60KKO52Y,"1700",4800
W2071,3,5/12/2022,QEC1VJ1V9F,"2000",2800
W2071,3,5/16/2022,QEG336YIP7,"2200",600
W2071,3,5/16/2022,QEG0387XWC,600,0
W2071,4,6/7/2022,QF73BSAUDB,"6200",0
W2071,5,7/6/2022,QG68XZDB8S,"3300",3500
W2071,5,7/6/2022,QG69YNOZ5N,"3500",0
W2071,6,8/3/2022,QH33KI1BNP,350,6150
W2071,6,8/3/2022,QH34KSKYPC,"5000",1150
W2071,6,8/3/2022,QH39KTZ99H,500,650
W2071,6,8/3/2022,QH38KVHOSS,100,550
W2071,6,8/3/2022,QH33KVRDYN,100,450
W2071,6,8/3/2022,QH33KWL7ZX,450,0
W2072,1,2/22/2022,QBM9L4NTUR,"2600",7800
W2072,1,3/10/2022,QCA8G2BLL2,"7800",0
W2072,2,4/12/2022,QDC79BEOIV,"3000",8680
W2072,2,4/21/2022,QDL3PV8XXN,"1000",7680
W2073,1,2/21/2022,QBL4JC4VIK,500,8600
W2073,1,2/22/2022,QBM1KZ666X,500,8100
W2073,1,2/23/2022,QBN1M19TDH,500,7600
W2073,1,2/24/2022,QBO3OBFHGZ,775,6825
W2073,1,2/28/2022,QBS9W7SW7D,500,6325
W2073,1,3/2/2022,QC22YY8JIO,500,5825
W2073,1,3/2/2022,QC291EK153,200,5625
W2073,1,3/3/2022,QC31376WBH,225,5400
W2073,1,3/4/2022,QC495EQK0J,550,4850
W2073,1,3/6/2022,QC608ZLBTQ,300,4550
W2073,1,3/9/2022,QC97EB061F,550,4000
W2073,1,3/10/2022,QCA3H4AZDT,300,3700
W2073,1,3/12/2022,QCC5L48GK1,500,3200
W2073,1,3/16/2022,QCG9SK3P2B,500,2700
W2073,1,3/17/2022,QCH7TS34HB,500,2200
W2073,1,3/13/2022,QCD3MWAAJZ,300,1900
W2073,1,3/18/2022,QCI6VCWIAS,1900,0
W2073,2,3/23/2022,QCN46EA1IU,275,8825
W2073,2,3/25/2022,QCP8AGMPBY,200,8625
W2073,2,3/26/2022,QCQ4CAFZPC,350,8275
W2073,2,3/31/2022,QCV9LP04YF,250,8025
W2073,2,4/1/2022,QD17NJA0Q9,1000,7025
W2073,2,4/2/2022,QD25PTBFMN,700,6325
W2073,2,4/7/2022,QD72ZTK48Q,500,5825
W2073,2,4/11/2022,QDB98JA1LP,500,5325
W2073,2,4/13/2022,QDD3BVXCGF,5325,0
W2073,3,4/15/2022,QDF6FYNXUG,500,8600
W2073,3,4/18/2022,QDI1LHMB9V,500,8100
W2073,3,4/23/2022,QDN1UDZE6X,500,7600
W2073,3,4/24/2022,QDO0WBHQW2,225,7375
W2073,3,4/27/2022,QDR92W7CCJ,500,6875
W2073,3,4/28/2022,QDS64ZSG2G,500,6375
W2073,3,5/2/2022,QE26CMRWEY,275,6100
W2073,3,5/1/2022,QE15A5Q4HD,500,5600
W2073,3,5/4/2022,QE41GCGBQ5,950,4650
W2073,3,5/8/2022,QE84O533FE,700,3950
W2073,3,5/10/2022,QEA7R0P1YZ,2000,1950
W2073,3,5/10/2022,QEA6RRN1TO,1950,0
W2073,4,5/12/2022,QEC7V72P4N,500,9900
W2073,4,5/12/2022,QEC7VZ0A0B,200,9700
W2073,4,5/14/2022,QEE810SYNM,100,9600
W2073,4,5/14/2022,QEE0114HIO,100,9500
W2073,4,5/15/2022,QEF72U05NR,300,9200
W2073,4,5/22/2022,QEM2EXCKH6,400,8800
W2073,4,5/26/2022,QEQ0M60O9E,500,8300
W2073,4,5/27/2022,QER8PVJSH8,500,7800
W2073,4,5/29/2022,QET6TMNGRO,100,7700
W2073,4,5/29/2022,QET7TMSL11,100,7600
W2073,4,5/29/2022,QET2TNWUDU,100,7500
W2073,4,5/31/2022,QEV3XQBWBF,300,7200
W2073,4,6/1/2022,QF15ZTAPDD,500,6700
W2073,4,6/2/2022,QF222MNS1G,1000,5700
W2073,4,6/5/2022,QF588OE6PQ,2000,3700
W2073,4,6/6/2022,QF629UPWXI,3700,0
W2073,5,6/12/2022,QFC8MMDD94,"1000",9400
W2073,5,6/13/2022,QFD8OQGMGY,600,8800
W2073,5,6/14/2022,QFE7QR0FLN,100,8700
W2073,5,6/29/2022,QFT8KP1TBM,400,8300
W2073,5,6/30/2022,QFU6LU50OQ,700,7600
W2073,5,7/1/2022,QG14PBZ4K4,1600,6000
W2073,5,7/2/2022,QG24RCJ4PM,1000,5000
W2073,5,7/3/2022,QG31T6PUCJ,5000,0
W2073,6,7/13/2022,QGD2F7V20C,"1000",9400
W2073,6,7/21/2022,QGL6UL4984,400,9000
W2073,6,7/27/2022,QGR77GPOK5,"1000",8000
W2073,6,7/29/2022,QGT4BJQRNI,500,7500
W2073,6,7/30/2022,QGU3DORLMV,500,7000
W2073,6,7/31/2022,QGV1FA3J1N,1000,6000
W2073,6,8/1/2022,QG10GKGMI8,1000,5000
W2073,6,8/1/2022,QH14GW2O0U,5000,0
W2073,7,8/21/2022,QHL3L4OKXB,500,9900
W2073,7,8/25/2022,QHP2RGJ9XI,"1000",8900
W2073,7,8/26/2022,QHQ6U1QNAG,500,8400
W2073,7,8/27/2022,QHR3WNP83H,1500,6900
W2073,7,8/28/2022,QHS0YKXSY6,1900,5000
W2073,7,8/29/2022,QHT118OZ0X,5000,0
W2074,1,2/27/2022,QBR0T1FJYM,900,5600
W2074,1,3/1/2022,QC13YB9CXJ,700,4900
W2074,1,3/8/2022,QC87DEKPAF,"1625",3275
W2074,1,3/15/2022,QCF4QUDE2O,"1625",1650
W2074,1,3/23/2022,QCN75TUF5N,1625,25
W2074,1,3/24/2022,QCO76U64UB,25,0
W2074,2,6/23/2022,QFN59FA2L3,"1625",4825
W2074,2,6/30/2022,QFU9MZY8PP,"1000",3825
W2074,2,7/1/2022,QG15PHRJL1,625,3200
W2074,2,7/10/2022,QGA895T80M,1625,1575
W2074,2,7/13/2022,QGD5FDRYSD,1000,575
W2074,2,7/14/2022,QGE7GH670V,575,0
W2074,3,7/20/2022,QGK6T3SURO,900,5600
W2074,3,7/21/2022,QGL3V1HBKD,725,4875
W2074,3,7/27/2022,QGR07OT1JA,425,4450
W2074,3,7/29/2022,QGT8BRGAPY,1200,3250
W2074,3,8/8/2022,QH86WRRTXI,1000,2250
W2074,3,8/10/2022,QHA810ZKFW,1000,1250
W2074,3,8/11/2022,QHB91VS6HB,1250,0
W2074,4,8/19/2022,QHJ7G15DJN,"1000",6300
W2074,4,8/25/2022,QHP5STLXM7,800,5500
W2074,4,8/31/2022,QHV6454XEQ,"1125",4375
W2074,4,9/6/2022,QI68GHW4AE,1000,3375
W2074,4,9/7/2022,QI73IOABCN,1000,2375
W2074,4,9/13/2022,QID2X6A5Y4,1000,1375
W2074,4,9/15/2022,QIF51JZ5M3,575,800
W2074,4,9/20/2022,QIK9BLGRIB,800,0
W2075,1,2/26/2022,QBQ0R4AFN6,100,8740
W2075,1,2/26/2022,QBQ0R4CRP0,100,8640
W2075,1,2/26/2022,QBQ7R4GCO9,100,8540
W2075,1,3/1/2022,QC13YDOZ6V,600,7940
W2075,1,3/2/2022,QC2417EE8A,100,7840
W2075,1,3/2/2022,QC22178RHW,100,7740
W2075,1,3/2/2022,QC24174S9U,100,7640
W2075,1,3/3/2022,QC303HGLO4,300,7340
W2075,1,3/7/2022,QC71BFCVZR,600,6740
W2075,1,3/8/2022,QC86DFQSIG,600,6140
W2075,1,3/11/2022,QCB6JBAQPK,600,5540
W2075,1,3/23/3033,QCN75RSR5P,600,4940
W2075,1,3/24/2022,QCO47U7RK8,300,4640
W2075,1,3/25/2022,QCP692JXFS,4250,390
W2075,1,3/25/2022,QCP09SYM98,390,0
W2075,2,4/6/2022,QD63WAJERL,300,8540
W2075,2,4/12/2022,QDC09U4RM8,600,7940
W2075,2,4/23/2022,QDN2T4CNEA,100,7840
W2075,2,4/23/2022,QDN2T4D0OM,100,7740
W2076,1,3/7/2022,QC79BCTSWR,"1000",5150
W2076,1,3/12/2022,QCC1JN7JA3,625,4525
W2076,1,3/14/2022,QCE4OXGKYM,"1625",2900
W2076,1,3/21/2022,QCL22ECCMK,"2900",0
W2076,2,4/4/2022,QD47TFZ049,"3250",2650
W2076,2,4/7/2022,QD73YHYYWR,"2650",0
W2076,3,4/21/2022,QDL2QH9PWS,"5750",0
W2076,4,5/20/2022,QEK6BKV2HU,"6350",0
W2076,5,6/14/2022,QFE5POGX0R,"9100",0
W2076,6,7/8/2022,QG883XBH7W,"8820",0
W2077,1,3/11/2022,QCB8IX5CYQ,"2600",8280
W2077,1,3/23/2022,QCN96MVDMP,"1600",6680
W2077,1,3/28/2022,QCS6EGKR7M,"2600",4080
W2077,1,3/22/2022,QCM03RWKUS,"1000",3080
W2077,1,3/31/2022,QCV6LPUC08,2600,480
W2077,1,4/1/2022,QD10MBQ28Q,480,0
W2077,2,4/15/2022,QDF5F11067,600,11080
W2077,2,4/26/2022,QDQ0ZJEC8W,350,10730
W2077,2,4/26/2022,QDQ01HAX5O,300,10430
W2077,2,4/27/2022,QDR03AA0KW,200,10230
W2077,2,4/30/2022,QDU07FKV02,200,10030
W2077,2,5/4/2022,QE43GD2OB7,400,9630
W2077,2,5/5/2022,QE54ID62QO,200,9430
W2077,2,5/16/2022,QEG33FX8EF,200,9230
W2077,2,5/18/2022,QEI27LTUDW,200,9030
W2077,2,5/25/2022,QEP3KZZ0VH,700,8330
W2077,2,5/28/2022,QES0QKV41I,200,8130
W2077,2,5/30/2022,QEU0UA2382,200,7930
W2077,2,6/4/2022,QF425G7NM4,300,7630
W2077,2,6/10/2022,QFA6IY0VTO,100,7530
W2077,2,6/17/2022,QFH2VBVH3Y,100,7430
W2077,2,7/12/2022,QGC4BNV59A,100,7330
W2077,2,7/21/2022,QGL5TJY26F,100,7230
W2077,2,8/22/2022,QHM8LQ0ECA,100,7130
W2077,2,9/5/2022,QI64HE4252,100,7030
W2077,2,10/12/2022,QJC4RATNVO,300,6730
W2077,2,11/1/2022,QK1411BNQC,300,6430
W2077,2,11/4/2022,QK4689PSI8,100,6330
W2077,2,11/8/2022,QK85I1XG3T,100,6230
W2077,2,11/8/2022,QK81I2GHPN,100,6130
W2078,1,3/11/2022,QCB7HUZJAV,"1625",4875
W2078,1,3/18/2022,QCI6VCWIAS2,"1625",3250
W2078,1,3/25/2022,QCP3A04PQD,"1625",1625
W2078,1,3/30/2022,QCV7K97JRP,"1625",0
W2078,2,4/8/2022,QD851T4D6R,"1625",4875
W2078,2,4/23/2022,QDN3UOGK5X,"1000",3875
W2078,2,4/28/2022,QDS1427J4P,"3875",0
W2078,3,5/18/2022,QEI38IYBTN,"3000",3400
W2078,3,5/23/2022,QEN4HBUBCI,"3400",0
W2078,4,6/20/2022,QFK22CFBHK,"10400",0
W2078,5,7/15/2023,QGF7IPO311,"10160",0
W2078,6,8/4/2022,QH45NA7JZL,"9680",0
W2078,7,9/1/2022,QI176WYQLX,500,9900
W2079,1,3/31/2022,QCV3KZNSJ3,"6250",0
W2079,2,4/7/2022,QD71ZYCA05,900,5600
W2079,2,4/17/2022,QDH3IJ1E29,725,4875
W2079,2,4/21/2022,QDL4R59NC8,500,4375
W2079,2,4/22/2022,QDM7SX7RR5,425,3950
W2079,2,4/27/2022,QDR91XHBJN,3950,0
W2079,3,5/16/2022,QEG23J3REQ,500,6000
W2079,3,5/24/2022,QEO9K3AAR9,"2250",3750
W2079,3,5/25/2022,QEP0LMWK1E,"3750",0
W2079,4,6/21/2022,QFL34WF3RR,"6450",0
W2079,5,7/20/2022,QGK6T12752,"8000",2400
W2079,5,7/21/2022,QGKL3TMI2YX,"2400",0
W2079,6,8/20/2022,QHK7I9HKLH,"1130",9750
W2079,6,8/25/2022,QHP7S20U8T,500,9250
W2079,6,8/25/2022,QHP2S6K2IS,500,8750
W2079,6,8/30/2022,QHU82YD5Q8,100,8650
W2079,6,8/31/2022,QHV13T6NPP,400,8250
W2079,6,8/31/2022,QHV45OYOSO,200,8050
W2079,6,9/1/2022,QI137XHSM1,200,7850
W2079,6,9/12/2022,QIC6U3E1NU,100,7750
W2079,6,9/12/2022,QIC1U3HP65,100,7650
W2080,1,3/27/2022,QCR3DYDU3Z,"2400",8000
W2080,1,7/12/2022,QGC1CRZ2CN,"8000",0
W2082,1,3/26/2022,QCQ3CEPTD5,174,4897
W2082,1,3/27/2022,QCR6DY7KHU,174,4723
W2082,1,3/28/2022,QCS2FZPWJG,174,4549
W2082,1,3/29/2022,QCT1HVKSP5,174,4375
W2082,1,3/30/2022,QCU0JR8BZA,174,4201
W2082,1,3/31/2022,QCV2LTD0I6,174,4027
W2082,1,4/1/2022,QD12NWHZBY,174,3853
W2082,1,4/2/2022,QD20PZRU4O,174,3679
W2082,1,4/3/2022,QD37RS70KZ,174,3505
W2082,1,4/4/2022,QD46TFCA64,174,3331
W2082,1,4/5/2022,QD56VTEPNY,174,3157
W2082,1,4/6/2022,QD65XX9299,100,3057
W2082,1,4/6/2022,QD61XXDJ0N,74,2983
W2082,1,4/7/2022,QD73YPRZ5R,2983,0
W2082,2,4/9/2022,QD97517PVX,250,4630
W2082,2,4/13/2022,QDD7CLF3JH,100,4530
W2082,2,4/13/2022,QDD8CLMIV4,74,4456
W2082,2,4/17/2022,QDH3JRU2HD,100,4356
W2082,2,4/17/2022,QDH9JRYRBV,74,4282
W2082,2,4/19/2022,QDJ8NHU4J0,100,4182
W2082,2,4/19/2022,QDJ9NHWDOZ,74,4108
W2082,2,4/20/2022,QDK5P97ASB,100,4008
W2082,2,4/20/2022,QDK9P9DLQZ,74,3934
W2082,2,4/21/2022,QDL0R6BI9E,174,3760
W2082,2,4/22/2022,QDM6SZH5EM,100,3660
W2082,2,4/22/2022,QDM1SZKOGD,100,3560
W2082,2,4/28/2022,QDS548TD15,3520,40
W2082,2,4/28/2022,QDS84LCPEC,40,0
W2082,3,5/6/2022,QE66KN0R24,100,5740
W2082,3,5/6/2022,QE69KN2JZF,95,5645
W2082,3,5/7/2022,QE73MMZNXD,250,5395
W2082,3,5/9/2022,QE99QCC4PP,100,5295
W2082,3,5/9/2022,QE97QCGMPL,75,5220
W2082,3,5/16/2022,QEG7504S3H,175,5045
W2082,3,6/7/2022,QF76CFQU9E,100,4945
W2083,1,4/4/2022,QD43TET69V,"3200",9200
W2083,1,4/11/2022,QDB6859M8E,"3300",5900
W2083,1,4/19/2022,QDJ7M6LJJZ,"2500",3400
W2083,1,4/20/2022,QDK9OMV7NR,"3400",0
W2083,2,4/27/2022,QDR73BJ3BF,"3250",9700
W2083,2,5/5/2022,QE56H9FG8G,"2400",7300
W2083,2,5/10/2022,QEA7RQUERD,800,6500
W2083,2,5/16/2022,QEG94ADT35,6500,0
W2083,3,5/26/2022,QEQ7MWRMEF,"2000",11000
W2083,3,6/7/2022,QF73B2B1EJ,"1300",9700
W2083,3,6/10/2022,QFA7HJOOQR,"1000",8700
W2083,3,6/12/2022,QFC3LG2Y1J,1250,7450
W2083,3,6/13/2022,QFD7OF70A1,7450,0
W2083,4,7/9/2022,QG915WG7W9,"12700",0
W2083,5,8/3/2022,QH35L3HFOZ,"12700",0
W2083,6,8/22/2022,QHM5MCK5WT,"1000",12600
W2083,6,8/31/2022,QHV93YIIMT,"4000",8600
W2083,6,9/7/2022,QI76JUUGI8,"8600",0
W2083,7,10/6/2022,QJ65DIRAV1,"3000",10600
W2083,7,10/7/2022,QJ79F71IIP,"10600",0
W2084,1,4/6/2022,QD65VZ18VT,"1625",4575
W2084,1,4/14/2022,QDE5CPC2H7,165,4410
W2084,1,4/14/2022,QDE8CPCBKI,"1000",3410
W2084,1,4/20/2022,QDK0OC2C9G,"3000",410
W2084,1,4/20/2022,QDK9OHAIY1,110,300
W2084,1,4/20/2022,QDK6OPO04Y,300,0
W2084,2,4/27/2022,QDR33H33HF,"1625",4425
W2084,2,5/5/2022,QE50HQ0UQ6,"1625",2800
W2084,2,5/10/2022,QEA0QW3HSY,"2800",0
W2084,3,5/18/2022,QEI08BC2OS,"1625",4125
W2084,3,5/23/2022,QEN8GPDQRQ,"4125",0
W2084,4,5/30/2022,QEU0V1UG4I,"3200",9400
W2084,4,6/6/2022,QF68AMES3Q,"3200",6200
W2084,4,6/14/2023,QFE9Q0V74L,"3200",3000
W2084,4,6/16/2022,QFG6TTNIGG,3000,0
W2084,5,6/27/2022,QFR6G8RUHS,"3200",9300
W2084,5,7/4/2022,QG44V44FZK,"3200",6100
W2084,5,7/9/2022,QG915VLG8Z,"6100",0
W2084,6,7/20/2022,QGK2S74SQ4,"3200",8900
W2084,6,7/25/2022,QGP83RM2EK,"3200",5700
W2084,6,7/28/2022,QGS092IHUY,"5700",0
W2084,7,8/11/2022,QHB01OFFNM,"3200",9200
W2084,7,8/16/2022,QHG0A7CUZ6,"3200",6000
W2084,7,8/20/2022,QHK1IEOGRR,"6000",0
W2084,8,9/2/2022,QI259FXDFF,"3200",11400
W2084,8,9/20/2022,QIK5BVY5XL,"1000",10400
W2084,8,9/22/2022,QIM6FLR34G,300,10100
W2084,8,9/23/2022,QIN3HZLYJ7,300,9800
W2084,8,9/23/2022,QIN5J903V3,300,9500
W2084,8,9/24/2022,QIO5LAXUM9,300,9200
W2084,8,9/27/2022,QIR7QDT09F,300,8900
W2084,8,9/28/2022,QIS0UKVWE8,600,8300
W2084,8,9/29/2022,QIT5VYE3FD,300,8000
W2084,8,9/30/2022,QIU1Z3JP6N,300,7700
W2084,8,10/1/2022,QJ192OCUID,300,7400
W2084,8,10/3/2022,QJ396M9F1B,1000,6400
W2084,8,10/4/2022,QJ469HOHUY,300,6100
W2084,8,10/6/2022,QJ66E1UERK,600,5500
W2084,8,10/7/2022,QJ70GJX3ZE,300,5200
W2084,8,10/8/2022,QJ82J0XBM2,300,4900
W2084,8,10/10/2022,QJA9NCZ8FV,600,4300
W2084,8,10/11/2022,QJB7PPNDQ5,300,4000
W2084,8,10/12/2022,QJC8RSIC6W,300,3700
W2084,8,10/13/2022,QJD4UBQIFE,300,3400
W2084,8,10/14/2022,QJE8WN8R30,300,3100
W2084,8,10/15/2022,QJF0YHQOMM,300,2800
W2084,8,10/17/2022,QJH32NAWTR,2800,0
W2085,1,4/8/2022,QD892QO2W3,"5600",0
W2085,2,5/19/2022,QEJ29GXLRG,"1000",6300
W2085,2,6/18/2022,QFI3YGCEI9,500,5800
W2085,2,6/20/2022,QFK036K5XI,"1000",4800
W2085,2,6/30/2022,QFU2LFEWSW,2000,2800
W2085,2,7/12/2022,QGC8D0EIGM,1000,1800
W2085,2,7/13/2022,QGD1EU4TJP,500,1300
W2085,2,7/14/2022,QGE9FKU3J7,500,800
W2086,1,4/5/2022,QD56VREP0E,310,9910
W2086,1,4/7/2022,QD73ZOX37B,305,9605
W2086,1,5/16/2022,QEG848YI1I,350,9255
W2087,1,4/13/2022,QDD0C43P8S,"11200",0
W2087,2,7/4/2022,QG46TN3IXK,"13000",0
W2087,3,7/18/2022,QGI1NW7ZYZ,"11400",200
W2087,3,7/19/2022,QGJ1R52E67,100,100
W2087,3,8/17/2022,QHH9CX70LB,100,0
W2088,1,5/5/2022,QE58H06OBA,"13000",600
W2088,1,5/5/2022,QE50HAWZL0,600,0
W2088,2,6/2/2022,QF241HDADK,"11800",1200
W2088,2,6/3/2022,QF333V77Z5,"1200",0
W2088,3,7/1/2022,QG17OS3QAV,"4000",9600
W2088,3,7/2/2022,QG28Q2U5YQ,"9600",0
W2088,4,7/27/2022,QGR26ID5B4,"12700",0
W2088,5,9/10/2022,QIA9P5956J,"3000",12800
W2089,1,4/23/2022,QDN9UI4TVR,290,7870
W2089,1,4/26/2022,QDQ6ZX4V2G,200,7670
W2089,1,4/27/2022,QDR036N2M4,100,7570
W2089,1,4/29/2022,QDT967GWFX,500,7070
W2089,1,5/3/2022,QE33DFKCB7,700,6370
W2089,1,5/4/2022,QE42GFMUHC,500,5870
W2089,1,5/14/2022,QEE7ZLQ96Z,200,5670
W2089,1,5/17/2022,QEH15RMOD5,200,5470
W2090,1,4/12/2022,QDC39XVTOH,"2275",6475
W2090,1,4/22/2022,QDM3STSUC1,"2275",4200
W2090,1,4/27/2022,QDR22XKE3K,"2275",1925
W2090,1,4/29/2022,QDT768PKUX,"1930",5
W2090,2,5/6/2022,QE63KN289B,"2275",6275
W2090,2,5/15/2022,QEF51HD8CJ,"2275",4000
W2090,2,5/20/2022,QEK5BEJ1JV,"4000",0
W2090,3,6/4/2022,QF42567JFA,"7900",220
W2090,3,6/4/2022,QF425NSRX6,220,0
W2090,4,7/2/2022,QG21Q7K5QH,"15600",0
W2090,5,7/5/2022,QG59XQKQXB,"4000",11600
W2090,5,7/15/2022,QGF9HGO6VF,500,11100
W2090,5,7/28/2022,QGS484OJZE,"11100",0
W2090,6,8/26/2022,QHQ3TG8CZX,"1000",15320
W2090,6,8/26/2022,QHQ1TPSQ21,600,14720
W2090,6,8/30/2022,QHU22FUHT4,500,14220
W2090,6,8/30/2022,QHU62G6ILI,500,13720
W2090,6,9/2/2022,QI238ABGIP,500,13220
W2090,6,9/2/2022,QI2998XO4B,500,12720
W2090,6,9/3/2022,QI35C3L7N9,500,12220
W2090,6,9/5/2022,QI50FI6DGC,1002,11218
W2090,6,9/6/2022,QI62I1HIWQ,500,10718
W2090,6,9/7/2022,QI72KGX788,500,10218
W2090,6,9/14/2022,QIE8YDLK78,400,9818
W2091,1,4/7/2022,QD74ZU8ZCO,220,6280
W2091,1,4/8/2022,QD8726AWRZ,100,6180
W2091,1,4/8/2022,QD8726FIFL,100,6080
W2091,1,4/8/2022,QD8526ITO1,20,6060
W2091,1,4/9/2022,QD9252JKYM,100,5960
W2091,1,4/9/2022,QD9452LFH4,100,5860
W2091,1,4/10/2022,QDA96QQ7UT,100,5760
W2091,1,4/10/2022,QDA56QWECF,100,5660
W2091,1,4/11/2022,QDB18QRIK7,100,5560
W2091,1,4/11/2022,QDB88SDC6G,100,5460
W2091,1,4/11/2022,QDB38SFM37,20,5440
W2091,1,4/12/2022,QDC2AKLFIS,100,5340
W2091,1,4/12/2022,QDC9AMBZWJ,20,5320
W2091,1,4/12/2022,QDC1AOCR7V,100,5220
W2091,1,4/13/2022,QDD2CM3YTM,100,5120
W2091,1,4/13/2022,QDD2CM8KXW,50,5070
W2091,1,4/17/2022,QDH7JW3EM7,100,4970
W2091,1,4/17/2022,QDH0JW7EL2,100,4870
W2091,1,4/18/2022,QDI8LK0XDG,100,4770
W2091,1,4/19/2022,QDJ8NI8BRQ,100,4670
W2091,1,4/21/2022,QDL4R3TJ24,100,4570
W2091,1,4/21/2022,QDL9R3Z4S7,100,4470
W2091,1,4/24/2022,QDO5WJRAMZ,100,4370
W2091,1,4/24/2022,QDO6WJWATE,100,4270
W2091,1,4/25/2022,QDP4YJW3HO,100,4170
W2091,1,4/25/2022,QDP8YK0LU8,100,4070
W2091,1,4/26/2022,QDQ91E9C0D,100,3970
W2091,1,4/26/2022,QDQ81EEHI4,100,3870
W2091,1,4/28/2022,QDS556PO2X,100,3770
W2091,1,4/28/2022,QDS456SJKQ,100,3670
W2091,1,5/2/2022,QE24CON6F4,100,3570
W2091,1,5/2/2022,QE22COQ1PE,100,3470
W2091,1,5/2/2022,QE29CP5YET,100,3370
W2091,1,5/2/2022,QE20CP8VFO,100,3270
W2091,1,5/4/2022,QE43FHW1LH,3270,0
W2091,2,5/5/2022,QE58IK0EYW,100,6400
W2091,2,5/5/2022,QE50IK2N4I,100,6300
W2091,2,5/6/2022,QE69KK37MR,100,6200
W2091,2,5/6/2022,QE62KK6THA,100,6100
W2091,2,5/8/2022,QE85OHVKXF,100,6000
W2091,2,5/8/2022,QE89OHXEPL,100,5900
W2091,2,5/9/2022,QE91QE9859,100,5800
W2091,2,5/9/2022,QE92QEC4RO,100,5700
W2091,2,5/10/2022,QEA4S75TOG,100,5600
W2091,2,5/10/2022,QEA7S7XWGB,100,5500
W2091,2,5/12/2022,QEC3WAUMQN,100,5400
W2091,2,5/12/2022,QEC3WAX1ZH,100,5300
W2091,2,5/13/2022,QED4Y5CNMS,100,5200
W2091,2,5/13/2022,QED7Y9YPBT,100,5100
W2091,2,5/15/2022,QEF72UEXFD,100,5000
W2091,2,5/15/2022,QEF32V0S7P,100,4900
W2091,2,5/16/2022,QEG94WZ247,100,4800
W2091,2,5/16/2022,QEG14X2EH1,100,4700
W2091,2,5/20/2022,QEK5CADV2H,100,4600
W2091,2,5/20/2022,QEK7CAIW69,100,4500
W2091,2,5/23/2022,QEN5I632M9,100,4400
W2091,2,5/23/2022,QEN4I67AUS,100,4300
W2091,2,5/24/2022,QEO6K3T9V4,100,4200
W2091,2,5/24/2022,QEO7K3VIW3,100,4100
W2091,2,5/27/2022,QER3Q2H265,100,4000
W2091,2,5/27/2022,QER0Q2J3W8,100,3900
W2091,2,6/1/2022,QF13ZUGO21,100,3800
W2091,2,6/1/2022,QF11ZUK6RD,100,3700
W2091,2,6/2/2022,QF2825O728,3700,0
W2091,3,6/2/2022,QF304Z5BP0,100,6350
W2091,3,6/2/2022,QF364Z8UMC,100,6250
W2091,3,6/9/2022,QF92FA1BXM,400,5850
W2091,3,6/12/2022,QFC6MG82X0,100,5750
W2091,3,6/12/2022,QFC0MH9FES,100,5650
W2091,3,6/20/2022,QFK33B6QUR,100,5550
W2091,3,6/20/2022,QFK53BAO6V,100,5450
W2091,3,6/22/2022,QFM27GCWQE,100,5350
W2091,3,6/22/2022,QFM37GEODJ,100,5250
W2091,3,6/30/2022,QFU6M5I9ZC2,5250,0
W2091,4,7/4/2022,QG41VE9UHZ,100,10780
W2091,4,7/4/2022,QG41VEEK3T,100,10680
W2091,4,7/4/2022,QG48VEJ8LK,100,10580
W2091,4,7/5/2022,QG54XOJA4Y,100,10480
W2091,4,7/5/2022,QG54XOP6XI,100,10380
W2091,4,7/7/2022,QG732Y9ORR,100,10280
W2091,4,7/7/2022,QG702YGXPA,100,10180
W2091,4,7/7/2022,QG702YRW7S,100,10080
W2091,4,7/20/2022,QGK8T0H43K,100,9980
W2091,4,7/20/2022,QGK4T0L1MQ,100,9880
W2091,4,7/20/2022,QGK6T0PRZK,100,9780
W2091,4,7/20/2022,QGK3T0U5DV,30,9750
W2091,4,7/22/2022,QGM1VW43H9,100,9650
W2091,4,7/22/2022,QGM2VW7TEY,100,9550
W2091,4,7/22/2022,QGM9VWBG5T,100,9450
W2091,4,7/26/2022,QGQ45M1704,100,9350
W2091,4,7/26/2022,QGQ15M3UAB,100,9250
W2091,4,7/26/2022,QGQ75MAL95,100,9150
W2091,4,7/26/2022,QGQ95MD4HD,40,9110
W2091,4,7/28/2022,QGS89KQP2G,630,8480
W2091,4,7/31/2022,QGV1FP5T6L,100,8380
W2091,4,7/31/2022,QGV5FPTGTV,100,8280
W2091,4,7/31/2022,QGV5FPWLCP,100,8180
W2091,4,8/1/2022,QH10HVLM2M,100,8080
W2091,4,8/1/2022,QH16HVRECA,100,7980
W2091,4,8/1/2022,QH10HW31MU,100,7880
W2091,4,8/4/2022,QH45MLAXM7,100,7780
W2091,4,8/4/2022,QH41MV386B,7780,0
W2092,1,4/9/2022,QD98547WU0,434,5766
W2092,1,4/10/2022,QDA36WBORN,217,5549
W2092,1,4/11/2022,QDB28UGOCM,217,5332
W2092,1,4/12/2022,QDC7ARIQ51,217,5115
W2092,1,4/13/2022,QDD7COR8KB,217,4898
W2092,1,4/14/2022,QDE4EMW74U,217,4681
W2092,1,4/15/2022,QDF3GH88NV,217,4464
W2092,1,4/16/2022,QDG7ID6CMV,217,4247
W2092,1,4/17/2022,QDH7JY3GBJ,217,4030
W2092,1,4/18/2022,QDI3LOT7RF,217,3813
W2092,1,4/19/2022,QDJ5NJ63NL,217,3596
W2092,1,4/20/2022,QDK8PEOX8O,217,3379
W2092,1,4/21/2022,QDL2R78SAC,217,3162
W2092,1,4/23/2022,QDN6V0WKBC,434,2728
W2092,1,4/24/2022,QDO4WP99DQ,217,2511
W2092,1,4/25/2022,QDP4YNECKQ,217,2294
W2092,1,4/27/2022,QDR63H2RBG,434,1860
W2092,1,4/29/2022,QDT176IUGJ,434,1426
W2092,1,4/30/2022,QDU67NSNQ4,1426,0
W2092,2,5/7/2022,QE78L0QM2C,"1625",4825
W2092,2,5/22/2022,QEM3GAW1WH,"1600",3225
W2092,2,5/24/2022,QEO9IINKC3,"3225",0
W2092,3,6/4/2022,QF455PBQIP,"5600",0
W2092,4,6/11/2022,QFB4JM6XA4,"11200",0
W2092,5,6/15/2022,QFF6R8UA2O,"11200",0
W2092,6,6/27/2022,QFR7GAJEUN,"11300",0
W2093,1,4/30/2022,QDU17DDGFR,"8000",5000
W2093,1,5/4/2022,QE49F9CXVT,"5000",0
W2093,2,5/31/2022,QEV3WJIAK9,"12900",0
W2093,3,6/25/2022,QFP3C3RSLH,"12900",0
W2093,4,7/22/2022,QGM2W97M98,"13000",0
W2093,5,8/17/2022,QHH3CRERFD,"12900",0
W2094,1,4/16/2022,QDG7IC7XJ3,"1700",10900
W2094,1,4/20/2022,QDK2PA7Q5E,"2000",8900
W2094,1,4/26/2022,QDQ31KYBS9,800,8100
W2094,1,4/28/2022,QDS255U47G,"1000",7100
W2094,1,5/4/2022,QE41GKT8YT,3500,3600
W2094,1,5/5/2022,QE59ILHDDR,1600,2000
W2094,1,5/6/2022,QE64JEKOW0,2000,0
W2094,2,5/11/2022,QEB2UG3M9W,220,11680
W2094,2,5/12/2022,QEC4WDZ3RY,500,11180
W2094,2,5/13/2022,QED8Y5ZVIA,400,10780
W2094,2,5/17/2022,QEH56VX2BH,1100,9680
W2094,2,5/18/2022,QEI78PYR2L,800,8880
W2094,2,5/20/2022,QEK0CGZNFO,2000,6880
W2094,2,5/23/2022,QEN8I9SF9E,1200,5680
W2094,2,5/24/2022,QEO6K6KABO,1430,4250
W2094,2,5/25/2022,QEP2M4ZGHI,650,3600
W2094,2,5/26/2022,QEQ5O4P89Z,1380,2220
W2094,2,5/27/2022,QER8OFOKGE,2220,0
W2094,3,5/31/2022,QEV9X9OM65,"1000",11300
W2094,3,6/13/2022,QFD9OCKA67,750,10550
W2094,3,6/17/2022,QFH5VQ7UB5,"10550",0
W2094,4,7/14/2022,QGE9FZWDPT,"19350",0
W2094,5,7/27/2022,QGR97MQFWH,450,18000
W2094,5,8/3/2022,QH33M6AQ9Z,"8000",10000
W2094,5,8/4/2022,QH43N3CYE7,"10000",0
W2094,6,8/30/2022,QHU93AAXG7,"8000",15700
W2094,6,9/1/2022,QI117V5PWV,900,14800
W2094,6,9/3/2022,QI37A6H1PN,700,14100
W2094,6,9/4/2022,QI46EB8SE6,500,13600
W2094,6,9/14/2022,QIE9Z81YAB,300,13300
W2094,6,9/23/2022,QIN6ICKR9A,300,13000
W2094,6,9/24/2022,QIO4LVT7HY,300,12700
W2094,6,9/26/2022,QIQ8Q4PA1M,300,12400
W2094,6,10/2/2022,QJ244UF3RK,350,12050
W2094,6,10/12/2022,QJC8RB91J6,900,11150
W2094,6,10/14/2022,QJE2WMD24Y,200,10950
W2094,6,11/7/2022,QK77GWEIAR,800,10150
W2094,6,11/15/2022,QKF616J596,500,9650
W2094,6,11/18/2022,QKI4827CA0,400,9250
W2094,6,12/9/2022,QL90SZEC3S,100,9150
W2094,6,12/9/2022,QL98SZAMNK,100,9050
W2094,6,12/11/2022,QLB2YAPUGC,130,8920
W2094,6,12/20/2022,QLK3MV3CQ9,200,8720
W2094,6,1/13/2023,RAD3ADZ5DH,100,8620
W2094,6,1/13/2023,RAD2AENST8,100,8520
W2095,1,4/23/2022,QDN0TQE9GG,500,12100
W2095,1,4/27/2022,QDR01QHSJY,"4000",8100
W2095,1,5/6/2022,QE69JFTQI7,"8100",0
W2095,2,6/2/2022,QF291D32MD,"13000",0
W2095,3,6/23/2022,QFN98GISHH,"12300",0
W2095,4,7/20/2022,QGK4S5G2R6,"19500",0
W2095,5,8/16/2022,QHG4AQSHA8,"1987",17363
W2095,5,8/16/2022,QHG4ARIMFW,"17363",0
W2095,6,9/14/2022,QIE3Y3E2ZP,"19500",0
W2095,7,10/12/2022,QJC7R0MMI3,"19500",0
W2095,8,11/9/2022,QK94L618QC,"19500",0
W2095,9,12/8/2022,QL89PGU8VJ,500,19900
W2095,9,12/8/2022,QL86PBF3DE,"1000",18900
W2095,9,12/8/2022,QL82PACJG0,"2500",16400
W2095,9,12/13/2022,QLD22ZVRQQ,"16400",0
W2095,10,1/12/2023,RAC38B9CD5,500,21400
W2095,10,1/13/2023,RAD4BB47I8,350,21050
W2095,10,1/16/2023,RAG5HZCSQH,"2000",19050
W2095,10,1/17/2023,RAH2KJ2DWG,"8000",11050
W2095,10,1/18/2023,RAI4N01T9C,"2000",9050
W2095,10,1/19/2023,RAJ3Q2YW2R,"7550",1500
W2095,10,1/19/2023,RAJ2Q4VUUG,"1500",0
W2095,11,2/17/2023,RBH7UZF8JF,100,20300
W2095,11,2/18/2023,RBI4X6LQ1C,200,20100
W2095,11,2/20/2023,RBK43PYYT4,200,19900
W2095,11,2/22/2023,RBM77XYP3P,500,19400
W2095,11,3/1/2023,RC17QPJFRF,"1000",18400
W2095,11,3/3/2023,RC32VQV1MG,"1000",17400
W2095,11,3/6/2023,RC694Y5STJ,"5000",12400
W2095,11,3/7/2023,RC799L53Q5,200,12200
W2095,11,3/8/2023,RC91CZ3CHH,"2000",10200
W2095,11,3/22/2023,RCM1DGEKW1,300,9900
W2095,11,3/28/2023,RCS1SN17IT,"9900",0
W2096,1,4/26/2022,QDQ4YY64XI,200,6100
W2096,1,4/26/2022,QDQ1ZA9U2F,50,6050
W2096,1,5/4/2022,QE46GLJXMA,550,5500
W2096,1,5/4/2022,QE47GLL2MF,550,4950
W2096,1,5/7/2022,QE76L26TY4,4950,0
W2096,2,6/4/2022,QF4658QDW2,"1550",5250
W2096,2,6/6/2022,QF689MG5KQ,"4800",450
W2096,2,6/6/2022,QF679W3MUV,450,0
W2096,3,6/14/2022,QFE3PIN223,"5600",0
W2096,4,6/20/2022,QFK92OYN1Z,"5600",0
W2096,5,7/22/2022,QGM9VU8R6H,300,10580
W2096,5,7/23/2022,QGN6XT6DMI,"10580",0
W2097,1,4/24/2022,QDO1VICGCH,"5000",7300
W2097,1,4/29/2022,QDT76JNKEF,"6000",1300
W2097,1,5/4/2022,QE47FCK01J,"1300",0
W2097,2,5/14/2022,QEE9YRTEFP,"4000",8300
W2097,2,5/16/2022,QEG04O4VOS,"3100",5200
W2097,2,5/20/2022,QEK3AY1ZMB,"2400",2800
W2097,2,5/26/2022,QEQ5MOPHRZ,1900,900
W2097,2,5/27/2022,QER5OHRSC7,900,0
W2097,3,6/7/2022,QF74B42GRE,"6000",6300
W2097,3,6/8/2022,QF85EMR2AP,"3000",3300
W2097,3,6/9/2022,QF95G4N3UJ,"1500",1800
W2097,3,6/9/2022,QF92GUG2B2,1800,0
W2097,4,7/4/2022,QG43TS2JPP,"2500",16700
W2097,4,7/6/2022,QG69YRTVDP,"8500",8200
W2097,4,7/6/2022,QG68Z21N0M,"8200",0
W2097,5,7/21/2022,QGL3TNUD2V,"17400",0
W2097,6,8/10/2022,QHA4YJSOT0,"18150",0
W2097,7,9/24/2022,QIO3K7F781,"4000",16400
W2097,7,9/27/2022,QIR8RZMQF8,500,15900
W2097,7,9/29/2022,QIT1VODTQX,500,15400
W2097,7,10/4/2022,QJ487ORQLS,500,14900
W2097,7,10/7/2022,QJ77FFVYL1,1000,13900
W2097,7,10/10/2022,QJA3LKRUZF,500,13400
W2097,7,10/11/2022,QJB7OPL449,500,12900
W2097,7,11/9/2022,QK96KO5N9A,0,12900
W2097,7,11/9/2022,QK98M7A5BS,0,12900
W2097,7,1/9/2023,RA911U6ZP9,3000,9900
W2097,7,3/13/2023,RCE9RCZOAV,500,9400
W2097,7,3/24/2023,RCO0K21LCE,500,8900
W2097,7,5/29/2023,RET5QSE0ST,500,8400
W2097,7,6/26/2023,RFQ2ZG3IL4,2000,6400
W2097,7,7/5/2023,RG57SP14KT,1000,5400
W2097,7,8/3/2023,RH3962D11L,1000,4400
W2098,1,5/14/2022,QEE3YYT28B,"12000",1000
W2098,1,5/14/2022,QEE0Z1ZG6M,"1000",0
W2098,2,6/11/2022,QFB0JMN8O4,"13000",0
W2098,3,6/27/2022,QFR4G625NC,"11700",0
W2098,4,7/22/2022,QGM4W4CKLA,"19050",0
W2098,5,8/18/2022,QHI1EMCNVJ,100,20300
W2098,5,8/18/2022,QHI6ERCGI4,"3500",16800
W2098,5,8/18/2022,QHI9ETRX6F,100,16700
W2098,5,8/19/2022,QHJ6GG33DK,100,16600
W2098,5,8/19/2022,QHJ5GG8Y3N,100,16500
W2098,5,8/24/2022,QHO1QEO7I7,16500,0
W2099,1,4/22/2022,QDM2SNY1ZQ,500,5850
W2099,1,4/25/2022,QDP0X44CI4,500,5350
W2099,1,4/27/2022,QDR1306NSB,300,5050
W2099,1,4/29/2022,QDT85FUPZS,400,4650
W2099,1,5/2/2022,QE23CKDMEH,900,3750
W2099,1,5/10/2022,QEA9R4U175,3750,0
W2099,2,6/13/2022,QFD5NPO4XV,500,6800
W2099,2,6/15/2022,QFF1RY6XZ1,"4170",2630
W2099,2,6/28/2022,QFT2JUMSNU,"2630",0
W20100,1,4/26/2022,QDQ3ZROP4N,"3250",9750
W20100,1,5/5/2022,QE55GYXXEF,"3250",6500
W20100,1,5/10/2022,QEA5QR7T9H,"3250",3250
W20100,1,5/15/2022,QEF71VLNR9,"3250",0
W20100,2,6/10/2022,QFA7HGJ06T,"4000",9000
W20100,2,6/12/2022,QFC0MV1I80,"2000",7000
W20100,2,6/13/2022,QFD4NHO5I2,"7000",0
W20100,3,7/5/2022,QG54WJGHZK,"8900",3500
W20100,3,7/1/2022,QG18O6DBNQ,"3500",0
W20100,4,7/29/2022,QGT6A8ZWH4,"12500",0
W20100,5,8/10/2022,QHA5ZE86EX,700,12300
W20100,5,8/19/2022,QHJ9GTTIXT,300,12000
W20100,5,8/25/2022,QHP5SASL7L,"11050",950
W20100,5,8/26/2022,QHQ9T6ZK0J,950,0
W20101,1,4/26/2022,QDQ1ZW0SKL,"1625",4500
W20101,1,5/4/2022,QE44F2FL3S,"1650",2850
W20101,1,5/10/2022,QEA3SDZKGL,"2850",0
W20101,2,5/23/2022,QEN4HH8K0M,"1625",4475
W20101,2,5/30/2022,QEU0VQO3B0,"1630",2845
W20101,2,6/6/2022,QF699K71MP,"2845",0
W20101,3,6/13/2022,QFD7OSYCOP,"1530",4620
W20101,3,6/21/2022,QFL73WQBX7,"1650",2970
W20101,3,6/27/2022,QFR3H0XH4H,"1390",1580
W20101,3,6/28/2022,QFS6HSIARQ,1580,0
W20101,4,7/14/2022,QGE3H98D8N,"5550",400
W20101,4,7/15/2022,QGF3JA9JG5,400,0
W20101,5,8/11/2022,QHB81GWXGA,"5200",1300
W20101,5,8/11/2022,QHB61WNPHI,"1300",0
W20102,1,4/22/2022,QDM6SFSSAC,260,7480
W20102,1,4/23/2022,QDN4UJE31M,260,7220
W20102,1,4/24/2022,QDO9WLUPYR,260,6960
W20102,1,4/26/2022,QDQ9YRQXNB,260,6700
W20102,1,4/27/2022,QDR12Z8MD1,520,6180
W20102,1,4/30/2022,QDU196UD3P,260,5920
W20102,1,5/1/2022,QE15AY9ODZ,260,5660
W20102,1,5/3/2022,QE34DFN8RS,260,5400
W20102,1,5/5/2022,QE56ILJJWW,260,5140
W20102,1,5/6/2022,QE67KCDVX3,260,4880
W20102,1,5/7/2022,QE75MNUJFL,260,4620
W20102,1,5/9/2022,QE98P21FRS,520,4100
W20102,1,5/14/2022,QEE9ZMIGK3,260,3840
W20102,1,5/16/2022,QEG44QCMZK,520,3320
W20102,1,5/18/2022,QEI137M3ZPB,3320,0
W20102,2,5/19/2022,QEJ79X13PL,260,7360
W20102,2,5/22/2022,QEM8FNT60U,520,6840
W20102,2,5/27/2022,QER8PT0R2K,"1000",5840
W20102,2,6/1/2022,QF17Z8A04Z,1000,4840
W20102,2,6/7/2022,QF71CZ5CB1,260,4580
W20102,2,6/11/2022,QFB4JZOKQ0,1000,3580
W20102,2,6/13/2022,QFD6NMNA76,3560,20
W20102,2,6/13/2022,QFD9NNOTRN,20,0
W20102,3,6/20/2022,QFK72DE517,"2000",5140
W20102,3,7/1/2022,QG18NU625C,"5140",0
W20102,4,7/14/2022,QGE6HACM00,"4000",3560
W20102,4,7/22/2022,QGM3VEYNXN,400,3160
W20102,4,7/25/2022,QGQ04149U,"3160",0
W20102,5,8/13/2022,QHD74X6G0N,"7140",0
W20102,6,8/16/2022,QHG0BMJGXE,500,7120
W20102,6,8/21/2022,QHL7KFS6EJ,"1400",5720
W20102,6,8/29/2022,QHT2ZZX46O,250,5470
W20102,6,9/5/2022,QI55FNFYBR,3000,2470
W20102,6,9/6/2022,QI65IJRUQP,300,2170
W20102,6,9/7/2022,QI77J7BV31,300,1870
W20102,6,9/8/2022,QI87KWYNT9,1870,0
W20102,7,9/27/2022,QIR4QCZ2TK,"1400",8080
W20102,7,9/29/2022,QIT7UU3SDD,950,7130
W20102,7,9/30/2022,QIU7X54OK1,650,6480
W20102,7,10/7/2022,QJ79FZZ4H3,100,6380
W20102,7,10/7/2022,QJ71G07NR3,100,6280
W20102,7,10/26/2022,QJQ9M3PWC5,350,5930
W20102,7,10/29/2022,QJT1T1A33P,200,5730
W20102,7,11/3/2022,QK336LLGOZ,250,5480
W20102,7,11/18/2022,QKI35UR7SL,300,5180
W20102,7,11/26/2022,QKQ1P4Z42V,500,4680
W20102,7,11/29/2022,QKU9XJDYM3,300,4380
W20102,7,12/6/2022,QL69KAEPGJ,400,3980
W20102,7,12/12/2022,QLC41VZR1Y,300,3680
W20103,1,4/23/2022,QDN2UKPP9S,300,5800
W20103,1,4/24/2022,QDO9WH5GBN,300,5500
W20103,1,4/25/2022,QDP5YIMFGF,300,5200
W20103,1,4/26/2022,QDQ01FYBPE,300,4900
W20103,1,4/27/2022,QDR038YTT2,220,4680
W20103,1,4/28/2022,QDS7583XTT,380,4300
W20103,1,4/29/2022,QDT470AM8C,300,4000
W20103,1,4/30/2022,QDU8931RRG,300,3700
W20103,1,5/1/2022,QE18AWZ0XI,300,3400
W20103,1,5/2/2022,QE26CS4UE8,300,3100
W20103,1,5/3/2022,QE37EME8IL,300,2800
W20103,1,5/4/2022,QE47GLISRR,300,2500
W20103,1,5/5/2022,QE50IIVZEE,300,2200
W20103,1,5/6/2022,QE62KIRPF2,300,1900
W20103,1,5/7/2022,QE76MJ5OHY,300,1600
W20103,1,5/8/2022,QE84ODB3C6,300,1300
W20103,1,5/9/2022,QE98QBZ1KA,300,1000
W20103,1,5/10/2022,QEA9SFNCRT,300,700
W20103,1,5/11/2022,QEB3SZZN8J,700,0
W20103,2,5/12/2022,QEC1W586GT,300,5350
W20103,2,5/13/2022,QED8Y4TPWE,300,5050
W20103,2,5/14/2022,QEE51C5061,300,4750
W20103,2,5/15/2022,QEF730AMK7,300,4450
W20103,2,5/16/2022,QEG24Y5AK4,300,4150
W20103,2,5/17/2022,QEH86SOCOE,300,3850
W20103,2,5/18/2022,QEI38NN0UT,300,3550
W20103,2,5/19/2022,QEJ5ADAVQ5,300,3250
W20103,2,5/20/2022,QEK3CJXU13,300,2950
W20103,2,5/21/2022,QEL7EJ8TE3,300,2650
W20103,2,5/22/2022,QEM4G6PWR8,300,2350
W20103,2,5/23/2022,QEN8GPHNZ2,2350,0
W20103,3,5/24/2022,QEO7K3L0Q7,300,5600
W20103,3,5/25/2022,QEP5M1TLLL,300,5300
W20103,3,5/27/2022,QER0PV784A,600,4700
W20103,3,5/29/2022,QET9TWYW2P,550,4150
W20103,3,5/30/2022,QEU5VXJY5X,350,3800
W20103,3,5/31/2022,QEV7XPDDXF,250,3550
W20103,3,6/1/2022,QF17ZX185F,250,3300
W20103,3,6/2/2022,QF291R31TN,3300,0
W20103,4,6/3/2022,QF344SZ11K,300,5300
W20103,4,6/4/2022,QF446YLSXM,300,5000
W20103,4,6/7/2022,QF70CZ6FBG,300,4700
W20103,4,6/8/2022,QF83EPJTTH,300,4400
W20103,4,6/10/2022,QFA1I6QXZ3,4400,0
W20103,5,6/12/2022,QFC8MODRGQ,350,9810
W20103,5,6/13/2022,QFD0OMO2PI,350,9460
W20103,5,6/14/2022,QFE0QRKG1A,200,9260
W20103,5,6/16/2022,QFG2UQCQTO,350,8910
W20103,5,6/17/2022,QFH6WT5HF8,350,8560
W20103,5,6/19/2022,QFJ81LIH6U,200,8360
W20103,5,6/21/2022,QFL25I9P7S,300,8060
W20103,5,6/22/2022,QFM77CTV53,300,7760
W20103,5,6/24/2022,QFO9BGP65B,300,7460
W20103,5,6/27/2022,QFR8H5SX0U,300,7160
W20103,5,6/29/2022,QFT5L6RRO5,300,6860
W20103,5,7/3/2022,QG33THLT0H,500,6360
W20103,5,7/4/2022,QG46VNAPAM,500,5860
W20103,5,7/5/2022,QG52XSHV7G,1000,4860
W20103,5,7/6/2022,QG68ZWU6E6,4860,0
W20103,6,7/8/2022,QG8757WSI7,300,10020
W20103,6,7/9/2022,QG9973WPYN,300,9720
W20103,6,7/11/2022,QGB0B8DJNQ,300,9420
W20103,6,7/12/2022,QGC6DBSW6G,300,9120
W20103,6,7/14/2022,QGE1H8T6F1,300,8820
W20103,6,7/16/2022,QGG9LHPALZ,300,8520
W20103,6,7/17/2022,QGH3N0GGU3,300,8220
W20103,6,7/18/2022,QGI2P6HYKU,300,7920
W20103,6,7/19/2022,QGJ9R2BJJB,300,7620
W20103,6,7/20/2022,QGK9T5WB89,300,7320
W20103,6,7/25/2022,QGP83M3TWO,700,6620
W20103,6,7/27/2022,QGR87OILE4,400,6220
W20103,6,7/28/2022,QGS89QN0RS,400,5820
W20103,6,7/29/2022,QGT4BQSX2E,400,5420
W20103,6,7/31/2022,QGV8FNB96Y,400,5020
W20103,6,8/1/2022,QH10HWQKSW,300,4720
W20103,6,8/2/2022,QH23K1BH7R,800,3920
W20103,6,8/4/2022,QH43MCMNP9,1000,2920
W20103,6,8/4/2022,QH49NAY78R,2920,0
W20103,7,8/6/2022,QH68SSMFC8,400,9920
W20103,7,8/8/2022,QH83WNHT0H,500,9420
W20103,7,8/9/2022,QH91Y9AIZF,350,9070
W20103,7,8/10/2022,QHA5ZW2X7B,350,8720
W20103,7,8/12/2022,QHC94NPRU5,500,8220
W20103,7,8/16/2022,QHG9BOKFM7,500,7720
W20103,7,8/17/2022,QHH2DJOIUI,500,7220
W20103,7,8/19/2022,QHJ2HF4V3M,500,6720
W20103,7,8/21/2022,QHL9L5X1BD,500,6220
W20103,7,8/22/2022,QHM9N018RZ,400,5820
W20103,7,8/23/2022,QHN6OZR0DM,500,5320
W20103,7,8/24/2022,QHO1QVG5BH,500,4820
W20103,7,8/25/2022,QHP0SP06UG,500,4320
W20103,7,8/26/2022,QHQ3UUBU89,500,3820
W20103,7,8/27/2022,QHR4WWYTX4,500,3320
W20103,7,8/28/2022,QHS9YF1M1V,500,2820
W20103,7,8/29/2022,QHT41O6FTY,400,2420
W20103,7,8/30/2022,QHU03Q9CNW,600,1820
W20103,7,8/31/2022,QHV84G8O7O,1820,0
W20103,8,9/1/2022,QI127V2FA2,350,10050
W20103,8,9/6/2022,QI60IHVA6I,500,9550
W20103,8,9/8/2022,QI87MQNX3Z,400,9150
W20103,8,9/13/2022,QID2X4Z4A6,500,8650
W20103,8,9/14/2022,QIE6Z4MIU2,500,8150
W20103,8,9/16/2022,QIG94KOQU5,500,7650
W20103,8,9/19/2022,QIJ6ATT6ES,500,7150
W20103,8,9/20/2022,QIK8D29ORS,500,6650
W20103,8,9/22/2022,QIM9HDJ22B,500,6150
W20103,8,9/24/2022,QIO5JPXZRV,500,5650
W20103,8,9/26/2022,QIQ7Q6LDTR,400,5250
W20103,8,9/27/2022,QIR2SCVUD8,400,4850
W20103,8,9/29/2022,QIT2UO8W76,400,4450
W20103,8,9/29/2022,QIT7V759AP,3970,480
W20104,1,5/12/2022,QEC7W8A5B1,800,13800
W20104,1,5/13/2022,QED3Y55POP,"1400",12400
W20104,1,5/19/2022,QEJ7AGP2XV,100,12300
W20104,1,5/19/2022,QEJ1AHH17J,100,12200
W20104,1,5/19/2022,QEJ9AHU97L,50,12150
W20104,1,5/19/2022,QEJ5AI83QZ,600,11550
W20104,1,5/20/2022,QEK8C7LF2Q,100,11450
W20104,1,5/20/2022,QEK3C7RSV3,100,11350
W20104,1,5/20/2022,QEK3C7XFFL,100,11250
W20104,1,5/20/2022,QEK7C866HX,700,10550
W20104,1,5/12/2022,QEC1W1OX83,600,9950
W20104,1,5/14/2022,QEE0ZZ8TL2,900,9050
W20104,1,5/27/2022,QER2PUS676,500,8550
W20105,1,5/11/2022,QE44GLR8VQ,"1950",5250
W20105,1,5/11/2022,QEB1UD1CHN,"1950",3300
W20105,1,5/16/2022,QEG646HGYE,"3300",0
W20105,2,7/22/2022,QGM7VWDQMN,500,8980
W20106,1,5/9/2022,QE92PW37ZA,"1625",4875
W20106,1,5/13/2022,QED5Y08MZL,"1625",3250
W20106,1,5/20/2022,QEK2CB43R0,"1625",1625
W20106,1,5/23/2022,QEN4GKZTC2,"1625",0
W20106,2,6/16/2022,QFG1U7652B,"1625",6275
W20106,2,6/17/2022,QFH6WSPHA4,800,5475
W20106,2,7/1/2022,QG17NUX28L,1000,4475
W20106,2,7/5/2022,QG52XONN0E,500,3975
W20107,1,5/12/2022,QEC2WCSXZW,"1000",8480
W20107,1,5/19/2022,QEJ993XHQB,"1500",6980
W20107,1,6/4/2022,QF455EJ8UT,"1300",5680
W20108,1,5/19/2022,QEJ99WNQZT,"1500",8900
W20108,1,5/27/2022,QER0OIP0R6,"1000",7900
W20108,1,5/30/2022,QEU5UAIGM9,"1000",6900
W20108,1,5/31/2022,QEV6W4VN0G,600,6300
W20108,1,5/31/2022,QEV8XXBIX0,5400,900
W20108,1,5/23/2022,QEN4GG9FSA,1100,200
W20108,2,5/31/2022,QEV1WU1L8J,800,9280
W20108,2,6/21/2022,QFL93Y6F3N,700,8580
W20108,2,6/25/2022,QFP9BW83JL,"8580",0
W20108,3,7/13/2022,QGD2EADHC6,"2300",7780
W20108,3,7/15/2022,QGF1HQ03I7,500,7280
W20108,3,7/19/2022,QGJ4Q1C3RA,"7280",0
W20108,4,8/2/2022,QH27IQGQKV,100,10300
W20108,4,8/2/2022,QH27J5SG3B,100,10200
W20108,4,8/2/2022,QH24JOWHO8,100,10100
W20108,4,8/3/2022,QH30KTBR2Q,300,9800
W20108,4,8/5/2022,QH55OYVPBZ,100,9700
W20108,4,8/6/2022,QH63QU5DIL,100,9600
W20108,4,8/7/2022,QH70UL6GWA,100,9500
W20108,4,8/10/2022,QHA4YHO9IW,300,9200
W20108,4,8/15/2022,QHF88BIJAW,1000,8200
W20108,4,8/15/2022,QHF296NGJE,2300,5900
W20108,4,8/16/2022,QHG3A2M0N1,700,5200
W20108,4,8/16/2022,QHG8AMB8RK,1500,3700
W20108,4,8/16/2022,QHG8AX0816,3700,0
W20108,5,9/1/2022,QI167XF6SW,100,10300
W20108,5,9/2/2022,QI219H4G5Z,100,10200
W20108,5,9/13/2022,QID1WDVGMR,"10200",0
W20108,6,10/11/2022,QJB2OKN57I,"10400",0
W20108,7,11/8/2022,QK88IQ6NUA,"10400",0
W20108,8,11/21/2022,QKL5CTXAJ7,500,9900
W20108,8,12/1/2022,QL121KTON0,500,9400
W20108,8,12/5/2022,QL55FU478L,"9400",0
W20108,9,1/2/2023,RA27KER7GN,"10400",0
W20108,10,2/1/2023,RAV0MGWLAY,"10400",0
W20108,11,3/1/2023,RC16SHFF6K,"10400",0
W20108,12,3/29/2023,RCT3W7D49X,"10080",240
W20108,12,3/29/2023,RCT0W8KNIO,100,140
W20108,12,3/29/2023,RCT1W90KUF,90,50
W20108,12,3/29/2023,RCT2W94SCM,50,0
W20108,13,4/26/2023,RDQ84OA8WK,"10400",0
W20108,14,6/2/2023,RF26ZQ1MW0,600,10280
W20108,14,6/7/2023,RF74GCXE54,750,9530
W20108,14,6/26/2023,RFQ6ZMW58E,500,9030
W20108,14,7/6/2023,RG61T9KZE9,50,8980
W20108,14,7/11/2023,RGB98P7W3T,50,8930
W20108,14,8/9/2023,RH96MHHORO,100,8830
W20109,1,6/8/2022,QF84E9JLG0,"5000",9600
W20109,1,6/11/2022,QFB7K9T2P7,"3000",6600
W20109,1,6/15/2022,QFF4RB447Q,"2500",4100
W20109,1,6/18/2022,QFI0XN4MHG,"4100",0
W20109,2,7/13/2022,QGD3DQUMCF,"8000",2320
W20109,2,7/15/2022,QGF4IK9P1Q,"2200",120
W20109,2,7/16/2022,QGG1L9K0UB,120,0
W20109,3,8/22/2022,QHM1LMMQCN,"12900",0
W20109,4,9/27/2022,QIR1R0GR2T,"1000",14800
W20109,4,10/2/2022,QJ212ZZUE5,500,14300
W20109,4,10/3/2022,QJ386TQV2Y,300,14000
W20109,4,10/5/2022,QJ599NS8X3,300,13700
W20109,4,10/9/2022,QJ93KGWZNR,300,13400
W20109,4,12/7/2022,QL71LB38NF,2000,11400
W20110,1,5/31/2022,QEV1WVX3O3,"1000",12000
W20110,1,5/3/2022,QF3148LURV,"12000",0
W20110,2,6/27/2022,QFR0FZLCXO,"3000",9900
W20110,2,6/30/2022,QFU9M46TKD,"9900",0
W20111,1,5/31/2022,QEV8W953TA,"1300",7460
W20111,1,6/8/2022,QF82E7BNMK,"2000",5460
W20111,1,6/15/2022,QFF7R6U5K9,"1000",4460
W20111,1,6/16/2022,QFG4UQHI5S,500,3960
W20111,1,6/20/2022,QFK332C907,1400,2560
W20111,1,6/21/2022,QFL953POFR,800,1760
W20111,1,6/24/2022,QFO5ADT6VB,1760,0
W20111,2,7/1/2022,QG14P2CX8E,1000,4040
W20111,2,7/19/2022,QGJ8QBSEEA,"4040",0
W20111,3,8/16/2022,QHG3AQZF4D,7800,0
W2112,1,5/17/2022,QEH85X2YTA,"1950",6210
W2112,1,5/24/2022,QEO3K3W2XX,"1950",4260
W2112,1,6/7/2022,QF74CRBHX4,"2000",2260
W2112,1,6/8/2022,QF83EEUWK3,"2260",0
W2112,2,6/28/2022,QFS4I5QDXO,"7320",0
W2112,3,7/20/2022,QGK2RTYSZE,"11250",0
W2112,4,8/13/2022,QHD058B6PA,500,13720
W2112,4,8/16/2022,QHG0B31W76,495,13225
W2112,4,8/23/2022,QHN2NMZWRI,300,12925
W2112,4,8/24/2022,QHO5QNUFOR,100,12825
W2112,4,8/24/2022,QHO1QNZHN7,100,12725
W2112,4,8/26/2022,QHQ6T9F7EM,100,12625
W2112,4,8/26/2022,QHQ7TA4QCL,100,12525
W2112,4,9/12/2022,QIC2V69TLQ,200,12325
W2112,4,9/29/2022,QIT3WDG7XH,100,12225
W2112,4,10/15/2022,QJF7XPE23Z,100,12125
W2112,4,10/15/2022,QJF4XPIA76,25,12100
W2112,4,10/27/2022,QJR7OYKAG3,100,12000
W2112,4,10/27/2022,QJR6OYNU3C,40,11960
W2112,4,11/2/2022,QK233YD189,100,11860
W20113,1,5/21/2022,QEL8EDT2L4,"1450",5050
W20113,1,5/25/2022,QEP8LXZKVI,"2000",3050
W20113,1,6/1/2022,QF19ZS5EPH,"1500",1550
W20113,1,6/7/2022,QF76BVZ3DS,400,1150
W20113,1,6/8/2022,QF82EC9MMS,1150,0
W20113,2,6/28/2022,QFS7I06DX7,"6100",0
W20113,3,7/29/2022,QGT3A1PUW5,500,12140
W20114,1,6/9/2022,QF98G2U2Q2,"5200",0
W20114,2,7/9/2022,QG94634B14,"2380",0
W20115,1,5/14/2022,QEE21AUJPW,130,3770
W20115,1,5/16/2022,QEG74YIBBJ,100,3670
W20115,1,5/16/2022,QEG04YLEHU,100,3570
W20115,1,5/16/2022,QEG24YM7FA,60,3510
W20115,1,5/17/2022,QEH56VF5M1,100,3410
W20115,1,5/17/2022,QEH76VFMI5,30,3380
W20115,1,5/26/2022,QEQ0MP5RXI,1040,2340
W20115,1,6/7/2022,QF72BLVHIO,2340,0
W20115,2,6/22/2022,QFM465INOS,"3840",0
W20115,3,7/20/2022,QGK7RLKGDZ,"6500",0
W20115,4,8/17/2022,QHH1DHHHQB,"6500",0
W20115,5,9/10/2022,QIA8P4GYZE,"6200",0
W20116,1,6/6/2022,QF6599O1IT,"13000",0
W20116,2,7/23/2022,QGN7XMWIMF,500,14100
W20116,2,7/25/2022,QGP824W3I4,"14100",0
W20117,1,6/11/2022,QFB6JRLQZS,"13000",0
W20117,2,7/8/2022,QG813AD37Z,"13000",0
W20118,1,5/26/2022,QEQ1NOZGPX,"1950",5610
W20118,1,6/3/2022,QF333PTV1T,"1950",3660
W20118,1,6/10/2022,QFA7H0QUEF,"1950",1710
W20118,1,6/13/2022,QFD6NQRNES,"1600",110
W20118,1,6/14/2022,QFE0Q4ALVS,100,10
W20118,1,6/18/2022,QFI6XBIXMY,10,0
W20118,2,8/2/2022,QH28J53NT4,"1950",5850
W20118,2,8/10/2022,QHA5ZAP9H9,"1950",3900
W20118,2,8/16/2022,QHG1BC4RSJ,"1950",1950
W20118,2,8/22/2022,QHM2LOYZ8K,1950,0
W20118,3,8/29/2022,QHT219SOEG,"1950",5850
W20118,3,9/5/2022,QI54FUB7WY,"1950",3900
W20118,3,9/13/2022,QID1X4CBER,"1950",1950
W20118,3,9/19/2022,QIJ5B0N91L,1950,0
W20118,4,9/27/2022,QIR7S7WQ1X,"1950",5370
W20118,4,10/4/2022,QJ487W97QC,"1950",3420
W20118,4,10/10/2022,QJA9NDN6RR,"3360",60
W20118,4,10/12/2022,QJC5RZI997,60,0
W20118,5,10/25/2022,QJP6K65GAO,"3000",3720
W20118,5,10/26/2022,QJQ7NAUMHF,"3720",0
W20118,6,11/3/2022,QK397HZTC9,"2275",6825
W20118,6,11/13/2022,QKD1VEE8QX,"2275",4550
W20118,6,11/17/2022,QKH14RTCR7,"2275",2275
W20118,6,11/24/2022,QKO6KZEAZC,2275,0
W20118,7,12/14/2022,QLE15W27Y1,"7840",0
W20119,1,6/8/2022,QF81ETTZ0J,200,5950
W20119,1,6/11/2022,QFB4J9TGDI,300,5650
W20119,1,6/13/2022,QFD4OU2SRI,500,5150
W20119,1,6/28/2022,QFS9HY6IU9,"5150",0
W20119,2,7/16/2022,QGG0JVOAJC,"5900",50
W20119,2,7/16/2022,QGG5JXFPO9,50,0
W20119,3,8/5/2022,QH50OZP7RC,280,6220
W20119,3,8/6/2022,QH69RAJDEL,320,5900
W20119,3,8/8/2022,QH86V8AK66,280,5620
W20119,3,8/9/2022,QH92Y93E9S,280,5340
W20119,3,8/10/2022,QHA0ZU0ZDW,300,5040
W20119,3,8/11/2022,QHB61FD26E,5040,0
W20120,1,6/8/2022,QF86EYOQQW,175,4705
W20120,1,6/9/2022,QF99GWQ4OR,185,4520
W20120,1,6/10/2022,QFA4J0I7LY,180,4340
W20120,1,6/11/2022,QFB7L2STFR,180,4160
W20120,1,6/12/2022,QFC9MTDSDT,180,3980
W20120,1,6/13/2022,QFD7OTJZN7,180,3800
W20120,1,6/14/2022,QFE1QTB0YL,180,3620
W20120,1,6/15/2022,QFF0SU01WO,180,3440
W20120,1,6/16/2022,QFG7UVJESF,180,3260
W20120,1,6/17/2022,QFH1WTY1PZ,100,3160
W20120,1,6/17/2022,QFH6WU2OL2,80,3080
W20120,1,6/18/2022,QFI7YWHTDR,180,2900
W20120,1,6/19/2022,QFJ81MKTV0,180,2720
W20120,1,6/20/2022,QFK43LIJEO,180,2540
W20120,1,6/21/2022,QFL25ICYIK,180,2360
W20120,1,6/23/2022,QFN49C1XT0,180,2180
W20120,1,6/23/2022,QFN39C9FCV,180,2000
W20120,1,6/25/2022,QFP6DC0UAQ,260,1740
W20120,1,6/25/2022,QFP3DC4J8H,100,1640
W20120,1,6/26/2022,QFQ5F36XHV,100,1540
W20120,1,6/26/2022,QFQ4F3A434,80,1460
W20120,1,6/27/2022,QFR7H4417T,100,1360
W20120,1,6/27/2022,QFR8H46YDY,80,1280
W20120,1,6/28/2022,QFS0HJXDFS,1280,0
W20120,2,6/29/2022,QFT8L72OPE,180,5000
W20120,2,6/30/2022,QFU4MYZ396,180,4820
W20120,2,7/1/2022,QG15P8SFDL,180,4640
W20120,2,7/3/2022,QG36TDJUQO,180,4460
W20120,2,7/3/2022,QG35TDQJCB,180,4280
W20120,2,7/4/2022,QG42VK47VE,180,4100
W20120,2,7/7/2022,QG70ZZLRW0,360,3740
W20120,2,7/7/2022,QG772ZDWJV,180,3560
W20120,2,7/8/2022,QG8454YSU8,180,3380
W20120,2,7/10/2022,QGA87EPXE0,180,3200
W20120,2,7/10/2022,QGA88ZPBCC,180,3020
W20120,2,7/11/2022,QGB1B7UO4F,180,2840
W20120,2,7/12/2022,QGC5DBV3X9,180,2660
W20120,2,7/13/2022,QGD8FAVHIW,180,2480
W20120,2,7/14/2022,QGE6HCVLYG,180,2300
W20120,2,7/15/2022,QGF5JECF8R,180,2120
W20120,2,7/19/2022,QGJ7PNWK3J,540,1580
W20120,2,7/19/2022,QGJ5R3N54N,180,1400
W20120,2,7/26/2022,QGQ345QYE5,1400,0
W20120,3,7/28/2022,QGS79LOMID,180,4870
W20120,3,7/30/2022,QGU5DQLDA7,360,4510
W20120,3,8/5/2022,QH59QFS2TT,360,4150
W20120,3,8/5/2022,QH51QG2A39,360,3790
W20120,3,8/5/2022,QH59QG7OLZ,180,3610
W20120,3,8/11/2022,QHB52TK4NR,1080,2530
W20120,3,8/12/2022,QHC74NLDSN,180,2350
W20120,3,8/15/2022,QHF19QCN8X,350,2000
W20120,3,8/16/2022,QHG4AGDPLY,2000,0
W20120,4,8/17/2022,QHH9DJB3A3,180,6140
W20120,4,9/15/2022,QIF72FXFBV,480,5660
W20120,4,9/19/2022,QIJ8AYQPCQ,360,5300
W20120,4,9/25/2022,QIP5NVA3CV,1200,4100
W20120,4,9/29/2022,QIT2WV9V7W,500,3600
W20121,1,6/23/2022,QFN683X3L8,"1000",11200
W20121,1,6/28/2022,QFS9HXR49T,"11200",0
W20121,2,7/25/2022,QGP62KVRA6,"2000",11000
W20121,2,7/25/2022,QGP13G2ONN,"11000",0
W20121,3,8/22/2022,QHM6M1RS3K,"13000",0
W20122,1,6/8/2022,QF81EY2X8F,217,6283
W20122,1,6/9/2022,QF96GXSWTS,217,6066
W20122,1,6/10/2022,QFA8J05MXY,217,5849
W20122,1,6/11/2022,QFB8L3YXP2,217,5632
W20122,1,6/12/2022,QFC7MV84RP,217,5415
W20122,1,6/13/2022,QFD4OU2LQQ,217,5198
W20122,1,6/14/2022,QFE4QTT7IK,217,4981
W20122,1,6/15/2022,QFF6SSNSSQ,217,4764
W20122,1,6/16/2022,QFG5UT403T,217,4547
W20122,1,6/17/2022,QFH0WU3UW8,217,4330
W20122,1,6/18/2022,QFI0YS2G1O,217,4113
W20122,1,6/19/2022,QFJ71JMYKL,217,3896
W20122,1,6/20/2022,QFK43N6BP6,217,3679
W20122,1,6/21/2022,QFL15KVJG5,217,3462
W20122,1,6/22/2022,QFM67IZLXM,217,3245
W20122,1,6/23/2022,QFN49D5A3Y,217,3028
W20122,1,6/24/2022,QFO4BFKPYE,217,2811
W20122,1,6/25/2022,QFP2DDPLIW,217,2594
W20122,1,6/26/2022,QFQ6F5PUEC,217,2377
W20122,1,6/27/2022,QFR5H3RD55,217,2160
W20122,1,6/28/2022,QFS2J4TLO0,217,1943
W20122,1,6/29/2022,QFT0L4JZOC,217,1726
W20122,1,6/30/2022,QFU9NAVWGH,217,1509
W20122,1,7/1/2022,QG15PI6VBJ,217,1292
W20122,1,7/2/2022,QG28RO4C3I,217,1075
W20122,1,7/3/2022,QG32TJDT9S,217,858
W20122,1,7/5/2022,QG51VOKR3L,217,641
W20122,1,7/5/2022,QG52VZAX9E,641,0
W20122,2,1/18/2023,RAI4OIKSSQ,217,6683
W20122,2,1/19/2023,RAJ7QZGBSV,217,6466
W20122,2,1/20/2023,RAK0TF685C,217,6249
W20122,2,1/22/2023,RAM4YJQVEA,434,5815
W20122,2,1/24/2023,RAO72OJAST,217,5598
W20122,2,1/25/2023,RAP658XJRY,217,5381
W20122,2,1/25/2023,RAP176ANQJ,217,5164
W20122,2,1/27/2023,RAR7C56VU3,434,4730
W20122,2,1/28/2023,RAS6ETSTTM,217,4513
W20122,2,1/30/2023,RAU9HEYHR5,217,4296
W20122,2,2/2/2023,RB23RJMA87,400,3896
W20122,2,2/20/2023,RBK23GPS5U,216,3680
W20123,1,6/10/2022,QFA6IR6JLU,260,7540
W20123,1,6/11/2022,QFB3KYQ4GD,260,7280
W20123,1,6/12/2022,QFC8MGSGS8,100,7180
W20123,1,6/12/2022,QFC3MH2X77,100,7080
W20123,1,6/12/2022,QFC6MH6IO4,60,7020
W20123,1,6/13/2022,QFD9NM8APB,100,6920
W20123,1,6/13/2022,QFD0NMCBVQ,100,6820
W20123,1,6/13/2022,QFD2NMIJAA,100,6720
W20123,1,6/14/2022,QFE2QD5WY2,100,6620
W20123,1,6/14/2022,QFE9QLAXQ3,100,6520
W20123,1,6/15/2022,QFF3SDP3JF,100,6420
W20123,1,6/15/2022,QFF8SDU25K,100,6320
W20123,1,6/15/2022,QFF3SE0CQN,80,6240
W20123,1,6/16/2022,QFG7UFNG85,100,6140
W20123,1,6/16/2022,QFG0UNWHEY,100,6040
W20123,1,6/16/2022,QFG9UNZ9CZ,60,5980
W20123,1,6/17/2022,QFH2W96QVI,100,5880
W20123,1,6/17/2022,QFH6W9FVZY,100,5780
W20123,1,6/17/2022,QFH8W9SMIE,60,5720
W20123,1,6/18/2022,QFI2YI290E,100,5620
W20123,1,6/18/2022,QFI4YI7K96,100,5520
W20123,1,6/18/2022,QFI9YRMVUZ,60,5460
W20123,1,6/19/2022,QFJ118Q0S3,100,5360
W20123,1,6/19/2022,QFJ51KDTIT,100,5260
W20123,1,6/20/2022,QFK735HJDP,100,5160
W20123,1,6/20/2022,QFK335TDNP,100,5060
W20123,1,6/20/2022,QFK4361OTG,100,4960
W20123,1,6/21/2022,QFL656NFV6,100,4860
W20123,1,6/21/2022,QFL056RHXM,100,4760
W20123,1,6/22/2022,QFM05MQ53O,80,4680
W20123,1,6/22/2022,QFM57EES9X,100,4580
W20123,1,6/23/2022,QFN47L5XMQ,100,4480
W20123,1,6/23/2022,QFN17TYFPB,60,4420
W20123,1,6/23/2022,QFN99EMGRL,100,4320
W20123,1,6/23/2022,QFN49EPGHI,100,4220
W20123,1,6/24/2022,QFO19IT087,60,4160
W20123,1,6/24/2022,QFO0B642UM,260,3900
W20123,1,6/25/2022,QFP6DCI9I6,260,3640
W20123,1,6/26/2022,QFQ3EQA66V,100,3540
W20123,1,6/26/2022,QFQ9EQDPJH,100,3440
W20123,1,6/26/2022,QFQ1EQGJ6F,60,3380
W20123,1,6/27/2022,QFR3H1DWB9,260,3120
W20123,1,6/29/2022,QFT5J6J6WX,60,3060
W20123,1,6/29/2022,QFT6J6IWLA,100,2960
W20123,1,6/29/2022,QFT0J6I2ZA,100,2860
W20123,1,6/29/2022,QFT2KZ5UM0,100,2760
W20123,1,6/29/2022,QFT6L2U4H2,100,2660
W20123,1,6/30/2022,QFU1N2E8MR,100,2560
W20123,1,6/30/2022,QFU6N312PC,100,2460
W20123,1,6/30/2022,QFU2N3Q0QO,100,2360
W20123,1,7/1/2022,QG10PBWMU0,700,1660
W20123,1,7/2/2022,QG29R9XXPH,2100,440
W20124,1,6/24/2022,QFO99Z9YSJ,"3300",9700
W20124,1,7/4/2022,QG43UJFUTP,"9700",0
W20124,2,7/26/2022,QGQ349JZBP,"12300",0
W20124,3,8/15/2022,QHF69CV824,"1150",11750
W20124,3,8/22/2022,QHM8M0A55,"9950",1800
W20124,3,8/22/2022,QHM3M5QAYV,"1800",0
W20124,4,9/20/2022,QIK4C9JC4S,"13600",0
W20124,5,10/18/2022,QJI55OF231,"13000",0
W20124,6,11/15/2022,QKF5YZWVQH,"13000",0
W20124,7,12/13/2022,QLD83F3EK8,"13000",0
W20124,8,1/10/2023,RAA33VYSFR,"13000",0
W20124,9,2/7/2023,RB7256WKXQ,"13000",0
W20124,10,3/7/2023,RC7293LR02,"13000",0
W20124,11,4/5/2023,RD57FJ3K4B,"13000",600
W20124,11,4/5/2023,RD50FS31C6,600,0
W20124,12,5/5/2023,RE58SF6XM4,"13600",0
W20124,13,6/6/2023,RF69DDBTL7,400,15400
W20124,13,6/26/2023,RFQ2Z7YJ70,"1000",14400
W20124,13,7/21/2023,RGL738J9KN,500,13900
W20124,13,8/2/2023,RH262I9XYA,500,13400
W20126,1,6/10/2022,QFA1IZ1ASJ,700,5800
W20126,1,6/14/2022,QFE0P0PG68,500,5300
W20126,1,6/17/2022,QFH8UZXHI0,500,4800
W20126,1,6/23/2022,QFN39GGKU7,700,4100
W20126,1,6/30/2022,QFU8LKG0E2,500,3600
W20126,1,7/4/2022,QG48UTFG1M,700,2900
W20126,1,7/5/2022,QG59XSSNTD,900,2000
W20126,1,7/6/2022,QG63ZYQ0XF,2000,0
W20126,2,7/18/2022,QGI5P9QX4N,700,6100
W20126,2,7/24/2022,QGO41RVT6A,950,5150
W20126,2,7/24/2022,QGO51RWP7D,40,5110
W20126,2,8/2/2022,QH28JPX3IK,1000,4110
W20126,2,8/8/2022,QH83W010Z5,1600,2510
W20126,2,8/9/2022,QH99Y99E7L,1000,1510
W20126,2,8/12/2022,QHC43L4Q5A,1010,500
W20126,2,8/12/2022,QHC63LDGQW,100,400
W20126,2,8/12/2022,QHC13M5QOL,100,300
W20126,2,8/24/2022,QHO6QFO6GO,300,0
W20127,1,7/7/2022,QG7920L38Z,"6500",0
W20127,2,8/3/2022,QH33LGLPCX,"4000",2500
W20127,2,8/4/2022,QH40MV6CQ8,"2500",0
W20127,3,8/23/2022,QHN6N8RXXM,"1000",5500
W20127,3,9/1/2022,QI106WQQ00,"1500",4000
W20127,3,9/2/2022,QI288POWU4,"4000",0
W20128,1,6/21/2022,QFL84AP2HU,"3000",10000
W20128,1,6/30/2022,QFU9LUXWJ9,"2000",8000
W20128,1,7/7/2022,QG771LK8XT,"8000",0
W20128,2,8/1/2022,QH15GY1A5T.,"12700",0
W20128,3,8/23/2022,QHN6O00746,"1950",11650
W20128,3,8/31/2022,QHV04KWUAY,"11000",650
W20128,3,8/31/2022,QHV34L8RH1,50,600
W20128,3,8/31/2022,QHV84LLTP8,600,0
W20129,1,6/18/2022,QFI5XAEED1,"2000",10700
W20129,1,6/20/2022,QFK81ZXNZ6,"1250",9450
W20129,1,6/30/2022,QFU8LJNXZM,"1000",8450
W20129,1,7/1/2022,QG16NL48CI,450,8000
W20129,1,7/5/2022,QG63YTBWQ1,8000,0
W20129,2,7/20/2022,QGK0RFRIX0,500,12300
W20129,2,7/29/2022,QGT49SPTE4,"1000",11300
W20129,2,7/30/2022,QGU5CRAZ15,800,10500
W20129,2,8/1/2022,QH13GOW0XX,9634,866
W20129,2,8/1/2022,QH12GUR1YE,866,0
W20130,1,7/8/2022,QG8647KPRS,600,13000
W20130,1,7/11/2022,QGB4A19X0Q,"12400",600
W20130,1,7/12/2022,QGC4BNX5R0,600,0
W20130,2,8/9/2022,QH97X2L4ZR,"1000",13600
W20130,2,9/23/2022,QIN5IJ8GWR,"2000",11600
W20130,2,9/27/2022,QIR5RM2SU1,800,10800
W20130,2,10/4/2022,QJ487C5R1G,2000,8800
W20130,2,10/5/2022,QJ519NNLNH,1500,7300
W20130,2,10/13/2022,QJD2TISD7M,500,6800
W20130,2,11/25/2022,QKO9JR10S9,500,6300
W20130,2,12/3/2022,QL31AQ0JND,3000,3300
W20130,2,1/17/2023,RAH0JWLOFO,1000,2300
W20131,1,6/13/2022,QFD4OR6L9W,217,6183
W20131,1,6/23/2022,QFN58S867D,650,5533
W20131,1,6/25/2022,QFP1C9D6BP,300,5233
W20131,1,6/28/2022,QFS4HRBBSU,450,4783
W20131,1,6/30/2022,QFU4M4QDQS,300,4483
W20131,1,30/06/2022,QFU7NAVYAT,200,4283
W20131,1,7/6/2022,QG69YELWAX,4283,0
W20131,2,7/12/2022,QGC3C6XVPV,500,5850
W20131,2,7/13/2022,QGD8E0XNLC,200,5650
W20131,2,7/15/2022,QGF7HNJDZ5,200,5450
W20131,2,7/29/2022,QGT8A5DR08,3000,2450
W20131,2,8/1/2022,QH14GI9U42,2450,0
W20131,3,8/9/2022,QH94Y9C6KS,200,5900
W20131,3,8/17/2022,QHH9DFS1NT,300,5600
W20131,3,8/18/2022,QHI5FI5KAH,150,5450
W20131,3,8/20/2022,QHK7I40LN1,5450,0
W20131,4,8/22/2022,QHM4N284BQ,200,6200
W20131,4,8/23/2022,QHN7OZK90T,200,6000
W20131,4,8/25/2022,QHP2SK114I,200,5800
W20131,4,8/26/2022,QHQ3URBJ29,200,5600
W20131,4,8/27/2022,QHR3WO1XX5,200,5400
W20131,4,8/29/2022,QHT91KLXBD,200,5200
W20131,4,8/31/2022,QHV75NEO4R,200,5000
W20131,4,9/1/2022,QI137UKIFD,200,4800
W20131,4,9/2/2022,QI229GAWU0,200,4600
W20131,4,9/3/2022,QI34C9VC8W,200,4400
W20131,4,9/5/2022,QI50GC9RGU,200,4200
W20131,4,9/7/2022,QI76K7M42G,200,4000
W20131,4,9/9/2022,QI99OVX6OB,400,3600
W20131,4,9/10/2022,QIA1QVLFRL,200,3400
W20131,4,9/16/2022,QIG93L87EB,3400,0
W20131,5,9/19/2022,QIJ8AZDSCA,300,6200
W20131,5,9/21/2022,QIL3F40XJH,200,6000
W20131,5,9/22/2022,QIM9H80JHX,200,5800
W20131,5,9/26/2022,QIQ9Q3WZDP,350,5450
W20131,5,9/27/2022,QIR5SB50L5,200,5250
W20131,5,9/29/2022,QIT0WBANPE,200,5050
W20131,5,9/30/2022,QIU2Z7AVX6,200,4850
W20131,5,10/3/2022,QJ3861FUOC,400,4450
W20131,5,10/4/2022,QJ479JJVU9,200,4250
W20131,5,10/5/2022,QJ50BXI3QY,200,4050
W20131,5,10/7/2022,QJ75GHZEF3,200,3850
W20131,5,10/10/2022,QJA9NF7D0B,270,3580
W20131,5,10/11/2022,QJB2PM843K,250,3330
W20131,5,10/13/2022,QJD7U68BPH,420,2910
W20131,5,10/14/2022,QJE2VMPFCC,2910,0
W20131,6,10/17/2022,QJH549XGSZ,300,7440
W20131,6,10/19/2022,QJJ58LCD1Z,270,7170
W20131,6,10/24/2022,QJO2JMR4KA,270,6900
W20131,6,10/25/2022,QJP6LZ2W42,200,6700
W20131,6,10/27/2022,QJR3QGZQ3H,290,6410
W20131,6,10/28/2022,QJS9SSZSOV,250,6160
W20131,6,10/31/2022,QJV6ZEI5IQ,290,5870
W20131,6,11/3/2022,QK327Y7Y6Y,400,5470
W20131,6,11/4/2022,QK48A1R9W4,240,5230
W20131,6,11/7/2022,QK77GAIN19,900,4330
W20131,6,11/7/2022,QK70HGY7AG,500,3830
W20131,6,11/9/2022,QK98M96WNQ,800,3030
W20131,6,11/11/2022,QKB0PQB1FC,3030,0
W20131,7,11/14/2022,QKE7XMZXEF,400,7340
W20131,7,11/15/2022,QKF413BPDQ,200,7140
W20131,7,11/17/2022,QKH15MXDV7,300,6840
W20131,7,11/19/2022,QKJ38EYE8F,300,6540
W20131,7,11/21/2022,QKL7ELOFZN,290,6250
W20131,7,11/22/2022,QKM7GVGZ8V,200,6050
W20131,7,11/24/2022,QKO2LBMFB2,290,5760
W20131,7,11/28/2022,QKS1UYOV0R,700,5060
W20131,7,11/29/2022,QKT7XB152F,300,4760
W20131,7,12/1/2022,QL1743Q4S7,300,4460
W20131,7,12/2/2022,QL247I4HCQ,170,4290
W20131,7,12/5/2022,QL53H50T4D,400,3890
W20131,7,12/7/2022,QL77KHHID7,790,3100
W20131,7,12/9/2022,QL92RPLQVW,3100,0
W20131,8,1/3/2023,RA38M71OPO,"7560",0
W20131,9,1/30/2023,RAU1HSIZK3,"3300",4500
W20131,9,1/31/2023,RAV6MD2IX8,"4200",300
W20131,9,1/2/2023,RB17NJ018V,300,0
W20131,10,2/24/2023,RBO3EZROGR,"7440",60
W20131,10,2/25/2023,RBP3FUMTLV,60,0
W20131,11,3/25/2023,RCP2LI89I8,"7800",0
W20131,12,4/21/2023,RDL4QDZOHO,10,7670
W20131,12,4/21/2023,RDL9QE5IGF,"7670",0
W20131,13,5/22/2023,REM17GZYIL,"6800",1360
W20131,13,5/23/2023,REN27V5ZB8,"1360",0
W20131,14,6/17/2023,RFH39ZMR2D,"7560",0
W20131,15,7/24/2023,RGO0BRNXIS,250,7910
W20131,15,7/25/2023,RGP0FRLN6I,150,7760
W20131,15,7/27/2023,RGR1LLBCOH,250,7510
W20131,15,8/2/2023,RH271DA0JJ,200,7310
W20131,15,8/7/2023,RH78GMKL2W,200,7110
W20132,1,7/7/2022,QG761UDMEQ,"10400",0
W20132,2,8/4/2022,QH43MXUWJH,"10400",0
W20133,1,6/12/2022,QFC4MUQRS6,300,5750
W20133,1,6/13/2022,QFD3OUYWIP,300,5450
W20133,1,6/14/2022,QFE1QTP4NT,250,5200
W20133,1,6/15/2022,QFF4SV8MAU,300,4900
W20133,1,6/16/2022,QFG7UVYHHN,250,4650
W20133,1,6/17/2022,QFH5WWT4S5,200,4450
W20133,1,6/18/2022,QFI7YWHM9N,300,4150
W20133,1,6/21/2022,QFL55LOX39,300,3850
W20133,1,6/23/2022,QFN17KLG0H,300,3550
W20133,1,6/27/2022,QFR2F7L5BI,220,3330
W20133,1,6/30/2022,QFU8L7O8GC,2120,1210
W20133,1,6/30/2022,QFU3N9WK45,1150,60
W20133,1,7/1/2022,QG16NP9Y2S,60,0
W20133,2,7/2/2022,QG25RN5M9J,250,6100
W20133,2,7/3/2022,QG37TJTN1L,300,5800
W20133,2,7/4/2022,QG40VMT2FG,300,5500
W20133,2,7/5/2022,QG50XRW0D0,300,5200
W20133,2,7/6/2022,QG67ZYKOPT,300,4900
W20133,2,7/8/2022,QG82571JJQ,200,4700
W20133,2,7/9/2022,QG907DX9C6,250,4450
W20133,2,7/13/2022,QGD5FD4VKR,500,3950
W20133,2,7/14/2022,QGE4HCI7IW,300,3650
W20133,2,7/15/2022,QGF1JG9SUT,300,3350
W20133,2,7/18/2022,QGI5P9XBD9,200,3150
W20133,2,7/19/2022,QGJ1R6BH3H,200,2950
W20133,2,7/21/2022,QGL7V14OF7,250,2700
W20133,2,7/23/2022,QGN7Z0HP2D,200,2500
W20133,2,7/24/2022,QGO91S6MBB,200,2300
W20133,2,7/25/2022,QGP43QK0V4,250,2050
W20133,2,7/26/2022,QGQ14FPWZZ,2050,0
W20133,3,7/31/2022,QGV1FQ3Q1Z,250,6050
W20133,3,8/1/2022,QH29I8EIUB,500,5550
W20133,3,8/3/2022,QH34KP77CS,300,5250
W20133,3,8/6/2022,QH68QUO67A,500,4750
W20133,3,8/12/2022,QHC04M2BGK,500,4250
W20133,3,8/13/2022,QHD76HKV7V,500,3750
W20133,3,8/16/2022,QHG7A7B1ET,600,3150
W20133,3,8/17/2022,QHH1DK9S0V,500,2650
W20133,3,8/20/2022,QHK9HHMF17,1000,1650
W20133,3,8/20/2022,QHK5JF8DS7,1650,0
W20133,4,8/28/2022,QHS5YR3Q55,300,6200
W20133,4,8/30/2022,QHU51RVB2X,300,5900
W20133,4,9/1/2022,QI136BGIO3,270,5630
W20133,4,9/3/2022,QI36CCOSSW,250,5380
W20133,4,9/9/2022,QI93OXK1Y1,300,5080
W20133,4,9/15/2022,QIF82H71XS,300,4780
W20133,4,9/17/2022,QIH06Y5MC6,200,4580
W20133,4,9/19/2022,QIJ9B0HPLP,150,4430
W20133,4,9/20/2022,QIK1CZTP19,4450,20
W20133,5,10/13/2022,QJD6U937P2,380,6120
W20133,5,10/15/2022,QJF9YU26RP,400,5720
W20133,5,10/18/2022,QJI14DGBWZ,480,5240
W20133,5,10/18/2022,QJI35EUKC7,5240,0
W20133,6,10/27/2022,QJR2QI9A4K,300,6200
W20133,6,10/29/2022,QJT3V849J7,240,5960
W20133,6,11/1/2022,QK1533W80T,300,5660
W20133,6,11/2/2022,QK265H6XV4,200,5460
W20133,6,11/5/2022,QK54CT4MSO,300,5160
W20133,6,11/7/2022,QK77HJGNQV,300,4860
W20133,6,11/10/2022,QKA0OOF35E,400,4460
W20133,6,11/11/2022,QKB3R1SPTX,400,4060
W20133,6,11/12/2022,QKC1TH6SVF,300,3760
W20133,6,11/14/2022,QKE3XWEKC7,350,3410
W20133,6,1/16/2022,QKG92BUG2D,3410,0
W20133,7,11/18/2022,QKI981HVWP,200,7480
W20133,7,11/23/2022,QKN8JGSPAA,200,7280
W20133,7,11/26/2022,QKQ9QO0HN9,300,6980
W20133,7,12/3/2022,QL3787P5IJ,300,6680
W20133,7,12/4/2022,QL43E0JES3,250,6430
W20133,7,12/7/2022,QL76KBN1JW,400,6030
W20133,7,12/8/2022,QL86N9ASYC,500,5530
W20133,7,12/9/2022,QL92Q68ACA,400,5130
W20133,7,12/9/2022,QL93T1FV1L,200,4930
W20133,7,12/11/2022,QLB2YB0DT0,200,4730
W20133,7,12/13/2022,QLD81WA348,400,4330
W20133,7,12/13/2022,QLD845VW7Y,4350,20
W20133,8,12/20/2022,QLK7N38GYN,400,7280
W20133,8,12/29/2022,QLT1ARFKLX,500,6780
W20133,8,1/3/2023,RA35MQLBGJ,500,6280
W20133,8,1/6/2023,RA60UBC1NI,500,5780
W20133,8,1/10/2023,RAS22URJJ0,5780,0
W20133,9,1/16/2023,RAH8JNP0QK,300,7200
W20133,9,1/19/2023,RAJ6OXZGIK,300,6900
W20133,9,1/22/2023,RAM4YFXXY0,300,6600
W20133,9,1/25/2023,RAP27897XI,500,6100
W20133,9,1/27/2023,RAR1BPDCH3,500,5600
W20133,9,1/30/2023,RAU8I982P6,1000,4600
W20133,9,1/31/2023,RAV0MBOAQC,500,4100
W20133,9,2/2/2023,RB23PVTKLR,500,3600
W20133,9,2/2/2023,RB20RRL8PC,3500,100
W20133,9,2/3/2023,RB24RQ945I,100,0
W20133,10,2/9/2023,RB98BEHR6S,200,7600
W20134,1,7/12/2022,QGC7CYU5Q5,"1100",14700
W20134,1,7/25/2022,QGP81WL18U,500,14200
W20134,1,7/30/2022,QGU2CI9NZK,500,13700
W20134,1,8/15/2022,QHF68DZL0O,400,13300
W20134,1,8/31/2022,QHV74EBTL3,1550,11750
W20135,1,6/23/2022,QFN58SNB3R,500,5750
W20135,1,6/28/2022,QFS0HB7YBA,500,5250
W20135,1,7/1/2022,QG16OGRMYS,400,4850
W20135,1,7/6/2022,QG63ZIA5V9,750,4100
W20135,1,7/7/2022,QG702XXVQK,2000,2100
W20135,1,7/8/2022,QG873CJE5T,2100,0
W20135,2,8/2/2022,QH24IFLFNC,200,6300
W20135,2,8/4/2022,QH40NHYQIM,200,6100
W20135,2,8/6/2022,QH63QVIV57,200,5900
W20135,2,8/16/2022,QHG6BK30AM,150,5750
W20135,2,8/17/2022,QHH5DAAX09,150,5600
W20135,2,8/30/2022,QHU53KLOUR,100,5500
W20135,2,9/1/2022,QI1979T60X,150,5350
W20135,2,10/5/2022,QJ58A2G55A,150,5200
W20135,2,3/27/2023,RCR2RXH78U,100,5100
W20136,1,6/16/2022,QFG8UP29EI,217,6183
W20136,1,6/17/2022,QFH9WV1SWP,217,5966
W20136,1,6/18/2022,QFI7YUB96R,217,5749
W20136,1,6/19/2022,QFJ31JUNR3,200,5549
W20136,1,6/21/2022,QFL24WJ7VE,217,5332
W20136,1,6/22/2022,QFM478XAB0,100,5232
W20136,1,6/22/2022,QFM37I0D5Z,100,5132
W20136,1,6/22/2022,QFM67I1ROO,17,5115
W20136,1,6/23/2022,QFN68Y1GPC,100,5015
W20136,1,6/23/2022,QFN28Z3ZVK,100,4915
W20136,1,6/23/2022,QFN88ZB92I,17,4898
W20136,1,6/25/2022,QFP8CYEA1C,100,4798
W20136,1,6/25/2022,QFP3CYHWW1,100,4698
W20136,1,6/25/2022,QFP7CYVGUT,17,4681
W20136,1,6/26/2022,QFQ2F5OJU4,100,4581
W20136,1,6/26/2022,QFQ2F5Q6WI,100,4481
W20136,1,6/26/2022,QFQ1F5RWRF,17,4464
W20136,1,6/27/2022,QFR6GYKI1M,100,4364
W20136,1,6/27/2022,QFR7GYRRML,100,4264
W20136,1,6/27/2022,QFR9GYV6QB,17,4247
W20136,1,6/28/2022,QFS0IZZEF8,100,4147
W20136,1,6/28/2022,QFS5J06I8T,100,4047
W20136,1,6/28/2022,QFS8J0APTA,17,4030
W20136,1,6/30/2022,QFU0N7N8DQ,100,3930
W20136,1,6/30/2022,QFU8N7Q2ZK,100,3830
W20136,1,6/30/2022,QFU4N7SJD4,17,3813
W20136,1,7/1/2022,QG16PCUP6I,100,3713
W20136,1,7/1/2022,QG17PCYDXF,100,3613
W20136,1,7/1/2022,QG13PDGUG3,17,3596
W20136,1,7/3/2022,QG34TATETS,100,3496
W20136,1,7/3/2022,QG39TAZV8L,100,3396
W20136,1,7/3/2022,QG39TB2SX1,17,3379
W20136,1,7/4/2022,QG42VNEBV2,100,3279
W20136,1,7/4/2022,QG45VNHKIV,100,3179
W20136,1,7/4/2022,QG47VNISNJ,17,3162
W20136,1,7/12/2022,QGC5CDXLNN,3162,0
W20136,2,8/17/2022,QHH2C98AMQ,500,6800
W20136,2,8/23/2022,QHN6NY5QPS,500,6300
W20136,2,8/24/2022,QHO5PV3K01,"1000",5300
W20136,2,8/24/2022,QHO7PYPA8F,500,4800
W20136,2,8/24/2022,QHO8Q0U3DG,4000,800
W20136,2,8/25/2022,QHP4R3TVZE,1100,300
W20136,3,6/26/2023,RFQ6ZQ7UY4,600,6700
W20136,3,6/28/2023,RFS172MMBH,500,6200
W20136,3,6/28/2023,RFS17CHZBJ,200,6000
W20136,3,6/29/2023,RFT9A1HGUP,200,5800
W20136,3,7/5/2023,RG58R830H8,300,5500
W20136,3,7/19/2023,RGJ7W7CLMD,1000,4500
W20137,1,8/4/2022,QH41MP8EHF,"1000",13600
W20137,1,8/8/2022,QH86V5J6UU,"1000",12600
W20137,1,9/8/2022,QI85L1D9XX,"2000",10600
W20138,1,7/14/2022,QGE0H9RE08,500,7400
W20138,1,7/27/2022,QGR95ZHGQP,400,7000
W20138,1,8/1/2022,QH10G3UOE8,400,6600
W20139,1,6/23/2022,QFN788W4JV,"1000",6500
W20139,1,6/23/2022,QFN78ZUWRF,"1000",5500
W20139,1,7/4/2022,QG43TNOEMV,"1000",4500
W20139,1,7/9/2022,QG915X2Y4N,"4500",0
W20139,2,8/3/2022,QH37M8Z1NX,500,7300
W20139,2,8/4/2022,QH45NN0GO9,500,6800
W20139,2,8/5/2022,QH52PCIZYI,"1000",5800
W20139,2,8/6/2022,QH65R74QOH,5800,0
W20139,3,9/26/2022,QIQ1Q35HAZ,500,8980
W20139,3,9/28/2022,QIS7UO2PDD,300,8680
W20139,3,10/12/2022,QJC8RSJQZI,300,8380
W20139,3,10/16/2022,QJG31ZH5PP,300,8080
W20140,1,6/16/2022,QFG3UMBV81,200,6250
W20140,1,6/17/2022,QFH2WW6C78,200,6050
W20140,1,6/18/2022,QFI6YWPRLM,200,5850
W20140,1,6/19/2022,QFJ01M4OPY,200,5650
W20140,1,6/20/2022,QFK33I0L29,200,5450
W20140,1,6/22/2022,QFM570O3IX,200,5250
W20140,1,6/24/2022,QFO7A25V63,200,5050
W20140,1,6/26/2022,QFQ8EV6PLG,800,4250
W20140,1,7/2/2022,QG25QZOP19,700,3550
W20140,1,7/6/2022,QG60ZA7YPY,1100,2450
W20140,1,7/8/2022,QG81538TPB,600,1850
W20140,1,7/13/2022,QGD0E7QN0U,1850,0
W20140,2,7/18/2022,QGI8O06CG0,"1200",5300
W20140,2,8/4/2022,QH46OCVLCQ,"3300",2000
W20140,2,8/10/2022,QHA9ZIDYYF,"2000",0
W20140,3,9/16/2022,QIG22N6GBE,"6800",0
W20140,4,10/24/2022,QJO2IMFIHC,"6800",0
W20140,5,11/21/2022,QKL2EQD4U0,"6500",0
W20141,1,6/30/2022,QFU0MV4G5W,300,11380
W20141,1,7/13/2022,QGD1F4W16X,400,10980
W20141,1,7/14/2022,QGE8H5R5OU,500,10480
W20141,1,7/15/2022,QGF1I0Z69N,"1000",9480
W20141,1,7/16/2022,QGG8LCBEN2,400,9080
W20141,1,7/18/2022,QGI4P3T4G2,400,8680
W20141,1,7/19/2022,QGJ0R0ND16,400,8280
W20141,1,7/20/2022,QGK0T54C50,300,7980
W20141,1,7/21/2022,QGL3UXCY6N,300,7680
W20141,1,7/23/2022,QGN8XH0TB8,750,6930
W20141,1,7/23/2022,QGN9XJFUR5,6130,800
W20141,1,7/23/2022,QGN3XJTFDT,1400,600
W20142,1,7/13/2022,QGD4EBWAHU,"12700",0
W20142,2,8/3/2022,QH36L8DEFU,500,12300
W20142,2,8/6/2022,QH62R07RA6,"12300",0
W20142,3,9/2/2022,QI268PLZ1Q,"12900",0
W20142,4,10/5/2022,QJ51BAV7WP,"13600",0
W20142,5,11/7/2022,QK76FVRVIY,"13600",0
W20142,6,12/6/2022,QL61J60IRV,"13000",0
W20142,7,1/4/2023,RA49O9VJQZ,"8000",5600
W20142,7,1/6/2022,RA61SECJX5,"5600",0
W20143,1,6/24/2022,QFO8AVLU4C,"4033",8267
W20143,1,7/1/2022,QG19PFPH6B,"4033",4234
W20143,1,7/8/2022,QG875916DD,"4033",201
W20143,1,7/9/2022,QG955PFLYP,201,0
W20143,2,7/19/2022,QGJ5PD3D1F,"2933",9467
W20143,2,7/29/2022,QGT8AY450A,"3267",6200
W20143,2,8/1/2022,QH10H5GM6O,"6200",0
W20143,3,8/23/2022,QHN8NUQ86A,"12300",0
W20144,1,7/9/2022,QG935OSLJL,"12500",0
W20144,2,8/8/2022,QH84W8VKR6,"12900",0
W20145,1,7/23/2022,QGN2Y7T9XU,600,10280
W20145,1,8/2/2022,QH24J7P9YK,100,10180
W20145,1,8/2/2022,QH28J7SSF6,100,10080
W20145,1,8/2/2022,QH27J7W2P7,100,9980
W20145,1,8/4/2022,QH44N8WE2K,500,9480
W20145,1,8/12/2022,QHC63J2MHS,480,9000
W20146,1,7/20/2022,QGK7SDIOX1,"2000",11600
W20146,1,7/21/2022,QGL5TS4H2P,"11600",0
W20146,2,8/8/2022,QH87V8Z0MB,"11600",200
W20146,2,8/8/2022,QH81VB8M09,200,0
W20146,3,9/6/2022,QI68HMI7QS,"10000",3600
W20146,3,9/7/2022,QI75JQCG5H,"3600",0
W20146,4,10/3/2022,QJ385Y33LW,"12700",0
W20146,5,11/17/2022,QKH73XAGN7,"4000",11800
W20146,5,11/23/2022,QKN8I62H0U,"4000",7800
W20146,5,12/24/2022,QLO3WHRM5F,500,7300
W20146,5,1/24/2023,RAO334KYFR,"1000",6300
W20146,5,6/29/2023,RFT49T2JMI,"1700",4600
W20146,5,8/2/2023,RH202PSBL8,"2000",2600
W20147,1,7/4/2022,QG48UIZ7SK,"6900",0
W20147,2,7/21/2022,QGL9UCC44H,"7080",0
W20147,3,8/8/2022,QH84W223XM,"7140",0
W20147,4,8/23/2022,QHN7O79K7P,"6900",60
W20147,4,8/23/2022,QHN8O8Y8FO,60,0
W20147,5,9/20/2022,QIK6D48H5O,"7800",0
W20147,6,10/12/2022,QJC4QRZE5M,"7380",0
W20147,7,11/2/2022,QK294EZUUB,"7380",0
W20147,8,11/23/2022,QKN6HY725G,"7380",0
W20147,9,12/9/2022,QL95RSGZ5J,"7080",0
W20147,10,1/6/2022,QKN6HY725G2,"7800",0
W20147,11,1/25/2023,RAP05ZFEGK,"7000",260
W20147,11,1/25/2023,RAP65ZMSAG,260,0
W20147,12,2/22/2023,RBM18XSPL1,"7800",0
W20147,13,3/22/2023,RCM2DO4KE2,"9100",0
W20147,14,4/19/2023,RDJ7JMCE1T,"9100",0
W20147,15,5/17/2023,REH4R7NOCQ,"9000",100
W20147,15,5/17/2023,REH0R7PYMU,100,0
W20147,16,6/14/2023,RFE1379BLP,"9100",0
W20147,17,7/20/2023,RGK8ZKJBTY,"9520",0
W20148,1,7/14/2022,QGE0G2RYP6,"13000",0
W20148,2,8/8/2022,QH81VO42I7,"12700",0
W20148,3,9/6/2022,QI67HAVY55,"13000",0
W20148,4,10/5/2022,QJ51AZ4DSL,"13000",0
W20148,5,11/1/2022,QK151UXN8F,"12700",0
W20148,6,11/30/2022,QKU3YVXJV5,"15600",0
W20148,7,12/29/2022,QLT8AL02GE,"15600",0
W20148,8,1/28/2023,RAS5DCIIOF,"15600",0
W20148,9,2/27/2023,RBR2LBFHSK,"16320",0
W20148,10,3/23/2023,RCN2G55YWU,"15120",0
W20148,11,4/20/2023,RDK9MHZ0ZP,"19500",0
W20148,12,5/20/2023,REK6Z3BCU0,"20400",0
W20148,13,6/19/2023,RFJ7FEFMMT,"20400",0
W20148,14,7/13/2023,RGD6FLK81Q,"18900",0
W20148,15,8/12/2023,RHC0WRBSDY,"19500",0
W20149,1,7/21/2022,QGL4T67610,"2400",8480
W20149,1,7/23/2022,QGN3XOF5BF,650,7830
W20149,1,7/25/2022,QGP13160PV,560,7270
W20149,1,7/29/2022,QGT49Z4QCI,"3000",4270
W20149,1,7/29/2022,QGT0AM48GA,4300,30
W20150,1,7/6/2022,QG63YWRTLZ,"3000",3400
W20150,1,7/19/2022,QGJ3QK2SZR,"3400",0
W20150,2,8/12/2022,QHC53NC8O5,"1500",6400
W20150,2,8/22/2022,QHM4LTRMOG,300,6100
W20150,2,8/24/2022,QHO3PU9HAH,500,5600
W20150,2,8/24/2022,QHO6Q8SVZI,250,5350
W20150,2,3/14/2023,RCE0S3LX3W,100,5250
W20150,2,3/14/2023,RCE3S3VI2B,100,5150
W20150,2,4/13/2023,RDD931I499,100,5050
W20150,2,8/1/2023,RH11Z1AWWB,200,4850
W20151,1,7/30/2022,QGU2C94TNK,650,12950
W20151,1,8/3/2022,QH39LG4G9X,500,12450
W20152,1,6/27/2022,QFR8F98PBK,500,9100
W20152,1,6/27/2022,QFR7H1S0EH,500,8600
W20152,1,6/28/2022,QFT3JRSG8Z,500,8100
W20152,1,7/1/2022,QG17PCD129,500,7600
W20152,1,7/3/2022,QG35THLJBN,500,7100
W20152,1,7/4/2022,QG43VJ4P7H,500,6600
W20152,1,7/5/2022,QG55XO83YX,500,6100
W20152,1,7/6/2022,QG68ZUUYAY,500,5600
W20152,1,7/7/2022,QG7030ENHS,681,4919
W20152,1,7/9/2022,QG9178EUZH,555,4364
W20152,1,7/10/2022,QGA88ZNBW4,555,3809
W20152,1,7/11/2022,QGB2B44P2Q,555,3254
W20152,1,7/12/2022,QGC6D86HSO,600,2654
W20152,1,7/13/2022,QGD5EFNFWL,2654,0
W20152,2,7/19/2022,QGJ2Q8LV9M,800,9360
W20152,2,7/21/2022,QGL3UYJHAD,600,8760
W20152,2,7/23/2022,QGN2Z0YHM4,650,8110
W20152,2,7/28/2022,QGS59MQ4OZ,360,7750
W20152,2,7/29/2022,QGT8BS3AAG,500,7250
W20152,2,8/3/2022,QH33M9ZZEN,400,6850
W20152,2,8/5/2022,QH56OSN4TI,90,6760
W20152,2,8/8/2022,QH82VX240W,6760,0
W20152,3,8/13/2022,QHD46FOYU0,200,10200
W20152,3,8/16/2022,QHG0B5FQJE,510,9690
W20152,3,8/17/2022,QHH8DG90Z0,480,9210
W20152,3,8/19/2022,QHJ0GW8YC8,510,8700
W20152,3,8/21/2022,QHL8KYCAWK,200,8500
W20152,3,8/26/2022,QHQ2T0LOD0,300,8200
W20152,3,8/28/2022,QHS0X7B1QM,200,8000
W20152,3,9/5/2022,QI58F4KYPA,8000,0
W20153,1,6/28/2022,QFS8J26Z9C,440,5560
W20153,1,6/29/2022,QFT8L1IAZ8,220,5340
W20153,1,6/30/2022,QFU3MEY567,220,5120
W20153,1,7/1/2022,QG14OA2NH8,220,4900
W20153,1,7/2/2022,QG21RLXU19,100,4800
W20153,1,7/2/2022,QG24RLZY20,20,4780
W20153,1,7/2/2022,QG24RM1YKU,100,4680
W20153,1,7/4/2022,QG48VENRNU,100,4580
W20153,1,7/4/2022,QG47VETDZZ,20,4560
W20153,1,7/4/2022,QG42VEYF6C,100,4460
W20153,1,7/6/2022,QG69ZRAQLF,100,4360
W20153,1,7/6/2022,QG66ZRHBNI,20,4340
W20153,1,7/6/2022,QG69ZRLMEZ,100,4240
W20153,1,7/7/2022,QG772YY2OB,100,4140
W20153,1,7/7/2022,QG732Z0WVN,20,4120
W20153,1,7/7/2022,QG722Z4K74,100,4020
W20153,1,7/8/2022,QG813K21OB,220,3800
W20153,1,7/8/2022,QG8557YB9J,100,3700
W20153,1,7/8/2022,QG8357ZF6P,20,3680
W20153,1,7/8/2022,QG805809JY,100,3580
W20153,1,7/9/2022,QG967ADZW4,100,3480
W20153,1,7/9/2022,QG997AGZS3,20,3460
W20153,1,7/9/2022,QG937AYKGV,100,3360
W20153,1,7/11/2022,QGB1B0TPS3,100,3260
W20153,1,7/11/2022,QGB3B0XAX1,20,3240
W20153,1,7/11/2022,QGB3B10E0H,100,3140
W20153,1,7/11/2022,QGB4B13KUY,220,2920
W20153,1,7/14/2022,QGE4GDKYTM,2920,0
W20153,2,7/15/2022,QGF0JCJZRS,100,6350
W20153,2,7/15/2022,QGF7JCNGWZ,20,6330
W20153,2,7/15/2022,QGF7JCTB9H,100,6230
W20153,2,7/16/2022,QGG6L97X60,100,6130
W20153,2,7/16/2022,QGG9L99O6P,20,6110
W20153,2,7/16/2022,QGG8L9LQ9W,100,6010
W20153,2,7/17/2022,QGH8MX74PC,100,5910
W20153,2,7/17/2022,QGH9MXB5HB,20,5890
W20153,2,7/17/2022,QGH9MXIJWZ,100,5790
W20153,2,7/18/2022,QGI9P2BZEH,100,5690
W20153,2,7/18/2022,QGI5P2EC1V,20,5670
W20153,2,7/18/2022,QGI9P2GYQL,100,5570
W20153,2,7/19/2022,QGJ7QZI715,100,5470
W20153,2,7/19/2022,QGJ8QZJJ7C,20,5450
W20153,2,7/19/2022,QGJ5QZLN9V,100,5350
W20153,2,7/20/2022,QGK3SUIMD7,100,5250
W20153,2,7/20/2022,QGK6SUKTWW,20,5230
W20153,2,7/20/2022,QGK5SUO99P,100,5130
W20153,2,7/21/2022,QGL0UX85H2,100,5030
W20153,2,7/21/2022,QGL7UXAANV,20,5010
W20153,2,7/21/2022,QGL9UXC01N,100,4910
W20153,2,7/22/2022,QGM3WZHXMT,100,4810
W20153,2,7/22/2022,QGM6WZIO0M,20,4790
W20153,2,7/22/2022,QGM8WZJLCE,100,4690
W20153,2,7/23/2022,QGN0YYQR9U,100,4590
W20153,2,7/23/2022,QGN7YYRTDP,20,4570
W20153,2,7/23/2022,QGN6YYTNHO,100,4470
W20153,2,7/28/2022,QGS29DTXK8,100,4370
W20153,2,7/28/2022,QGS39DX0F3,20,4350
W20153,2,7/28/2022,QGS79DZUK5,100,4250
W20153,2,8/1/2022,QH17HQP67B,100,4150
W20153,2,8/1/2022,QH10HQRS02,20,4130
W20153,2,8/1/2022,QH17HQUDGP,100,4030
W20153,2,8/2/2022,QH24JTLM30,100,3930
W20153,2,8/2/2022,QH21JTTYN7,20,3910
W20153,2,8/2/2022,QH29JTXXA5,100,3810
W20153,2,8/4/2022,QH43O3H39H,100,3710
W20153,2,8/4/2022,QH42O3JG00,20,3690
W20153,2,8/4/2022,QH44O3MJJM,100,3590
W20153,2,8/5/2022,QH54QHNZT4,100,3490
W20153,2,8/5/2022,QH58QHPS5M,20,3470
W20153,2,8/5/2022,QH51QHRY8J,100,3370
W20153,2,8/8/2022,QH89WG2XID,100,3270
W20153,2,8/8/2022,QH84WG4Y9Y,20,3250
W20153,2,8/8/2022,QH89WG7YDR,100,3150
W20153,2,8/10/2022,QHA3ZCADCL,3150,0
W20153,3,8/18/2022,QHI1FE2LWH,100,7800
W20153,3,8/18/2022,QHI4FE4ZJM,20,7780
W20153,3,8/18/2022,QHI9FE7L39,100,7680
W20153,3,8/19/2022,QHJ5HBPL5B,100,7580
W20153,3,8/19/2022,QHJ6HBQUV6,20,7560
W20153,3,8/19/2022,QHJ7HBT1LD,100,7460
W20153,3,8/20/2022,QHK9JA4JON,100,7360
W20153,3,8/20/2022,QHK6JA5QH4,20,7340
W20153,3,8/20/2022,QHK4JA7RC4,100,7240
W20153,3,9/9/2022,QI93O6WJ6L,600,6640
W20153,3,9/13/2022,QID0WAWVI2,100,6540
W20153,3,9/13/2022,QID6WAZISS,100,6440
W20153,3,9/13/2022,QID9WB2NJ7,100,6340
W20153,3,9/13/2022,QID9WB6A9L,100,6240
W20153,3,9/13/2022,QID1WBBWOL,100,6140
W20153,3,9/16/2022,QIG43TFOF8,100,6040
W20153,3,9/16/2022,QIG73TJOBL,100,5940
W20153,3,9/16/2022,QIG43TPVBA,100,5840
W20153,3,9/16/2022,QIG83TVGC2,100,5740
W20153,3,9/16/2022,QIG03V19AG,100,5640
W20153,3,9/20/2022,QIK9D5L5PF,100,5540
W20153,3,9/20/2022,QIK7D5MCHX,100,5440
W20153,3,9/22/2022,QIM2H8PXZ4,100,5340
W20153,3,9/22/2022,QIM3H8RZ51,50,5290
W20153,3,9/29/2022,QIT6WKTNK2,100,5190
W20153,3,9/29/2022,QIT4WL07PY,100,5090
W20154,1,7/13/2022,QGD6DQXJXC,"5000",7800
W20154,1,7/19/2022,QGJ4PX62S0,"2000",5800
W20154,1,7/21/2022,QGL7UUG6NR,"3000",2800
W20154,1,7/22/2022,QGM0WURN3A,"2000",800
W20154,1,7/23/2022,QGN7YGNKN1,800,0
W20154,2,8/17/2022,QHH1CR0CRD,"5000",8600
W20154,2,8/21/2022,QHL3L3K2Q1,"5500",3100
W20154,2,8/23/2022,QHN0OSKJWM,"2000",1100
W20154,2,8/24/2022,QHO2PNNZBU,500,600
W20154,2,8/25/2022,QHP0RCI98G,600,0
W20155,1,7/18/2022,QGI7ONXGVZ,500,13100
W20156,1,7/5/2022,QG54WDP5ZO,"2000",4960
W20156,1,7/12/2022,QGC3CANPA3,"2000",2960
W20156,1,7/13/2022,QGD4ED1AMY,"2960",0
W20156,2,8/3/2022,QH38M6SQBK,"1000",6800
W20156,2,8/5/2022,QH58QKPZVQ,"1000",5800
W20156,2,8/9/2022,QH98YBD75S,"1000",4800
W20156,2,8/11/2022,QHB11QFC07,4800,0
W20157,1,6/30/2022,QFU4M9L5NY,220,5980
W20157,1,7/1/2022,QG12OOUH5W,220,5760
W20157,1,7/5/2022,QG54XF1G1S,700,5060
W20157,1,7/14/2022,QGE3FIA6SV,400,4660
W20157,1,7/20/2022,QGK5RDXAHP,4100,560
W20157,1,7/21/2022,QGL5TFXJQ3,500,60
W20157,1,7/21/2022,QGL6TGZQM8,60,0
W20157,2,8/6/2022,QH62QWDRJ0,650,5850
W20157,2,8/18/2022,QHI4FIF7NG,"5850",0
W20157,3,8/24/2022,QHO3QSBPAN,220,7680
W20157,3,9/21/2022,QIL3E1OC2Z,100,7580
W20157,3,9/21/2022,QIL1E1X585,50,7530
W20157,3,9/21/2022,QIL9EMPJIL,800,6730
W20158,1,7/20/2022,QGK2SP2PX4,"12200",0
W20158,2,8/15/2022,QHF68DY1FA,"12700",0
W20158,3,9/12/2022,QIC8UEQRCE,"9000",4000
W20158,3,9/12/2022,QIC6UW85QU,"2700",1300
W20158,3,9/13/2022,QID2VYVBW8,1300,0
W20158,4,10/14/2022,QJE0USML4U,"2500",16460
W20158,4,10/19/2022,QJJ27BESTI,"1000",15460
W20158,4,10/24/2022,QJO0I8EUUU,1000,14460
W20158,4,10/27/2022,QJR7P3VOJZ,1500,12960
W20158,4,10/31/2022,QJV0XPSKQS,1000,11960
W20158,4,11/4/2022,QK499QS2X1,400,11560
W20158,4,11/7/2022,QK74GQBVOG,500,11060
W20158,4,11/10/2022,QKA5MR2GU3,400,10660
W20158,4,11/12/2022,QKC2R7J78E,500,10160
W20158,4,11/14/2022,QKE9X83LJZ,500,9660
W20158,4,11/21/2022,QKL2CNLAH4,500,9160
W20158,4,12/13/2022,QLD72GO69Z,400,8760
W20158,4,1/5/2023,RA50R5LLIS,500,8260
W20158,4,1/8/2023,RA84X94GF2,1000,7260
W20158,4,1/10/2023,RAA03LJSRM,500,6760
W20158,4,1/11/2023,RAB25Q4CWS,200,6560
W20158,4,1/16/2023,RAG7JKFS73,400,6160
W20158,4,1/20/2023,RAK1ST7O0X,200,5960
W20158,4,1/31/2023,RAV4KCOJNQ,300,5660
W20158,4,2/2/2023,RB28PYYZG4,200,5460
W20159,1,7/27/2022,QGR46P4QTE,"3100",9900
W20159,1,7/27/2022,QGR46TC6JW,"4950",4950
W20159,1,7/27/2022,QGR96VNQH1,"4950",0
W20160,1,7/17/2022,QGH4MRCEFO,"1000",12000
W20160,1,7/20/2022,QGK0R8GGV2,500,11500
W20160,1,7/22/2022,QGM5V7L5M9,500,11000
W20160,1,7/23/2022,QGN5X2B4X7,500,10500
W20160,1,7/25/2022,QGP53RRSIH,11100,600
W20161,1,7/20/2022,QGK8RWBXDC,"12100",0
W20161,2,8/19/2022,QHJ7FWBRKR,"13000",600
W20161,2,8/19/2022,QHJ4FX2GC6,600,0
W20161,3,9/17/2022,QIH460JN0G,500,15300
W20161,3,10/1/2022,QJ152H6E8D,200,15100
W20161,3,10/2/2022,QJ264HNQ9W,200,14900
W20161,3,10/3/2022,QJ34750KIY,200,14700
W20161,3,10/31/2022,QJV0YHCL88,200,14500
W20161,3,11/5/2022,QK53BRTHKJ,200,14300
W20161,3,12/1/2022,QL1029IYZW,200,14100
W20161,3,12/8/2022,QL87NVXI7Z,500,13600
W20162,1,7/10/2022,QGA182LP4B,"1500",10000
W20162,1,7/11/2022,QGB2AZRLZE,"1750",8250
W20162,1,7/18/2022,QGI5O3PQ7Z,"8250",0
W20162,2,8/15/2022,QHF09OB5IS,"2000",11600
W20162,2,8/16/2022,QHG9AGPII7,"11000",600
W20162,2,8/16/2022,QHG9AHRIR5,600,0
W20162,3,9/20/2022,QIK1C63WZ3,500,15300
W20162,3,9/22/2022,QIM6GXOVRK,"1000",14300
W20162,3,9/25/2022,QIP7NJGGJT,500,13800
W20162,3,8/27/2022,QIR4RH8KVG,500,13300
W20162,3,10/1/2022,QJ142AMMBM,600,12700
W20162,3,10/2/2022,QJ294R50T9,100,12600
W20162,3,10/2/2022,QJ224R7OZA,100,12500
W20162,3,10/4/2022,QJ4179HIKF,100,12400
W20162,3,10/9/2022,QJ97KQWXYR,500,11900
W20162,3,10/12/2022,QJC2PXMOOO,200,11700
W20162,3,10/16/2022,QJG0ZZKXAC,700,11000
W20162,3,10/23/2022,QJN9GEBMR9,400,10600
W20162,3,11/7/2022,QK73FVU42L,100,10500
W20162,3,11/7/2022,QK74FVX3U2,100,10400
W20162,3,11/28/2022,QKS4SY9418,200,10200
W20162,3,12/4/2022,QL55E6318N,500,9700
W20162,3,1/9/2023,RA90Z885WM,300,9400
W20162,3,1/15/2023,RAF9GIOWG3,350,9050
W20162,3,1/17/2023,RAH0K06LIK,200,8850
W20162,3,1/23/2023,RAN0YTYS1Y,300,8550
W20162,3,1/27/2023,RAR3A4Y5HN,150,8400
W20162,3,1/30/2023,RAU7JPSBTF,200,8200
W20162,3,2/1/2023,RB13OZBTMH,200,8000
W20163,1,7/26/2022,QGQ14JRKMT,"12200",0
W20163,2,9/1/2022,QI106GMXVC,"12900",0
W20163,3,10/14/2022,QJE6UTZFHA,"12900",0
W20163,4,11/17/2022,QKH55NHA23,"13000",0
W20163,5,12/17/2022,QLH3DOEF5R,"6000",7600
W20163,5,12/18/2022,QLI2FZWHDK,"5000",2600
W20163,5,12/18/2023,QLI9GXGBVH,"2000",600
W20163,5,12/19/2023,QLJ2I7KC5K,600,0
W20163,6,1/18/2023,RAI5NJMUR9,"13600",0
W20163,7,2/11/2023,RBB2EWFUQK,"4000",8800
W20163,7,2/14/2023,RBE7MHXNMZ,"8800",0
W20163,8,3/16/2023,RCG9X4YZTT,"13600",0
W20163,9,4/8/2023,RD81OBXM4H,"12400",0
W20163,10,5/8/2023,RE801P0HNO,"13000",600
W20163,10,5/8/2023,RE842EU6LQ,600,0
W20163,11,7/10/2023,RGA86MMN1Y,"13000",0
W20163,12,8/8/2023,RH84K4D7TG,"13000",0
W20164,1,8/1/2022,QH16H443XA,"7400",3000
W20164,1,8/2/2022,QH23K15E67,"3000",0
W20164,2,8/19/2022,QHJ1HCPIP9,"1000",9320
W20164,2,8/31/2022,QHV44Z6VIA,"9320",0
W20164,3,9/28/2022,QIS7TKB61P,"10400",0
W20165,1,10/6/2022,QJ65C19K0D,"13000",0
W20166,1,8/2/2022,QH27J8EPA1,"12200",0
W20166,2,9/1/2022,QHV54H7E8P,"13000",0
W20166,2,9/1/2022,QHV74HBPYL,100,100
W20167,1,7/26/2022,QGQ44NE6RU,"11300",0
W20166,2,8/25/2022,QHP9RQNVTN,"1000",12600
W20166,2,8/28/2022,QHS7XS1DQL,"12000",600
W20168,1,8/10/2022,QHA5Z4H19T,"12800",0
W20169,1,7/29/2022,QGT0A0D7S2,"3000",2800
W20169,1,8/2/2022,QH27IMTR3D,"2800",0
W20169,2,8/23/2022,QHN2NXJD6S,"3500",3000
W20169,2,8/29/2022,QHT31R4C7H,"3000",0
W20170,1,7/25/2022,QGP32T1N4J,"3500",9500
W20170,1,8/2/2022,QG21J1TW0Z,"2500",7000
W20170,1,8/10/2022,QHA6Z15PQE,"1500",5500
W20170,1,8/13/2022,QHD25584GO,"5500",0
W20170,2,8/30/2022,QHU22BSQ3C,"10000",2400
W20170,2,9/5/2022,QI59FJDRU5,"2400",0
W20170,3,9/28/2022,QIS5TDKKJ9,"11800",300
W20170,3,9/28/2022,QIS7TQ9HX3,100,200
W20170,3,9/28/2022,QIS2TQP458,100,100
W20170,3,9/28/2022,QIS3TQVHZP,100,0
W20170,4,10/24/2022,QJO4HTXQTK,"15240",0
W20170,5,11/6/2022,QK67ESQXPB,"1000",13760
W20170,5,11/15/2022,QKF3YSUWO5,"13760",0
W20170,6,12/8/2022,QL84NHW3TK,"1000",17960
W20170,6,12/9/2022,QL94T0QMM0,350,17610
W20170,6,12/16/2022,QLG5ANJUX5,500,17110
W20170,6,12/20/2022,QLK2MAFM3A,350,16760
W20170,6,12/23/2022,QLN2SRFBP6,350,16410
W20170,6,1/31/2023,RAV9L8S73R,450,15960
W20171,1,8/1/2022,QH14H3SLK0,700,5800
W20171,1,8/3/2022,QH30M8PTSI,800,5000
W20171,1,8/9/2022,QH92YDGEEG,600,4400
W20171,1,8/12/2022,QHC94J7YU5,"1000",3400
W20171,1,8/14/2022,QHE784FTFV,1000,2400
W20171,1,8/16/2022,QHG6ANUIDC,2400,0
W20172,1,9/26/2022,QIQ9PMHG6D,217,6283
W20172,1,9/27/2022,QIR6RPNL3C,217,6066
W20172,1,9/28/2022,QIS4U0989S,217,5849
W20172,1,10/1/2022,QJ15ZXHYRJ,217,5632
W20172,1,10/3/2022,QJ316BPP6X,500,5132
W20172,1,10/4/2022,QJ4993NMT3,217,4915
W20172,1,10/5/2022,QJ54BAVQWO,217,4698
W20172,1,10/7/2022,QJ71FLEIQR,434,4264
W20172,1,10/8/2022,QJ86ICBTYW,217,4047
W20172,1,10/10/2022,QJA0MS0ANC,434,3613
W20172,1,10/11/2022,QJB1P315LL,500,3113
W20172,1,10/12/2022,QJC9RALU83,500,2613
W20172,1,10/14/2022,QJE2UP7CW,1496,1117
W20172,1,10/10/2022,QJF1WXFP65,500,617
W20172,1,10/16/2022,QJG510WEUX,617,0
W20173,1,9/27/2022,QIR8SEV1TU,217,6583
W20173,1,9/29/2022,QIT0UP54G0,217,6366
W20173,1,9/30/2022,QIU4Z8MSD8,217,6149
W20173,1,10/1/2022,QJ132OIZJP,217,5932
W20173,1,10/3/2022,QJ3853UE38,217,5715
W20173,1,10/3/2022,QJ3176SGEP,217,5498
W20173,1,10/14/2022,QJE7WOJ6HJ,300,5198
W20173,1,10/16/2022,QJG0227P5O,300,4898
W20173,1,10/17/2022,QJH44C4L0I,300,4598
W20173,1,10/31/2022,QJV9Y9TBMJ,4598,0
W20174,1,10/25/2022,QJP2JS7JVS,500,6000
W20174,1,10/25/2022,QJP6LZB18U,"1900",4100
W20174,1,10/27/2022,QJR4PGG23C,"4100",0
W20174,2,11/2/2022,QK2459YYAC,900,4900
W20174,2,11/9/2022,QK93K1WM99,"1600",3300
W20174,2,11/10/2022,QKA8NC2ZHE,"3300",0
W20174,3,12/7/2022,QL76KZCFHC,"6450",0
W20174,4,1/5/2023,RA50PS8ZPO,"6500",0
W20174,5,2/2/2023,RB28PZGMFA,"6450",0
W20174,6,2/19/2023,RBJ2Z27PLM,"2000",4450
W20174,6,3/1/2023,RC26T1VG5O,"4450",0
W20174,7,3/29/2023,RCT6W1HX4O,"6450",0
W20174,8,4/27/2023,RDR25Q4MZU,"8160",0
W20174,9,5/26/2023,REQ1G00IMF,"8160",0
W20174,10,6/26/2023,RFQ5Z9QHAX,300,8460
W20174,10,6/29/2023,RFT58ENVKJ,"1000",7460
W20174,10,6/30/2023,RFU3B4SBY5,"1000",6460
W20174,10,7/3/2023,RG30K470CC,500,5960
W20174,10,7/20/2023,RGK4YBH6O2,200,5760
W20174,10,7/24/2023,RGO0AE3YG8,100,5660
W20174,10,7/24/2023,RGO1BKWU99,100,5560
W20174,10,8/5/2023,RH57AIC6CT,100,5460
W20175,1,10/4/2022,QJ499IT9HR,120,3780
W20175,1,10/6/2022,QJ64C1N4TK,100,3680
W20175,1,10/6/2022,QJ65E9AAQV,125,3555
W20175,1,10/11/2022,QJB3PPV471,130,3425
W20175,1,10/12/2022,QJC8S00IYS,150,3275
W20175,1,10/15/2022,QJF7YYRK4D,125,3150
W20175,1,10/17/2022,QJH44BBAKS,100,3050
W20175,1,10/17/2022,QJH54BEEYD,100,2950
W20175,1,10/25/2022,QJP8LY1UP2,200,2750
W20175,1,10/26/2022,QJQ6O1S968,100,2650
W20175,1,10/28/2022,QJS7SU0DX3,100,2550
W20175,1,10/28/2022,QJS4SUA1IC,100,2450
W20175,1,11/2/2022,QK264JUTTA,2450,0
W20175,2,11/7/2022,QK70F9UE16,100,3800
W20175,2,11/8/2022,QK85JUKG9L,100,3700
W20175,2,11/9/2022,QK92MC15ES,100,3600
W20175,2,11/11/2022,QKB7R0RPSZ,100,3500
W20175,2,12/1/2022,QL143KAN4Y,3500,0
W20175,3,12/14/2022,QLE5777TU5,100,4640
W20175,3,12/16/2022,QLG1CN1VF9,100,4540
W20175,3,12/16/2022,QLH8CVT94I,100,4440
W20175,3,1/3/2023,RA36MU1M06,"1000",3440
W20175,3,1/6/2023,RA61U8A7DN,600,2840
W20176,1,10/12/2022,QJC2QO3XCO,"3250",9150
W20176,1,10/19/2022,QJJ47NO1NG,"3250",5900
W20176,1,10/26/2022,QJQ8NHEXA0,"3250",2650
W20176,1,10/27/2022,QJR0PGEEW4,"2650",0
W20176,2,11/3/2022,QK316XDQK3,"3250",9050
W20176,2,11/9/2022,QK94KTPOMO,"3250",5800
W20176,2,11/17/2022,QKH344VPK9,"5500",300
W20176,2,11/17/2022,QKH547VOIB,300,0
W20176,3,11/25/2022,QKP8MAUZHO,"3900",10860
W20176,3,12/2/2022,QL2459LCLQ,"1000",9860
W20176,3,12/4/2022,QL44CJHO4I,"2900",6960
W20176,3,12/7/2022,QL70KWRJM0,1000,5960
W20176,3,12/8/2022,QL81OJI0K5,5960,0
W20176,4,12/16/2022,QLG4AJ6UAO,900,14700
W20176,4,1/4/2023,RA49N7UT6T,"2000",12700
W20176,4,1/4/2023,RA43N8DQU3,"2000",10700
W20176,4,1/5/2022,RA57QNV06L,"8100",2600
W20176,4,1/5/2022,RA52QVL3E2,"2600",0
W20176,5,1/17/2023,RAH3LKEAV7,"1050",13350
W20176,5,1/22/2023,RAM5YAN71P,"7800",5550
W20176,5,1/23/2023,RAN1Z3LQBZ,"1350",4200
W20176,5,1/23/2023,RAN6Z4AAH0,"4200",0
W20176,6,2/20/2023,RBK745NSP7,"12500",3820
W20176,6,2/21/2023,RBL45GHGK0,"2000",1820
W20176,6,2/21/2023,RBL25U4G5W,"1620",200
W20176,6,2/21/2023,RBL45UAKAY,200,0
W20176,7,3/17/2023,RCH0ZNXXAG,"12400",2720
W20176,7,3/17/2023,RCH411815I,"2720",0
W20177,1,10/21/2022,QJL4B40URM,"2000",8400
W20177,1,11/2/2022,QK224371PW,"8400",0
W20177,2,11/30/2022,QKU7YMKTQL,"10400",0
W20177,3,12/31/2022,QLV9DF2ENR,"3500",8180
W20177,3,1/3/2023,RA41N1284N,"2000",6180
W20177,3,1/5/2023,RA59PT6EWX,"2000",4180
W20177,3,2/28/2023,RBS1O914KX,120,4060
W20177,3,3/4/2023,RC48Z6HZ1O,150,3910
W20177,3,3/7/2023,RC7387TFLN,150,3760
W20177,3,3/14/2023,RCE7QPCU13,150,3610
W20177,3,3/17/2023,RCI729APX3,150,3460
W20177,3,3/20/2023,RCL3A1QVT1,150,3310
W20177,3,3/28/2023,RCS2SK9YLU,150,3160
W20177,3,6/30/2023,RFT2A0FXPE,200,2960
W20178,1,10/14/2022,QJE0WOGW6K,10,6490
W20178,1,10/14/2022,QJE8WOIPAO,"1400",5090
W20178,1,10/15/2022,QJF8YZZ5HC,206,4884
W20178,1,10/16/2022,QJG422BWBG,216,4668
W20178,1,10/21/2022,QJL4D4RHE4,1418,3250
W20178,1,11/1/2022,QK1419VR9C,1416,1834
W20178,1,11/4/2022,QK47AB43DV,1834,0
W20178,2,11/14/2022,QKE5XWSGJR,"1600",4850
W20178,2,11/21/2022,QKL6ES03WE,"1600",3250
W20178,2,11/28/2022,QKS5V2BKP1,"1600",1650
W20178,2,12/5/2022,QL54F17C7M,1650,0
W20178,3,1/6/2023,RA69S2LDO1,"2500",4300
W20178,3,1/6/2022,RA60TCQ306,"4300",0
W20178,4,2/1/2023,RB10O4F8FY,"2000",5300
W20178,4,2/8/2023,RB97908N75,500,4800
W20178,4,2/14/2023,RBE4NB6SFG,200,4600
W20179,1,10/7/2022,QJ72FLBCJY,500,5100
W20179,1,10/8/2022,QJ83HPTJSP,500,4600
W20179,1,10/9/2022,QJ91JFK4TJ,500,4100
W20179,1,10/10/2022,QJA1LHQGXX,500,3600
W20179,1,10/11/2022,QJB0NRU2R6,500,3100
W20179,1,10/12/2022,QJC6Q0CHMO,500,2600
W20179,1,10/13/2022,QJD5SDFMCZ,500,2100
W20179,1,10/14/2022,QJE8UTNJX4,500,1600
W20179,1,10/15/2022,QJF8X0IACU,500,1100
W20179,1,10/16/2022,QJG5Z99E0D,500,600
W20179,1,10/16/2022,QJG9ZJMRSX,600,0
W20179,2,10/18/2022,QJI04SJ0AO,500,5100
W20179,2,10/19/2022,QJJ77YMZJZ,500,4600
W20179,2,10/20/2022,QJK4AMY65W,500,4100
W20179,2,10/21/2022,QJL5CQ8T7X,500,3600
W20179,2,10/22/2022,QJM5F1JF55,500,3100
W20179,2,10/23/2022,QJN0GZD3X0,500,2600
W20179,2,10/24/2022,QJO7INO98F,500,2100
W20179,2,10/25/2022,QJP5L1TT2D,500,1600
W20179,2,10/27/2022,QJR5Q2X7OD,800,800
W20179,2,10/27/2022,QJR9QDDSVX,800,0
W20179,3,10/29/2022,QJT9UXK6V9,500,5100
W20179,3,10/30/2022,QJU1WZUWHP,500,4600
W20179,3,10/31/2022,QJV6ZLOCB8,500,4100
W20179,3,11/1/2022,QK152LBON9,500,3600
W20179,3,11/2/2022,QK2856EBK2,500,3100
W20179,3,11/3/2022,QK347MP63G,500,2600
W20179,3,11/4/2022,QK46A31OJY,500,2100
W20179,3,11/6/2022,QK66EWFPKK,1050,1050
W20179,3,11/5/2022,QK56CK94WO,1050,0
W20179,4,11/8/2022,QK89JEJT8F,100,5500
W20179,4,11/8/2022,QK83JF0T9B,100,5400
W20179,4,11/8/2022,QK88JGIX3O,100,5300
W20179,4,11/8/2022,QK82JGRMOE,100,5200
W20179,4,11/8/2022,QK81JH0X6L,100,5100
W20179,4,11/9/2022,QK91LZ4R81,100,5000
W20179,4,11/9/2022,QK93LZ9NJB,100,4900
W20179,4,11/9/2022,QK92LZK6HS,100,4800
W20179,4,11/9/2022,QK93LZRFMN,100,4700
W20179,4,11/9/2022,QK95LZXLEB,100,4600
W20179,4,11/10/2022,QKA4O1E3ZC,100,4500
W20179,4,11/10/2022,QKA1O1KNMV,100,4400
W20179,4,11/10/2022,QKA5O1RNOB,100,4300
W20179,4,11/10/2022,QKA3O20HXR,100,4200
W20179,4,11/10/2022,QKA6O2BRRA,100,4100
W20179,4,11/13/2022,QKD6TP080E,100,4000
W20179,4,11/13/2022,QKD5TP3MZB,100,3900
W20179,4,11/13/2022,QKD7TP85EL,100,3800
W20179,4,11/13/2022,QKD6TPBQRI,100,3700
W20179,4,11/13/2022,QKD3TPG4ZJ,100,3600
W20179,4,11/13/2022,QKD9VI5SPR,100,3500
W20179,4,11/13/2022,QKD7VIAJ81,100,3400
W20179,4,11/13/2022,QKD4VIGQGC,100,3300
W20179,4,11/13/2022,QKD7VIKBEN,100,3200
W20179,4,11/13/2022,QKD3VIOA37,100,3100
W20179,4,11/14/2022,QKE4XO1SFI,100,3000
W20179,4,11/14/2022,QKE9XO5NCH,100,2900
W20179,4,11/14/2022,QKE0XOA2BA,100,2800
W20179,4,11/14/2022,QKE7XOGIIN,100,2700
W20179,4,11/14/2022,QKE0XOKODQ,100,2600
W20179,4,11/17/2022,QKH94TSA1R,2550,50
W20179,4,11/17/2022,QKH456TDJC,50,0
W20179,5,11/19/2022,QKJ1A8WF51,800,7040
W20179,5,11/20/2022,QKK9CDQ7SD,800,6240
W20179,5,11/21/2022,QKL7EL88TR,800,5440
W20179,5,11/22/2022,QKM5H0Q82R,100,5340
W20179,5,11/22/2022,QKM7H0Y32B,100,5240
W20179,5,11/22/2022,QKM0H0X9BK,100,5140
W20179,5,11/23/2022,QKN6J4JM6G,100,5040
W20179,5,11/23/2022,QKN8J4PNIE,100,4940
W20179,5,11/23/2022,QKN6J4VV4W,100,4840
W20179,5,11/24/2022,QKO2LG8IKO,800,4040
W20179,5,11/25/2022,QKP7O4GUN5,1000,3040
W20179,5,11/27/2022,QKR1QS1OY3,1000,2040
W20179,5,11/27/2022,QKR9SI5ZIZ,2040,0
W20179,6,11/29/2022,QKT3XB8KWJ,"1000",6840
W20179,6,11/30/2022,QKU212CQ4W,"1000",5840
W20179,6,12/1/2022,QL1343T6PV,1000,4840
W20179,6,12/4/2022,QL44DH4P7S,1000,3840
W20179,6,12/5/2022,QL50H4AN3S,1000,2840
W20179,6,12/6/2022,QL65IPB6NH,2840,0
W20179,7,12/7/2022,QL71N20FMJ,800,7040
W20179,7,12/8/2022,QL83Q2GY8R,"1000",6040
W20179,7,12/9/2022,QL94SUYHPU,1000,5040
W20179,7,12/12/2022,QLC51NCB3P,1000,4040
W20179,7,12/13/2022,QLD048M268,1000,3040
W20179,7,12/14/2022,QLE875DUBC,1000,2040
W20179,7,12/16/2022,QLG3ACPN6R,2040,0
W20179,8,12/17/2022,QLH1FCJN9X,"1000",10300
W20179,8,12/19/2022,QLJ8K9I7CC,"1000",9300
W20179,8,12/21/2022,QLL5NB1Y1P,1000,8300
W20179,8,12/23/2022,QLN6VBJ780,1000,7300
W20179,8,12/28/2022,QLS87JQYHU,7300,0
W20179,9,12/29/2022,QLT0ALJHWG,"1000",10300
W20179,9,12/30/2022,QLU8D1QFBM,"1000",9300
W20179,9,1/2/2023,RA20K9ZAV0,3000,6300
W20179,9,1/9/2022,RA98ZI9C04,6200,100
W20179,9,1/9/2023,RA96ZM70ES,100,0
W20179,10,1/14/2023,RAE4CXJWU8,"6000",5200
W20179,10,1/19/2023,RAY6GHJCD4,"5200",0
W20179,11,1/25/2023,RAE4CXJWU82,"11200",0
W20179,12,1/26/2023,RAQ997L4AD,"1000",10200
W20179,12,1/27/2023,RAR7C8OO0T,600,9600
W20179,12,1/28/2023,RAS8EXU64G,1000,8600
W20179,12,1/30/2023,RAU3HUBG09,1000,7600
W20179,12,2/5/2023,RB54ZMBA3S,7600,0
W20179,13,2/12/2023,RBC0IZISD8,"2650",10790
W20179,13,2/13/2023,RBD8LOI3KC,2650,8140
W20179,13,2/14/2023,RBE8OBNZAA,1200,6940
W20179,13,2/15/2023,RBF5QWCO5B,1250,5690
W20179,13,2/17/2023,RBH0TY8W7U,5690,0
W20179,14,2/20/2023,RBK94T0FQP,"1500",11940
W20179,14,2/25/2023,RBP2G4DQR6,11940,0
W20179,15,2/25/2023,RBP6HJFUHS,"2000",11440
W20179,15,2/26/2023,RBQ5JXHLJ1,500,10940
W20179,15,2/27/2023,RBR2MXA5AM,500,10440
W20179,15,2/28/2023,RBS7NEEM4P,10040,400
W20179,15,2/28/2023,RBS0NEKUYE,400,0
W20179,16,3/11/2023,RCB1IWWK0T,"15680",0
W20179,17,3/24/2023,RCO9KEJV73,400,17520
W20179,17,3/25/2023,RCP3N3ZTM1,300,17220
W20179,17,3/26/2023,RCQ9PF8C4F,200,17020
W20179,17,4/6/2023,RD68J7UJ5S,17020,0
W20179,18,4/6/2023,RD65KJPNBR,500,18540
W20179,18,5/8/2023,RE851XZJLV,10000,8540
W20180,1,10/15/2022,QJF9YK7A1R,"1625",4725
W20180,1,10/22/2022,QJM1EV5MOF,"1625",3100
W20180,1,10/31/2022,QJV6XIL108,"1625",1475
W20180,1,11/3/2022,QK3166CMLT,"1475",0
W20180,2,11/11/2022,QKB3QWW5ML,"1025",5325
W20180,2,11/23/2022,QKN7J0N15J,"1425",3900
W20180,2,11/28/2022,QKS8TM3CCU,3900,0
W20180,3,19/12/2022,QLJ0I8IONO,"1625",4625
W20180,3,12/21/2022,QLL7NC9WNN,800,3825
W20180,3,12/21/2022,QLL9OC1HWX,3825,0
W20180,4,1/19/2023,RAJ6OU3MHU,"4500",2300
W20180,4,1/19/2023,RAJ7PHNLSX,"2300",0
W20180,5,2/17/2023,RBH1V0BQCL,"1000",5800
W20180,5,2/19/2023,RBJ42AWEGU,"5800",0
W20180,6,3/20/2023,RCK58SG7VF,"3500",3000
W20180,6,3/20/2023,RCK69XPRXO,"3000",0
W20180,7,4/19/2023,RDJ7JKP14N,"2000",4800
W20180,7,4/21/2023,RDL9OOOYE9,"1500",3300
W20180,7,4/25/2023,RDP2ZB5DD0,3300,0
W20180,8,6/24/2023,RFO1TSN5AL,"1000",6900
W20180,8,6/20/2023,RFK4I3L0TI,500,6400
W20180,8,6/28/2023,RFS65L46SC,500,5900
W20180,8,7/1/2023,RG14EHI5BO,500,5400
W20180,8,7/17/2023,RGI2SVCUUQ,500,4900
W20180,8,7/22/2023,RGM45K54KK,500,4400
W20180,8,7/31/2023,RGV2UW73PK,800,3600
W20180,8,8/1/2023,RH18XHEDHE,200,3400
W20180,8,8/2/2023,RH221I93P6,200,3200
W20180,8,8/8/23 10:42,RH83JTS5HF,200,3000
W20180,8,7/8/23 8:29,RH72GFSQC0,200,2800
W20180,8,5/8/23 12:16,RH54B5I6HW,200,2600
W20180,8,8/11/2023,RHB2SKSYJS,200,2400
W20181,1,10/110/2022,QJA8N89CXS,200,7200
W20181,1,10/18/2022,QJI861C082,200,7000
W20181,1,10/24/2022,QJO6HWFCS2,250,6750
W20181,1,10/25/2022,QJP7KRBWDJ,150,6600
W20181,1,12/25/2022,QLP1ZRJIHF,6600,0
W20182,1,10/18/2022,QJI96IZYAB,"1600",4350
W20182,1,10/26/2022,QJQ6NE0VS0,"1650",2700
W20182,1,10/28/2022,QJS4RCV87Y,"2700",0
W20182,2,11/10/2022,QKA8O1GWIC,"1000",5150
W20182,2,11/19/2022,QKI86GXZ08,"5150",0
W20182,3,11/26/2022,QKQ7PTAHQZ,"1000",5100
W20182,3,12/8/2022,QL86NPM8ZI,"5100",0
W20182,4,12/15/2022,QLF19VJ0HZ,"1000",5500
W20182,4,12/23/2022,QLN2SNKYOS,625,4875
W20182,4,1/5/2023,RA57Q0BV7H,"4875",0
W20182,5,1/13/2023,RAD9A11D77,500,6800
W20183,1,10/15/2022,QJF4XBVEGY,217,5983
W20183,1,10/15/2022,QJF9Z0N5L5,217,5766
W20183,1,10/18/2022,QJI469OEGU,250,5516
W20183,1,10/27/2022,QJR9OHHR45,100,5416
W20183,1,10/27/2022,QJR9OHKBHF,100,5316
W20183,1,10/27/2022,QJR2OHO20U,50,5266
W20183,1,11/1/2022,QK17179F87,100,5166
W20183,1,11/1/2022,QK1117D2RV,100,5066
W20183,1,11/1/2022,QK1517G05V,50,5016
W20183,1,11/4/2022,QK47ACZ1I1,4900,116
W20183,1,11/5/2022,QK53B63JTP,100,16
W20183,1,11/5/2022,QK57B668E7,16,0
W20183,2,1/3/2023,RA31MFZVZN,"6800",0
W20184,1,10/14/2022,QJE1WNLM7L,130,3680
W20184,1,10/18/2022,QJI54OCZ1J,520,3160
W20184,1,10/22/2022,QJM5FBMZPR,520,2640
W20184,1,10/25/2022,QJP4LHWPAY,390,2250
W20184,1,10/27/2022,QJR0PU54CE,130,2120
W20184,1,10/31/2022,QJV2YYEH76,650,1470
W20184,1,11/4/2022,QK4488853W,130,1340
W20184,1,11/9/2022,QK94LJMMWI,1340,0
W20185,1,10/22/2022,QJM0DJM0DI,"1625",4825
W20185,1,10/29/2022,QJT0T2EJAG,"1625",3200
W20185,1,11/5/2022,QK56AV3C8C,"1625",1575
W20185,1,11/11/2022,QKB8PD0D1G,"1575",0
W20185,2,11/19/2022,QKJ587SJY9,"1625",4525
W20185,2,11/26/2022,QKQ8OF8EZ2,"1625",2900
W20185,2,12/3/2022,QL33870YGD,"1625",1275
W20185,2,12/3/2022,QL3588O18B,"1275",0
W20185,3,12/10/2022,QLA3TIJOET,"1625",4525
W20185,3,12/22/2022,QLM3Q25SDT,"1625",2900
W20185,3,12/24/2022,QLO7VTWTCT,"1625",1275
W20185,3,12/24/2022,QLO6WJL0AY,"1275",0
W20185,4,1/4/2023,RA44NGBRAM,"2275",6825
W20185,4,1/7/2023,RA74VKKWCE,"1000",5825
W20185,4,1/12/2023,RAC67WC7IU,"1275",4550
W20185,4,1/16/2023,RAG6HK3AMO,"2275",2275
W20185,4,1/21/2023,RAL1UJ14TD,"2275",0
W20185,5,3/11/2023,RCB0IM8L42,"1000",10060
W20185,5,7/12/2023,RGC5CBAUJN,"6000",4060
W20186,1,10/26/2022,QJQ6M259KI,"2275",6755
W20186,1,11/2/2022,QK2638PEYM,"2275",4480
W20186,1,11/14/2022,QKE6XN22OM,"4480",0
W20186,2,11/22/2022,QKM9G4BJ2R,"2275",5565
W20186,2,11/26/2022,QKQ2Q6R12U,"5565",0
W20186,3,12/9/2022,QL99RNSIO9,"7840",0
W20186,4,1/6/2023,RA69TLL0PX,"9100",0
W20186,5,1/16/2023,RAG8HW4FZA,"2275",6825
W20186,5,1/25/2023,RAP64WZH4O,"2275",4550
W20186,5,2/3/2023,RB34T6NF7Y,"4550",0
W20186,6,3/8/2023,RC89BAQ2O1,"13000",0
W20186,7,4/5/2023,RD54GGW3F2,"13000",0
W20186,8,5/3/2023,RE30MOQE4U,"13000",0
W20187,1,11/1/2022,QK192S5J4L,"2600",8280
W20187,1,11/21/2022,QKL3D9O5O3,"2000",6280
W20187,1,11/23/2022,QKN3I3C97T,"6280",0
W20187,2,12/2/2022,QL294SEEVD,"2600",7480
W20187,2,12/8/2022,QL84PL7KYC,"4000",3480
W20187,2,12/17/2022,QLH7DOOASX,"3480",0
W20187,3,1/14/2023,RAE8DFS1H4,"10400",0
W20187,4,2/2/2023,RB20PNA7UK,500,10380
W20187,4,2/3/2023,RB37SAKYJB,500,9880
W20187,4,2/14/2023,RBE8M51D70,"9880",0
W20188,1,10/27/2022,QJR1PDPSFP,220,6580
W20188,1,10/28/2022,QJS3SH5TVX,220,6360
W20188,1,10/29/2022,QJT9UYD8VX,220,6140
W20188,1,10/31/2022,QJV4ZH4L8O,220,5920
W20188,1,11/7/2022,QK71HD8LVV,500,5420
W20188,1,11/11/2022,QKB9QX5EQZ,200,5220
W20188,1,11/17/2022,QKH85H93EA,300,4920
W20188,1,11/23/2022,QKN3IRMRFJ,400,4520
W20188,1,11/25/2022,QKP2MP9I94,4520,0
W20188,2,27/12/2022,QLQ53Q9FZR,"3000",4900
W20188,2,1/8/2023,RA85YWZZK9,200,4700
W20189,1,11/22/2022,QKM0G1B2Q4,"12900",0
W20189,2,11/30/2022,QKU7XSETFD2,"3250",10350
W20189,2,12/8/2022,QL80OE6XSA,"3250",7100
W20189,2,12/22/2022,QLM4R6Y15Q,"7100",0
W20189,3,1/5/2023,RA58PQKLII,"4000",8700
W20189,3,1/13/2023,RAD6AMEO1K,"4000",4700
W20189,3,1/16/2023,RAG4HVWCMA,"4700",0
W20189,4,1/31/2023,RAV3KFN9GZ,"6500",6500
W20189,4,2/13/2022,RBD6JWN5I4,"6500",0
W20189,5,3/27/2023,RCR9R5VX5N,"3000",11600
W20189,5,4/4/2023,RD42DMAMA0,"7300",4300
W20189,5,4/4/2023,RD41DN1DBP,"4300",0
W20190,1,10/28/2023,QJS3SGKS1F,140,3760
W20190,1,10/31/2022,QJV6YZGFGK,500,3260
W20190,1,11/1/2022,QK1734MDTV,150,3110
W20190,1,11/3/2022,QK327WI5V4,120,2990
W20190,1,11/5/2022,QK50CXDGJC,260,2730
W20190,1,11/16/2022,QKG81VYHGO,500,2230
W20190,1,11/25/2022,QKP1MLFZYT,2230,0
W20191,1,11/3/2022,QK327VUKQS,435,12465
W20191,1,11/5/2022,QK50AWJ4PK,435,12030
W20191,1,11/10/2022,QKA5MCKO6V,500,11530
W20191,1,11/11/2022,QKB9OWUM2T,500,11030
W20191,1,11/16/2022,QKG41V8H4I,500,10530
W20191,1,11/19/2022,QKJ68BBYXO,1000,9530
W20191,1,11/19/2022,QKJ0AD2CX0,500,9030
W20191,1,11/22/2022,QKM0H3PSNY,1000,8030
W20191,1,11/30/2022,QKU7Y85TT7,8030,0
W20191,2,12/1/2022,QL1142SPMZ,450,12450
W20191,2,12/2/2022,QL237HRAWF,500,11950
W20191,2,12/5/2022,QL57E5V9NZ,"1000",10950
W20191,2,12/28/2022,QLS479ADJG,"10950",0
W20191,3,12/29/2022,QLT7AOGFBB,450,11850
W20191,3,1/5/2023,RA50POWZBS,"1000",10850
W20191,3,1/10/2023,RAA02REHEG,"1000",9850
W20191,3,1/12/2023,RAC69UEU9Y,"1250",8600
W20191,3,1/19/2023,RAJ2PCGB2Q,"8600",0
W20191,4,2/21/2023,RBL46HBP00,"1500",17460
W20191,4,2/23/2023,RBN0AGW6U,500,16960
W20191,4,2/24/2023,RBO6D953D8,500,16460
W20191,4,3/1/2023,RC17Q0FF33,500,15960
W20191,4,3/14/2023,RCE1RMW2UN,200,15760
W20192,1,11/29/2022,QKT6VY935O,"2000",8320
W20192,1,12/1/2023,QL122EGUJ6,"8320",0
W20192,2,2/4/2023,RB45VURCCN,200,11480
W20192,2,2/9/2023,RB91A8XQLX,350,11130
W20193,1,11/29/2022,QKT0WVXV1C,"5020",2880
W20194,1,11/11/2022,QKB1R0WE71,350,9250
W20194,1,11/12/2022,QKC2TGADYU,410,8840
W20194,1,11/17/2022,QKH05PAQHC,100,8740
W20194,1,11/17/2022,QKH75PBCXV,70,8670
W20194,1,11/17/2022,QKH75PCNXT,100,8570
W20194,1,11/23/2022,QKN2HN13WG,250,8320
W20194,1,11/24/2022,QKO0LKXJSY,350,7970
W20194,1,11/28/2022,QKS0TZM914,4000,3970
W20194,1,11/28/2022,QKS0UEV18Q,3970,0
W20194,2,12/12/2022,QLC51TWHY7,400,9520
W20194,2,12/13/2022,QLD24IT1HS,420,9100
W20194,2,12/18/2022,QLI4HO7A7O,"1300",7800
W20194,2,12/18/2022,QLI4H3Z9G4,"1350",6450
W20194,2,12/19/2022,QLJ5JKMB4J,100,6350
W20194,2,12/19/2022,QLJ8JM79OC,500,5850
W20194,2,12/19/2022,QLJ1JSW4ZN,100,5750
W20194,2,12/19/2022,QLJ3JWNDNX,100,5650
W20194,2,12/19/2022,QLJ5JZE79L,100,5550
W20194,2,12/19/2022,QLJ2K25HSK,500,5050
W20194,2,12/19/2022,QLJ1K3I497,100,4950
W20194,2,12/19/2022,QLJ7K8XGSH,50,4900
W20194,2,12/19/2022,QLJ7KBUYXT,100,4800
W20194,2,12/19/2022,QLJ7KCGUPT,50,4750
W20194,2,12/19/2022,QLJ6KFR6S0,50,4700
W20194,2,12/19/2022,QLJ8KF96KI,50,4650
W20194,2,12/20/2022,QLK8KMQW1M,"1280",3370
W20194,2,12/20/2022,QLK8KPA97M,100,3270
W20194,2,12/20/2022,QLK3KPDJQ5,90,3180
W20194,2,12/20/2022,QLK3KPPFIP,100,3080
W20194,2,12/20/2022,QLK9LZR3KN,"3080",0
W20194,3,1/8/2023,RA83Z1IZ6N,450,9950
W20194,3,1/9/2023,RA982HG52G,475,9475
W20194,3,1/11/2023,RAB07EQMY2,"1770",7705
W20194,3,1/13/2023,RAD8CDD6RC,"1460",6245
W20194,3,1/13/2023,RAD4CDQP4Y,100,6145
W20194,3,1/15/2023,RAE6EUMDD4,400,5745
W20194,3,1/15/2023,RAF8GTAU8U,"1000",4745
W20194,3,1/15/2023,RAF0H1PQ8S,720,4025
W20194,3,1/15/2023,RAF4H4TCXE,100,3925
W20194,3,1/15/2023,RAF3H5P6VJ,100,3825
W20194,3,1/15/2023,RAF3H5R7ST,40,3785
W20194,3,1/16/2023,RAG7IJEQTL,505,3280
W20194,3,1/16/2023,RAG6IM59Q6,500,2780
W20194,3,1/16/2023,RAG4IMD3FS,50,2730
W20194,3,1/16/2023,RAG0J0MKRM,495,2235
W20194,3,1/16/2023,RAG6JBBVWW,50,2185
W20194,3,1/16/2023,RAG8JG9A40,100,2085
W20194,3,1/16/2023,RAG2JK0ECM,500,1585
W20194,3,1/16/2023,RAG9JLMJQH,255,1330
W20194,3,1/17/2023,RAH9JRX451,650,680
W20194,3,1/17/2023,RAH5JSWEJN,200,480
W20194,3,1/17/2023,RAH4JWF1D4,100,380
W20194,3,1/17/2023,RAH5JX99DH,50,330
W20194,3,1/17/2023,RAH0JZFQ8M,100,230
W20194,3,1/17/2023,RAH0K0GB9Y,50,180
W20194,3,1/17/2023,RAH6K4UBXI,100,80
W20194,3,1/17/2023,RAH8K5ZJSQ,75,5
W20194,3,1/17/2023,RAH2KGJE1C,100,95
W20194,3,1/17/2023,RAH5KGNAND,95,190
W20194,3,1/17/2023,RAH2KGRZD6,100,290
W20194,3,1/17/2023,RAH6KGVALS,95,385
W20194,3,1/17/2023,RAH9KHDZH7,55,440
W20194,4,2/10/2023,RB97BBXRYB,900,9500
W20194,4,2/10/2023,RBA0CP0R5G,100,9400
W20194,4,2/10/2023,RBA5CRGDON,100,9300
W20194,4,2/10/2023,RBA8CZCH6Q,100,9200
W20194,4,2/10/2023,RBA2DXAURY,"2450",6750
W20194,4,2/10/2023,RBA2E2GRWG,"1000",5750
W20194,4,2/11/2023,RBB5GS8D05,"2200",3550
W20194,4,2/12/2023,RBC2IW2R3A,"1000",2550
W20194,4,2/12/2023,RBC3J4DO1H,"1350",1200
W20194,4,2/12/2023,RBC1J565B5,50,1150
W20194,4,2/12/2023,RBC4J6GF3A,100,1050
W20194,4,2/13/2023,RBD7JC2ZN1,"1000",50
W20194,4,2/13/2023,RBD6JR0RQ2,50,0
W20194,5,3/8/2023,RC89CRVZ7H,100,10140
W20194,5,3/8/2023,RC84CRXD7W,60,10080
W20194,5,3/8/2023,RC84CRYIJO,50,10030
W20194,5,3/9/2023,RC96EMWY40,"2150",7880
W20194,5,3/9/2023,RC93F394IJ,400,7480
W20194,5,3/9/2023,RC99FGE3SX,500,6980
W20194,5,3/10/2023,RCA1FPVZF5,"1000",5980
W20194,5,3/10/2023,RCA7G2N97Z,100,5880
W20194,5,3/10/2023,RCA6G2US50,50,5830
W20194,5,3/10/2023,RCA0G3U9P2,100,5730
W20194,5,3/10/2023,RCA7GDMPFV,400,5330
W20194,5,3/10/2023,RCA5H3QFLX,500,4830
W20194,5,3/10/2023,RCA0HBU0J8,300,4530
W20194,5,3/10/2023,RCA5HQCLBX,440,4090
W20194,5,3/10/2023,RCA9ICTY29,60,4030
W20194,5,3/11/2023,RCB9J79EJB,"4030",0
W20194,6,4/3/2023,RD36A5JB0G,400,9840
W20194,6,4/3/2023,RD30C6LPBU,"3000",6840
W20194,6,4/4/2023,RD48EY0APU,"2000",4840
W20194,6,4/5/2023,RD59HK4GGV,"2300",2540
W20194,6,4/5/2023,RD58HNDE5G,100,2440
W20194,6,4/5/2023,RD53HO4M97,100,2340
W20194,6,4/6/2023,RD66IIGY5A,"2340",0
W20194,7,5/1/2023,RE14I9S6DU,"2800",7600
W20194,7,5/2/2023,RE28J9JPKG,100,7500
W20194,7,5/2/2023,RE23JAH44T,100,7400
W20194,7,5/2/2023,RE27KH4BSH,"1000",6400
W20194,7,5/2/2023,RE29L044Y1,"2000",4400
W20194,7,5/3/2023,RE31M6V5HZ,"1000",3400
W20194,7,5/3/2023,RE31MCSS4R,"1400",2000
W20194,7,5/4/2023,RE49NXZI8H,500,1500
W20194,7,5/4/2023,RE48O6JDZ6,"1500",0
W20194,8,5/27/2023,RER2J0UVMK,"10000",0
W20194,9,6/20/2023,RFK1K4IJEL,850,9550
W20194,9,6/21/2023,RFL0MZQEGC,950,8600
W20194,9,6/22/2023,RFM2NMLWGS,100,8500
W20194,9,6/22/2023,RFM4NN0BCK,50,8450
W20194,9,6/22/2023,RFM6NCLYAG,450,8000
W20194,9,6/22/2023,RFM5PW6PMF,"1000",7000
W20194,9,6/23/2023,RFN9QZUCG5,900,6100
W20194,9,6/23/2023,RFN6RFLZAI,"1000",5100
W20194,9,6/23/2023,RFN6ROJ4YS,100,5000
W20194,9,6/23/2023,RFN7SPBAEJ,"3500",1500
W20194,9,6/23/2023,RFN7SVJ43H,1300,200
W20194,9,6/24/2023,RFO7T2U6M3,100,100
W20194,9,6/24/2023,RFO6T3N03I,100,0
W20194,10,7/16/2023,RGG7PNZWXT,"5500",4500
W20194,10,7/16/2023,RGG4OHAS4G,"1500",3000
W20194,10,7/17/2023,RGH0PVPZCW,500,2500
W20194,10,7/17/2023,RGH9PZYIKR,"2500",0
W20194,11,8/10/2023,RHA2S76OHU,"6000",4000
W20194,11,8/9/2023,RH90P7PHGU,"4000",0
W20195,1,11/16/2022,QKG92UFNZJ,400,6000
W20195,1,11/18/2022,QKI779AT2P,100,5900
W20195,1,11/22/2022,QKM9EWIVU9,100,5800
W20195,1,11/28/2022,QKS7TYE7UX,"2000",3800
W20195,1,12/2/2022,QL2348EDM7,250,3550
W20195,1,12/7/2022,QL78KFPAKI,1050,2500
W20195,1,12/7/2022,QL71MUSMM7,1700,800
W20195,1,12/8/2022,QL83NSWUFF,700,100
W20195,1,12/8/2022,QL81OXYLLD,100,0
W20195,2,12/21/2022,QLL9NTUAJD,200,5000
W20195,2,12/28/2022,QLS38DA0ST,150,4850
W20195,2,1/5/2023,RA54RS1CXS,"2550",2300
W20195,2,1/6/2022,RA63SYYFVB,2300,0
W20195,3,1/19/2023,RAJ2P37ZX4,200,6050
W20195,3,1/28/2023,RAS7F12TKZ,"2000",4050
W20195,3,1/30/2023,RAU7IUFUIV,"4050",0
W20195,4,2/6/2023,RB613DPMIP,200,6300
W20195,4,2/27/2023,RBR3M0BDJN,"4000",2300
W20195,4,2/28/2023,RBS0POGXL6,"2300",0
W20195,5,5/9/2023,RE925N9XX4,"2000",4500
W20195,5,5/11/2023,REB3BGBQIL,"2200",2300
W20195,5,5/12/2023,REC0CP7UNI,"1300",1000
W20195,5,5/12/2023,REC8D1RPMU,1000,0
W20195,6,5/19/2023,REJ3VK32Z7,200,6100
W20195,6,5/25/2023,REP1FACB8F,"3000",3100
W20195,6,6/3/2023,RF3344ECKJ,100,3000
W20195,6,6/3/2023,RF3144JWBL,60,2940
W20195,6,6/3/2023,RF386GIZBM,600,2340
W20195,6,6/4/2023,RF477XFMVJ,400,1940
W20195,6,6/6/2023,RF69CUYVWZ,1990,50
W20195,7,7/3/2023,RG35LFN407,"5600",2200
W20195,7,7/5/2023,RG59QU83GB,800,1400
W20195,7,7/5/2023,RG56R8OEU8,"1400",0
W20196,1,12/13/2022,QLD63F673C,"6800",0
W20196,2,1/12/2022,RAC58TA6IJ,"6800",0
W20196,3,8/4/2023,RH52B26ABC,"1000",6900
W20196,3,8/10/2023,RHA9QEE0WD,"1000",5900
W20197,1,11/13/2022,QKD6V7EWUM,109,3291
W20197,1,11/14/2022,QKE4XMVV7K,109,3182
W20197,1,11/22/2022,QKM1FNLE5X,400,2782
W20197,1,12/13/2022,QLD421DP4E,"1400",1382
W20197,1,12/14/2022,QLE553IH5H,1382,0
W20197,2,12/16/2022,QLG8BVI2QA,100,3300
W20197,2,12/16/2022,QLG3BWOKPB,9,3291
W20197,2,12/17/2022,QLH1F8EXF1,100,3191
W20197,2,12/17/2022,QLH5F8KHTB,50,3141
W20197,2,12/18/2022,QLI9HBGJAV,100,3041
W20197,2,12/19/2022,QLJ3KBEWZL,100,2941
W20197,2,12/20/2022,QLK2MAFM3A2,100,2841
W20197,2,12/21/2022,QLL6OYY72A,100,2741
W20197,2,12/22/2022,QLM1RR3XM9,100,2641
W20197,2,12/22/2022,QLM4RRAX2U,30,2611
W20197,2,12/23/2022,QLN6V4TKDO,100,2511
W20197,2,12/24/2022,QLO9Y8G3TJ,100,2411
W20197,2,12/29/2022,QLT2A3CYQC,100,2311
W20197,2,12/29/2022,QLT0A3IFMC,15,2296
W20197,2,12/30/2022,QLU6D0MDLW,100,2196
W20197,2,12/30/2022,QLU6D0QNCC,15,2181
W20197,2,1/1/2023,RA19HXXQTL,100,2081
W20197,2,1/1/2023,RA14HYBWKU,59,2022
W20197,2,1/2/2023,RA26KBZRR6,100,1922
W20197,2,1/2/2023,RA28KC2GF8,50,1872
W20197,2,1/3/2023,RA39MJWFFL,100,1772
W20197,2,1/3/2023,RA31MK0EPP,20,1752
W20197,2,1/4/2023,RA42P5JG1G,87,1665
W20197,2,1/6/2023,RA69U2GFZ1,100,1565
W20197,2,1/6/2023,RA65U3A60B,19,1546
W20197,2,1/11/2023,RAB050Q1PS,450,1096
W20197,2,1/14/2023,RAE2CHL8UE,350,746
W20197,2,1/16/2023,RAG2IKKJTG,750,4
W20197,3,1/20/2023,RAK7T3QCLB,250,3000
W20197,3,1/30/2023,RAU4JOXS1Y,120,2880
W20197,3,2/2/2023,RB21P77VXX,140,2740
W20197,3,2/5/2023,RB51Z6AV7H,360,2380
W20197,3,2/8/2023,RB866E4WXW,220,2160
W20197,3,2/14/2023,RBE1MK3NXF,"2160",0
W20197,4,2/7/2023,RBH3VH6SXN,110,3290
W20197,4,3/17/2023,RCH9ZA3HRR,800,2490
W20197,4,3/28/2023,RCS8TIP1CI,2490,0
W20198,1,11/24/2022,QKO7K3KJMD,"1500",7180
W20198,1,11/27/2022,QKR6SOY24Y,675,6505
W20198,1,11/28/2022,QKS8UZGT8U,400,6105
W20198,1,12/6/2022,QL62IJ5Q86,"6105",0
W20198,2,12/16/2022,QLH8CVT94I2,"2275",6825
W20198,2,12/30/2022,QLU1BD6WX1,"1500",5325
W20198,2,1/3/2023,RA31LYTGMJ,"5325",0
W20198,3,1/17/2023,RAH2JVI7HK,700,7910
W20198,3,1/21/2023,RAL6TX737M,"1600",6310
W20198,3,1/25/2023,RAP65NE5L8,"4250",2060
W20198,3,1/25/2023,RAP065FEI2,2130,70
W20198,4,2/13/2023,RBD2JKRDYY,780,8250
W20198,4,2/17/2023,RBH8TV0C5Q,"1400",6850
W20198,4,2/19/2023,RBK12IM1XP,"2800",4050
W20198,4,2/20/2023,RBK64LPM7M,3900,150
W20198,4,2/21/2023,RBL65CC6OC,80,70
W20198,4,1/25/2023,RAP065FEI22,70,0
W20198,5,3/15/2023,RCF3VDLOGN,"2000",7100
W20198,5,3/18/2023,RCI54UZ8E9,"2000",5100
W20198,5,3/21/2023,RCL3BKPNZT,"5100",0
W20198,6,4/15/2023,RDF9A289CX,"4000",5100
W20198,6,4/18/2023,RDI0GQSGLS,"5100",0
W20198,7,5/16/2023,RDF9A289CX2,"10400",0
W20198,8,6/13/2023,RFD5Y3FEG3,500,10380
W20198,8,6/15/2023,RFF644RE0C,"10000",380
W20198,8,6/15/2023,RFF945QQT9,380,0
W20198,9,7/15/2023,RGF5K46B95,"1300",9580
W20198,9,7/16/2023,RGG7PP4LD9,"3000",6580
W20198,9,7/17/2023,RGH0QLD9ZQ,"6580",0
W20199,1,11/22/2022,QKM6GHVY90,"1000",8100
W20199,1,12/14/2022,QLE75KOFNP2,"8100",0
W20200,1,11/24/2022,QKO1KPV13B,"2600",7240
W20200,1,12/7/2022,QL76L8BLR8,"7240",0
W20200,2,12/17/2022,QLH0DPY7OW,"9860",900
W20200,3,12/29/2022,QLT19VI4O5,"8060",980
W20200,3,12/17/2022,QLH0DPY7OW2,900,80
W20200,3,12/29/2022,QLT7A3HC37,80,0
W20200,4,1/9/2023,RA92193F0E,"2600",6520
W20200,4,1/11/2023,RAB56KGI2N,"6550",30
W20200,5,1/18/2023,RAI4NKENJ0,"11200",0
W20200,6,2/6/2023,RB6630G7S2,"12000",0
W20200,7,3/7/2023,RC768EE6SG,"13000",0
W20200,8,4/4/2023,RD44DR2IB8,"13000",0
W20201,1,11/24/2022,QKO4JN9WVK,"1625",4875
W20201,1,12/1/2022,QL191DW4XV,"1625",3250
W20201,1,12/8/2022,QL87NS18LL,"1625",1625
W20201,1,12/14/2022,QLE277GEDU,"1625",0
W20201,2,12/22/2022,QLL0PTOUP2,"1625",4875
W20201,2,12/29/2022,QLT68SJ0HO,"1625",3250
W20201,2,1/5/2023,RA57PRA41P,"1625",1625
W20201,2,1/12/2023,RAC17O2161,"1625",0
W20201,3,1/18/2023,RAI4ONQVHS,"1625",4875
W20201,3,1/26/2023,RAQ78RWQ4F,"1625",3250
W20201,3,2/2/2023,RB25RPK1Y3,"1625",1625
W20201,3,2/9/2023,RB999C6CMN,"1625",0
W20201,4,2/16/2023,RBG2TMTZQ6,"1625",4875
W20201,4,2/23/2023,RBN0C0BYVM,"1625",3250
W20201,4,3/2/2023,RC22V57C34,"1625",1625
W20201,4,3/9/2023,RC98FGEPRG,"1625",0
W20201,5,4/20/2023,RDK8NQWLYC,"1625",4875
W20201,5,4/27/2023,RDR47GFRPO,"1625",3250
W20201,5,5/4/2023,RE47QRBVGB,"1625",1625
W20201,5,5/11/2023,REB39NSOA9,"1625",0
W20201,6,5/18/2023,REI9VAZ9YP,"1625",4875
W20201,6,5/25/2023,REP9FDQLH7,"1625",3250
W20201,6,6/1/2023,RF15YFG2RV,"1625",1625
W20201,6,6/8/2023,RF82JDFAKU,"1625",0
W20201,7,6/15/2023,RFF64YQO0S,"1625",4875
W20201,7,6/22/2023,RFM9PDB46Z,"1625",3250
W20201,7,6/29/2023,RFT4ADNXFA,"1625",1625
W20201,7,7/3/2023,RG34K8VL22,"1625",0
W20201,8,7/10/2023,RGA585YTLD,"1625",4875
W20201,8,7/17/2023,RGH6RUF7YS,"1625",3250
W20201,8,7/26/2023,RGQ1GC6ZJD,"1625",1625
W20201,8,7/24/2023,RGO7C3JPAN,"1625",0
W20201,9,8/2/2023,RH2637W432,"1625",4875
W20201,9,8/9/2023,RH97OT9019,"1625",3250
W20202,1,11/18/2022,QKI37WNC7R,174,4894
W20202,1,11/19/2022,QKJ8A4O1XQ,174,4720
W20202,1,11/20/2022,QKK8CA2CN4,174,4546
W20202,1,11/21/2022,QKL5EJTO4Z,174,4372
W20202,1,11/22/2022,QKM5GZ6E2R,174,4198
W20202,1,11/23/2022,QKN5JA0L1T,174,4024
W20202,1,11/24/2022,QKO0LJMCVU,174,3850
W20202,1,11/25/2022,QKP3O18ZAP,174,3676
W20202,1,11/26/2022,QKQ8QIGFSK,174,3502
W20202,1,11/27/2022,QKR3SOAV0F,174,3328
W20202,1,11/28/2022,QKS0V58SV2,174,3154
W20202,1,11/29/2022,QKT5XCKXMP,174,2980
W20202,1,11/30/2022,QKU7ZU05E3,174,2806
W20202,1,12/1/2022,QL103VK330,174,2632
W20202,1,12/2/2022,QL22761O2M,174,2458
W20202,1,12/3/2022,QL38AOVK08,174,2284
W20202,1,12/4/2022,QL44DZIXGY,174,2110
W20202,1,12/5/2022,QL58EYA47E,2110,0
W20202,2,12/7/2022,QL78MPP95M,174,4546
W20202,2,12/8/2022,QL86Q21ZIO,174,4372
W20202,2,12/10/2022,QLA3T46WI9,174,4198
W20202,2,12/10/2022,QLA4VLLXMQ,174,4024
W20202,2,12/11/2022,QLB3Y2UADJ2,174,3850
W20202,2,12/12/2022,QLC41M83M8,174,3676
W20202,2,12/14/2022,QLE074QHBA,174,3502
W20202,2,12/15/2022,QLF79U6GQF,174,3328
W20202,2,12/16/2022,QLG8CJ99TA,174,3154
W20202,2,12/18/2022,QLI3G6WKBN,174,2980
W20202,2,12/18/2022,QLI0HRIHDI,174,2806
W20202,2,12/19/2022,QLJ6KDPY7C,174,2632
W20202,2,12/20/2022,QLK1N1IXQZ,174,2458
W20202,2,12/21/2022,QLL7PRCQU7,174,2284
W20202,2,12/22/2022,QLM2QAWH3E,"2284",0
W20202,3,12/23/2022,QLN9VBJZ3P,174,4866
W20202,3,12/25/2022,QLP21B26H0,174,4692
W20202,3,12/26/2022,QLQ13VLZN3,174,4518
W20202,3,12/31/2022,QLV7FXQQ25,174,4344
W20202,3,1/1/2023,RA19I7BIE1,174,4170
W20202,3,1/2/2023,RA27K9ZRKL,174,3996
W20202,3,1/4/2023,RA49P9V7RF,174,3822
W20202,3,1/6/2023,RA65UBATJB,174,3648
W20202,3,1/7/2023,RA74URIOUA,174,3474
W20202,3,1/8/2023,RA80Z0KEYM,174,3300
W20202,3,1/10/2023,RAA93M6TTZ,174,3126
W20202,3,1/10/2023,RAA74X10C7,174,2952
W20202,3,1/11/2023,RAB87914FW,174,2778
W20202,3,1/13/2023,RAD3CB35HF,174,2604
W20202,3,1/16/2023,RAG4IAK5JC,"2400",204
W20202,3,1/16/2023,RAG8IAPQ5O,204,0
W20202,4,1/17/2023,RAH0LZXCMM,239,6856
W20202,4,1/20/2023,RAK8TQJ74S,238,6618
W20202,4,1/24/2023,RAO04RVF1M,239,6379
W20202,4,1/29/2023,RAT8GZ14G6,239,6140
W20202,4,1/31/2023,RAV4MFZ3T0,239,5901
W20202,4,2/11/2023,RBB7GOQJ93,500,5401
W20202,4,2/13/2023,RBD8L0Q1E6,"5000",401
W20202,4,2/13/2023,RBD0L0Y71C,401,0
W20202,5,2/15/2023,RBF7QZXTLD,239,6911
W20202,5,2/16/2023,RBG2TM2IA6,239,6672
W20202,5,2/19/2023,RBJ820EGM4,239,6433
W20202,5,3/14/2023,RCE0R65VB0,"6433",0
W20202,6,3/15/2023,RCF8VKQ7MM,239,6261
W20202,6,3/16/2023,RCG2Y9PIKG,239,6022
W20202,6,3/18/2023,RCI64UNNGU,239,5783
W20202,6,3/25/2023,RCP5N0MCCL,239,5544
W20202,6,3/26/2023,RCQ0PH4FZY,239,5305
W20202,6,4/12/2023,RDC8ZQD12G,5000,305
W20202,6,4/12/2023,RDC3ZQJ84B,305,0
W20202,7,5/3/2023,RE36NPOZW2,717,6433
W20202,7,5/11/2023,REB3AEXPSX,"6000",433
W20202,7,5/11/2023,REB5AFCA35,433,0
W20202,8,5/12/2023,REC8ETG1MG,239,6911
W20202,8,5/14/2023,REE5KDMGOP,239,6672
W20202,8,6/9/2023,RF97M6OKXR,"6672",0
W20202,9,6/10/2023,RFA8R0D95O,288,8552
W20202,9,6/11/2023,RFB7TP4BMV,288,8264
W20202,9,6/13/2023,RFD7ZEM4YX,288,7976
W20202,9,7/10/2023,RGA067MMU8,"7000",976
W20202,9,7/10/2023,RGA96A88ST,980,4
W20202,10,8/9/2023,RH96NXBCDO,"3450",5000
W20202,10,8/9/2023,RH94NP8UMG,"5000",0
W20203,1,12/16/2022,QLG2ATPFIA,"12900",0
W20203,2,1/13/2023,RAD7BNBKLV,"12900",100
W20203,3,2/7/2023,RB775643T5,"12600",0
W20204,1,11/25/2022,QKP2NKS4YS,"1625",4175
W20204,1,12/2/2022,QL2868MUVG,"4175",0
W20204,2,12/13/2022,,"5600",0
W20204,3,12/27/2022,QLR561E90Z,600,5000
W20204,3,12/27/2022,QLR761HRFL,"5000",0
W20204,4,1/27/2023,RAR4BCJ7KK,"2000",4500
W20204,4,2/7/2023,RB735YHKHZ,"4500",0
W20204,5,5/17/2023,REH0RLP56Q,"6500",0
W20204,6,6/15/2023,RFF163S1UD,"6500",0
W20204,7,7/23/3023,RGN3A1UQVF,"6500",0
W20205,1,11/26/2022,QKQ8PJEQOU,650,6150
W20205,1,11/26/2022,QKQ7QLLS1Z,500,5650
W20205,1,11/28/2022,QKS6URLOIQ,200,5450
W20205,1,12/1/2022,QL1522HD9H,400,5050
W20205,1,12/3/2022,QL30APLXJ22,400,4650
W20205,1,12/5/2022,QL55GTV6H1,250,4400
W20205,1,12/7/2022,QL72MVXAVK,400,4000
W20205,1,12/9/2022,QL90SA89UU,500,3500
W20205,1,12/12/2022,QLC01HF72I,700,2800
W20205,1,12/15/2022,QLF29GPEK8,600,2200
W20205,1,12/16/2022,QLG0CN6360,700,1500
W20205,1,12/21/2022,QLK0MURG8C,400,1100
W20205,1,12/22/2022,QLM8RZSE40,300,800
W20205,1,12/23/2022,QLN7SXA7BN,800,0
W20205,2,1/6/2023,RA69U89I3L,800,5550
W20205,2,1/9/2022,",RA96ZL1JZ0",400,5150
W20205,2,1/9/2023,RA982AKI8U,300,4850
W20205,2,1/11/2023,RAB5765EFN,350,4500
W20205,2,1/12/2023,RAC89FU95A,600,3900
W20205,2,1/13/2023,RAD0C1P5XY,300,3600
W20205,2,1/17/2023,RAH9JR2U1P,500,3100
W20205,2,1/17/2023,RAH4KF7YYY,"3100",0
W20205,3,2/1/2023,RB10OY8IEM,"1000",5350
W20205,3,2/6/2023,RB61393TBB,500,4850
W20205,3,2/8/2023,RB868KOROI,500,4350
W20205,3,2/11/2023,RBB5EIZW3D,"4250",100
W20205,3,2/11/2023,RBB4F0Y5MI,100,0
W20205,4,3/13/2023,RCD2OY4DZW,"2000",4800
W20205,4,3/13/2023,RCD7PAZ1LF,"4800",0
W20205,5,3/23/2023,RCN3G3AYIH,"5600",0
W20205,6,4/20/2023,RDK2LQYKHE,"9100",0
W20205,7,5/18/2023,REI0TI9YRS,"9000",100
W20205,7,5/18/2023,REI5TZIEIB,100,0
W20205,8,6/15/2023,RFF93WFMST,"13000",0
W20205,9,7/12/2023,RGC9D56ICF,"1500",13100
W20205,9,7/14/2023,RGE2HNGCB8,700,12400
W20205,9,7/17/2023,RGH1S96Y7H,500,11900
W20205,9,7/18/2023,RGI1VF727J,500,11400
W20205,9,7/19/2023,RGJ5XQLJQ5,500,10900
W20205,9,7/28/2023,RGS2OALN7M,500,10400
W20205,9,7/31/2023,RGV2WUR184,500,9900
W20205,9,8/3/2023,RH374QDMTN,200,9700
W20205,9,8/5/2023,RH55CU3P9B,300,9400
W20205,9,8/10/2023,RHA6R2QBYG,9400,0
W20206,1,12/15/2022,QLF5826QHL,"2000",5900
W20206,1,12/17/2022,QLH7DJFUPP,300,5600
W20206,1,12/24/2022,QLO8W8WD4O,"2400",3200
W20206,1,2/4/2023,RB44X5JZ7U,300,2900
W20207,1,1/13/2023,RAD8AZW8WQ,160,7740
W20207,1,1/23/2023,RAN1ZX1BLF,100,7640
W20207,1,1/23/2023,RAN0ZX6AHO,50,7590
W20207,1,2/3/2023,RB38SNWXW0,50,7540
W20208,1,12/20/2022,QLK0LCPDUY,"12800",0
W20208,2,1/20/2023,RAK1RE3JLH,"13600",0
W20208,3,2/16/2023,RBG9S8C4R5,"12800",0
W20209,1,12/22/2022,QLM6Q8L3PI,"12800",0
W20209,2,1/20/2022,RAK7SMXF63,"13000",0
W20209,3,2/16/2023,RBG5RWRO0P,"12800",0
W20210,1,12/15/2022,QLF67UQE5O,"12000",0
W20210,2,1/6/2023,RA66T29S1C,"7500",5500
W20210,2,1/13/2022,RAD1ANW4QV,"5500",0
W20210,3,2/7/2023,RB704OCROO,"2800",10000
W20210,3,2/8/2023,RB817IY0SJ,"3500",6500
W20210,3,2/9/2023,RB929RC34W,"6500",0
W20211,1,12/3/2022,QL338ULVWV,"2275",6825
W20211,1,12/21/2022,QLL4NFUN2G,"2300",4525
W20211,1,12/24/2022,QLO7VTWTCT2,"4525",0
W20211,2,1/20/2023,RAK5T8H4TD,"2000",7100
W20211,2,1/21/2022,RAL3UTXOEN,"7100",0
W20211,3,2/14/2023,RBE6N7JD4K,"8820",0
W20211,4,3/15/2023,RCF9TRQ08T,"9520",0
W20211,5,4/18/2023,RDI6GWC0GK,550,8970
W20211,5,4/21/2023,RDL7P98F0P,"8970",0
W20211,6,5/29/2023,RET1PJSQY9,300,9220
W20211,6,6/3/2023,RF31534X8N,"9220",0
W20212,1,12/1/2022,QL1140TRZ1,434,6966
W20212,1,12/7/2022,QL72MXB6AA,434,6532
W20212,1,12/9/2022,QL93T0MGBP,434,6098
W20212,1,12/17/2022,QLH4D7SBOG,600,5498
W20212,1,12/28/2022,QLS67H4S6Y,1000,4498
W20212,1,12/30/2022,QLU5B15UWB,500,3998
W20212,1,1/6/2023,RA62S0IBMI,1500,2498
W20212,1,1/9/2023,RA981F2LVS,2498,0
W20212,2,1/11/2023,RAB75DD3UN,434,6066
W20212,2,1/13/2023,RAD4CE31JK,434,5632
W20212,2,1/20/2023,RAK3RN0Y09,400,5232
W20212,2,1/24/2023,RAO93A48OZ,400,4832
W20212,2,2/1/2023,RB10O4OZDA,400,4432
W20212,2,2/2/2023,RB29RQQBZ9,400,4032
W20212,2,2/7/2023,RB724SJZLK,"4032",0
W20212,3,2/14/2023,RBE5OF360R,400,5750
W20212,3,2/27/2023,RBR3L3RQ7T,"5750",0
W20212,4,3/30/2023,RCU6ZCLR2E,"6800",0
W20212,5,4/25/2023,RDP1ZL8X9F,"6350",0
W20212,6,5/24/2023,REO6BTS3PA,"6800",0
W20213,1,12/2/2022,QL22784X82,152,4398
W20213,1,12/4/2022,QL48DRLMOG,302,4096
W20213,1,12/7/2022,QL77N364LP,152,3944
W20213,1,12/7/2022,QL78N3AAMK,152,3792
W20213,1,12/9/2022,QL93T149T1,304,3488
W20213,1,12/13/2022,QLD93VXUPR,500,2988
W20213,1,12/21/2022,QLL0OIHQIC,302,2686
W20213,1,12/22/2022,QLM1RQI2H1,302,2384
W20213,1,12/23/2022,QLN3V7P4Z1,302,2082
W20213,1,12/27/2022,QLR443M2DA,302,1780
W20213,1,12/28/2022,QLS28AMXX6,1500,280
W20213,1,12/29/2022,QLT795UNMD,250,30
W20213,1,12/29/2022,QLT396HLUZ,30,0
W20213,2,1/17/2023,RAH7LZPHA9,500,3945
W20213,2,1/20/2023,RAK1RF3N2B,650,3295
W20213,2,1/24/2023,RAO8408U6U,"3295",0
W20213,3,2/22/2023,RBM189V1AR,"4550",0
W20213,4,3/24/2023,RCO0IOMXEE,"4560",200
W20214,1,12/14/2022,QLE55R1R73,"2000",5740
W20214,1,12/22/2022,QLM7PUNVFN,"1900",3840
W20214,1,12/26/2022,QLQ8325WM4,"2000",1840
W20214,1,12/30/2022,QLU2C3LDR6,"1850",10
W20214,2,1/9/2023,RA90ZXX7RK,"1300",7460
W20214,2,1/9/2023,RA902D6DLK,700,6760
W20214,2,1/17/2023,RAH0L2Z2EG,"2000",4760
W20214,2,3/19/2023,RCJ94YH5OF,600,4160
W20215,1,1/4/2023,RA45N4UTEZ,"13000",0
W20215,2,2/3/2023,RB36U9TYE0,"13400",200
W20215,2,2/4/2023,RB48V2MZG2,200,0
W20215,3,3/6/2023,RC675YGRKP,"13000",600
W20215,3,3/6/2023,RC6463DCQ,600,0
W20216,1,12/13/2022,QLD34FJKWD,500,11740
W20216,1,12/15/2022,QLF684E03C,"2300",9440
W20216,1,12/30/2022,QLU5BYIOHV,"1100",8340
W20216,1,1/5/2023,RA56QJRDI8,"1000",7340
W20216,1,1/13/2023,RAD7BFM9CD,400,6940
W20216,1,1/16/2023,RAG3HLRSJ1,500,6440
W20216,1,1/25/2023,RAP65839M4,500,5940
W20217,1,12/14/2022,QLE15S0JSB,"3250",9750
W20217,1,12/21/2022,QLL7OTTBTF,"3250",6500
W20217,1,12/29/2022,QLT88XMOJ2,"3250",3250
W20217,1,1/5/2023,RA54PTVLP8,"3250",0
W20217,2,31/01/2023,RAV7K416GF,"1625",4875
W20217,2,2/7/2023,RB724NW79W,"1625",3250
W20217,2,2/15/2023,RBF2PJUZJ4,"1625",1625
W20217,2,2/20/2023,RBK82ZF1NM,"1625",0
W20217,3,3/2/2023,RC25T1HNU5,"1950",6210
W20217,3,3/20/2023,RCA5HK9FMR,"1950",4260
W20217,3,3/20/2023,RCK79437LD,"2000",2260
W20217,3,3/27/2023,RCR4QGV44I,"1000",1260
W20217,3,3/28/2023,RCS0TGOPTM,"1050",210
W20217,3,3/28/2023,PENALTIES W/OFF,210,0
W20218,1,12/10/2022,QLA9VQFOYT,260,7540
W20218,1,12/11/2022,QLB6Y19MJG,260,7280
W20218,1,12/12/2022,QLC81TDIWA,260,7020
W20218,1,12/13/2022,QLD34IO3H7,260,6760
W20218,1,12/14/2022,QLE277BAW0,260,6500
W20218,1,12/15/2022,QLF49VI5W4,260,6240
W20218,1,12/16/2022,QLG2CP1Q5S,260,5980
W20218,1,12/18/2022,QLI1HKXE2F,260,5720
W20218,1,12/18/2022,QLI8FFT8DS,260,5460
W20218,1,12/20/2022,QLJ9KGGUNJ,260,5200
W20218,1,12/20/2022,QLK6N2BPBO,260,4940
W20218,1,12/21/2022,QLL5PTLB8L,260,4680
W20218,1,12/22/2022,QLM3SIQJBV,260,4420
W20218,1,12/24/2022,QLO1VETOUN,260,4160
W20218,1,12/25/2022,QLP5YDWJC5,260,3900
W20218,1,12/26/2022,QLQ62RI194,520,3380
W20218,1,12/28/2022,QLS76YD9BJ,520,2860
W20218,1,12/30/2022,QLU1B1F9OB,560,2300
W20218,1,12/31/2022,QLV7FYJZIL,260,2040
W20218,1,1/2/2023,RA29KGVWOV,520,1520
W20218,1,1/5/2023,RA68RTVHCW,520,1000
W20218,1,1/7/2023,RA76VNQXLC,1000,0
W20218,2,1/14/2023,RAE8DTIRUQ,"1950",5430
W20218,2,1/19/2023,RAJ4R5RN5C,"2000",3430
W20218,2,1/28/2023,RAS4D53WHO,"3430",0
W20218,3,2/4/2023,RB42X983UE,"1950",5190
W20218,3,2/11/2023,RBB9GMZTRZ,"1950",3240
W20218,3,2/14/2023,RBF9PS6XZH3,"3240",0
W20218,4,3/16/2023,RCG3Y9K5UZ,"5200",240
W20218,4,3/18/2023,RCI22URJLS,240,0
W20219,1,12/16/2022,QLG8CMWC2S,"1650",11350
W20219,1,12/22/2022,QLM8SEUVJ6,"1000",10350
W20219,1,12/30/2022,QLU1BD6WX12,"1000",9350
W20219,1,1/4/2023,RA46OYMT0C,400,8950
W20219,1,1/6/2023,RA69TN1187,9000,50
W20219,2,1/16/2023,RAG3HM3ABF,"1000",9320
W20219,2,1/24/2023,RAO62V5U8U,"1000",8320
W20219,2,2/2/2023,RB26PO3MY8,"8320",0
W20219,3,2/15/2023,RBF4PCNW02,"1000",12000
W20219,3,2/17/2023,RBH0U45O8O,500,11500
W20219,3,2/19/2023,RBK22H6VQA,500,11000
W20219,3,2/22/2023,RBM47NZ4KA,"3000",8000
W20219,3,2/26/2023,RBQ5K61CW9,500,7500
W20219,3,3/1/2023,RC10SA90O4,"2000",5500
W20219,3,3/3/2023,RC35VOYEV1,"2000",3500
W20219,3,3/8/2023,RC84AAFDK6,"3000",500
W20219,3,2/22/3033,RBM47X1IAA,500,0
W20219,4,4/8/2023,RD81O7AYKL,"13600",0
W20220,1,12/21/2022,QLL4PIGN70,200,5650
W20220,1,12/22/2022,QLM3SGQWT7,200,5450
W20220,1,12/24/2022,QLO0VLPEZ4,250,5200
W20220,1,12/24/2022,QLO8XQ6NDM,200,5000
W20220,1,12/25/2022,QLP01BA6TS,200,4800
W20220,1,12/26/2022,QLQ03MO3Z8,200,4600
W20220,1,12/28/2022,QLS064TY34,200,4400
W20220,1,12/29/2022,QLT4A0YJHE,200,4200
W20220,1,12/31/2022,QLV8EVJODC,200,4000
W20220,1,1/8/2023,RA81YUJHTH,2000,2000
W20220,1,1/10/2023,RAA73TB1AN,250,1750
W20220,1,1/11/2023,RAB77026H5,250,1500
W20220,1,1/12/2023,RAC99PLAX1,250,1250
W20220,1,1/14/2023,RAE0DN8UTM,250,1000
W20220,1,1/16/2023,RAG0JII2RQ,300,700
W20220,1,1/18/2023,RAI8N12AL6,700,0
W20220,2,1/30/2023,RAU9JPO9N9,350,5800
W20220,2,2/1/2023,RB16MMVZ4W,500,5300
W20220,2,2/1/2023,RB15P4WJ73,350,4950
W20220,2,2/3/2023,RB39U92F3Z,300,4650
W20220,2,2/4/2023,RB41X1GCVN,250,4400
W20220,2,2/6/2023,RB6638S5UW,300,4100
W20220,2,2/8/2023,RB8069VELY,300,3800
W20220,2,2/10/2023,RBA1DV5PM5,300,3500
W20220,2,2/14/2023,RBE8O7T4AY,2200,1300
W20220,2,2/15/2023,RBF3QX6L4N,500,800
W20220,2,2/16/2023,RBG7S316AT,500,300
W20220,3,2/28/2023,RBS6PONH4S,2,7108
W20220,3,2/28/2023,RBS6POQOOS,300,6808
W20220,3,3/3/2023,RC33XWPE63,400,6408
W20220,3,3/18/2023,RCI52WL72B,3000,3408
W20221,1,1/19/2023,,"13000",0
W20221,2,2/15/2023,RBF0QYRI78,"12500",0
W20221,3,3/16/2023,RCG2Y5LQXI,"12900",0
W20222,1,2/5/2023,RB50ZBTX52,"5000",8600
W20222,1,2/6/2023,RB67382329,"2000",6600
W20222,1,2/7/2023,RB794O0SM1,"2000",4600
W20222,1,2/8/2023,RB847632ZQ,"2000",2600
W20222,1,2/9/2023,RB91ABVFQ3,2600,0
W20222,2,3/11/2023,RCB9JI9J3V,"3000",10800
W20222,2,3/13/2023,RCD9P0M4Q7,"4000",6800
W20222,2,3/15/2023,RCF5U8HU7N,6800,0
W20222,3,4/11/2023,RDB4VTNP1U,"12700",0
W20222,4,6/6/2023,REC2CV51SA,"16900",0
W20222,5,7/8/2023,RG83ZI7477,"17680",0
W20222,6,8/9/2023,RH93MY9Y3L,"5000",12680
W20222,6,8/10/2023,RHA6QVSKQK,"12680",0
W20223,1,1/16/2023,RAG6IS9BN2,"1300",3900
W20223,1,1/27/2023,RAR4AADG6Y,400,3500
W20223,1,2/2/2023,RB20PQL5PS,400,3100
W20223,1,2/6/2023,RB631RGEIH,"3100",0
W20224,1,2/11/2023,RBB3EH3QP3,"5000",8600
W20224,1,2/14/2023,RBE0M1NHJ8,"5000",3600
W20224,1,2/14/2023,RBE9M78AHF,"3000",600
W20225,1,1/27/2023,RAR8A8L5XQ,500,6300
W20225,1,1/28/2023,RAS6CYZOGU,500,5800
W20225,1,2/2/2023,RB28PKKYH2,200,5600
W20225,1,2/2/2023,RB26QWSY56,425,5175
W20225,1,2/21/2023,RBL45IS4R2,5175,0
W20226,1,2/16/2023,RBG9S814XF,"9760",0
W20226,2,3/16/2023,RCG7WUTQWD,"10400",0
W20226,3,4/13/2023,RDD931M3RN,"10320",0
W20226,4,5/12/2023,REC8CR0XNI,"13000",0
W20226,5,6/10/2023,RFA2PODKUU,"13000",0
W20226,6,7/10/2023,RGA68B1ARE,"13600",0
W20227,1,2/1/2023,RB17P5GZ9H,130,3770
W20227,1,2/2/2023,RB27RCWX0N,130,3640
W20227,1,2/3/2023,RB34U96YBE,130,3510
W20227,1,2/4/2023,RB46X6C7P8,130,3380
W20227,1,2/5/2023,RB55ZJPLEL,130,3250
W20227,1,2/6/2023,RB6331AP5J,130,3120
W20227,1,2/7/2023,RB7162B5BL,130,2990
W20227,1,2/8/2023,RB818I8WBT,130,2860
W20227,1,2/9/2023,RB90ARHQBO,130,2730
W20227,1,2/10/2023,RBA9DM7JRL,130,2600
W20227,1,2/11/2023,RBB4GIN1X8,130,2470
W20227,1,2/12/2023,RBC0IX6NDM,100,2370
W20227,1,2/12/2023,RBC2IX9RT6,30,2340
W20227,1,2/14/2023,RBE8OC25MS,130,2210
W20227,1,2/15/2023,RBF7QBCTZJ,130,2080
W20227,1,2/17/2023,RBH0TY8W7U2,100,1980
W20227,1,2/17/2023,RBH6TYEPRW,60,1920
W20227,1,2/17/2023,RBH0TYM1AE,100,1820
W20227,1,2/18/2023,RBI4YS1I6M,130,1690
W20227,1,2/21/2023,RBL75369BD,100,1590
W20227,1,2/21/2023,RBL1539L85,30,1560
W20227,1,2/24/2023,RBO2DVCDLM,100,1460
W20227,1,2/24/2023,RBO6DVIJDW,30,1430
W20227,1,2/25/2023,RBP0HCW810,100,1330
W20227,1,2/25/2023,RBP1HD0UQP,30,1300
W20227,1,2/26/2023,RBQ6K8HF7Y,100,1200
W20227,1,2/26/2023,RBQ2K8VWFG,30,1170
W20227,1,2/27/2023,RBR7MJMR2Z,100,1070
W20227,1,2/27/2023,RBR8MJZMX2,30,1040
W20227,1,2/28/2023,RBS9PKEDST,100,940
W20227,1,2/28/2023,RBS6PKVMMQ,30,910
W20227,1,3/1/2023,RC14RNHLNI,100,810
W20227,1,3/1/2023,RC12RNRX7A,100,710
W20227,1,3/1/2023,RC13SFN6BZ,100,610
W20227,1,3/1/2023,RC17SFKCHF,100,510
W20227,1,3/1/2023,RC14SFG1E0,100,410
W20227,1,3/1/2023,RC14SFDROW,100,310
W20227,1,3/1/2023,RC12SFB1QQ,100,210
W20227,1,3/1/2023,RC15SF8RFH,100,110
W20227,1,3/1/2023,RC15SEZWUL,100,10
W20227,1,3/2/2023,RC29SQ9R09,10,0
W20227,2,3/8/2023,RC86AR46H2,100,3800
W20227,2,3/8/2023,RC88C46FU6,100,3700
W20227,2,3/10/2023,RCA9HY4B7B,100,3600
W20227,2,3/13/2023,RCD3PEBZ1R,100,3500
W20227,2,3/14/2023,RCE8SWTOT6,100,3400
W20227,2,3/22/2023,RCM0ETMVAE,100,3300
W20227,2,3/22/2023,RCM3ETW2ZB,30,3270
W20227,2,3/23/2023,RCN5HIDVID,100,3170
W20227,2,3/23/2023,RCN6HIHPKO,30,3140
W20227,2,3/24/2023,RCO7K74HQX,130,3010
W20227,2,3/29/2023,RCT2VXS7XU,1000,2010
W20227,2,3/31/2023,RCV81M1HOS,1000,1010
W20227,2,3/31/2023,RCV920NC8J,1000,10
W20227,2,3/31/2023,RCV220SBG0,10,0
W20227,3,4/11/2023,RDB1VLTENN,"3000",360
W20227,3,4/11/2023,RDB9VXL7M5,360,0
W20227,4,5/10/2023,REA274BXUW,"3900",0
W20227,5,5/15/2023,REF3MWM7TV,50,3850
W20227,5,6/7/2023,RF78FSFPFA,"3850",0
W20227,6,7/5/2023,RG58QT46ZS,"4000",1200
W20227,6,7/6/2023,RG62UHPW1C,830,370
W20227,6,7/6/2023,RG63UHW5RR,50,320
W20227,6,7/6/2023,RG66VURN32,320,0
W20227,7,8/8/2023,RH89KIIAWL,"5440",0
W20228,1,2/14/2023,RBE4LVD3JW2,"1500",13100
W20228,1,2/15/2023,RBF4OGI4K2,"1150",11950
W20228,1,2/20/2023,RBK4459JNY,"1000",10950
W20228,1,2/21/2023,RBL77GDMBX,700,10250
W20228,1,2/25/2023,RBP9F9MC1F,500,9750
W20228,1,2/26/2023,RBQ5KFCZXP,500,9250
W20228,1,3/3/2023,RC30Y3PT36,800,8450
W20228,1,3/6/2023,RC694JUYZR,390,8060
W20228,1,3/4/2023,RC451X2V0D,600,7460
W20228,1,3/7/2023,RC727CN1JU,400,7060
W20228,1,3/10/2023,RCA6FLNJ62,500,6560
W20228,1,3/10/2023,RCA6I8BWSO,200,6360
W20228,1,3/12/2023,RCC5NL1W6R,400,5960
W20228,1,3/14/2023,RCE0SWYK1U,300,5660
W20228,1,3/16/2023,RCG5VN59YN,200,5460
W20228,1,3/23/2023,RCN5HSUZZZ,100,5360
W20229,1,2/3/2023,RB34UG003K,250,6250
W20229,1,2/4/2023,RB41X6ZM05,250,6000
W20229,1,2/5/2023,RB52ZOQ2H8,200,5800
W20229,1,2/6/2023,RB613CROE1,217,5583
W20229,1,2/7/2023,RB71633CTD,217,5366
W20229,1,2/8/2023,RB828QLWUK,217,5149
W20229,1,2/10/2023,RBA4BRXFNA2,217,4932
W20229,1,2/10/2023,RBA2E1XQB2,217,4715
W20229,1,2/11/2023,RBB8GPVUX8,217,4498
W20229,1,2/12/2023,RBC2IK410O,217,4281
W20229,1,2/13/2023,RBD2LPZ6NW,217,4064
W20229,1,2/14/2023,RBE8ODBU28,217,3847
W20229,1,2/15/2023,RBF2QZNKHQ,217,3630
W20229,1,2/17/2023,RBH3W7UD9H,217,3413
W20229,1,2/18/2023,RBI9YVMENF,217,3196
W20229,1,2/19/2023,RBJ71VU6U9,217,2979
W20229,1,2/20/2023,RBK24TSHFE,100,2879
W20229,1,2/20/2023,RBK84TULMM,117,2762
W20229,1,2/21/2023,RBL87EBR22,217,2545
W20229,1,2/22/2023,RBM29W6W9E,100,2445
W20229,1,2/22/2023,RBM89WAWEQ,117,2328
W20229,1,2/23/2023,RBN2CEXXVY,100,2228
W20229,1,2/23/2023,RBN2CF3KMU,117,2111
W20229,1,2/24/2023,RBO9F5SLDH,100,2011
W20229,1,2/24/2023,RBO9F5X11T,17,1994
W20229,1,2/24/2023,RBO5F69YOH,100,1894
W20229,1,2/25/2023,RBP8HXYS2O,100,1794
W20229,1,2/25/2023,RBP7HY3IE1,100,1694
W20229,1,2/25/2023,RBP7HY6C5D,17,1677
W20229,1,2/26/2023,RBQ4K901M2,100,1577
W20229,1,2/26/2023,RBQ8K95ELO,117,1460
W20229,1,2/27/2023,RBR4N0GJOC,100,1360
W20229,1,2/27/2023,RBR0N0IV6C,117,1243
W20229,1,2/28/2023,RBS2PPVTA2,100,1143
W20229,1,2/28/2023,RBS1PPWMLV,117,1026
W20229,1,3/1/2023,RC12SFEDM0,100,926
W20229,1,3/1/2023,RC14SFGU46,117,809
W20229,1,3/2/2023,RC20V68TVA,100,709
W20229,1,3/2/2023,RC25V6DGL3,117,592
W20229,1,3/3/2023,RC37WJ1S6L,592,0
W20229,2,3/4/2023,RC471XJOAZ,100,6400
W20229,2,3/4/2023,RC441XL6CG,117,6283
W20229,2,3/5/2023,RC573L9RO3,217,6066
W20229,2,3/6/2023,RC6278V48O,100,5966
W20229,2,3/6/2023,RC6278YIFU2,117,5849
W20229,2,3/8/2023,RC88CMR6TC,100,5749
W20229,2,3/8/2023,RC88CMV760,117,5632
W20229,2,3/13/2023,RCD4Q7OHJ6,100,5532
W20229,2,3/13/2023,RCD6Q7R86M,117,5415
W20229,2,3/13/2023,RCD9Q7T4F3,100,5315
W20229,2,3/13/2023,RCD9Q7URBX,117,5198
W20229,2,3/14/2023,RCE8SOOF5W,200,4998
W20229,2,3/15/2023,RCF7VHJLVN,234,4764
W20229,2,3/16/2023,RCG1Y9Q4PN,100,4664
W20229,2,3/16/2023,RCG2Y9UDZG,117,4547
W20229,2,3/17/2023,RCH321PR9T,100,4447
W20229,2,3/17/2023,RCH221TRLW,117,4330
W20229,2,3/20/2023,RCK89RNX9W,434,3896
W20229,2,3/21/2023,RCL2CIQL7S,100,3796
W20229,2,3/21/2023,RCL5CIS30J,117,3679
W20229,2,3/22/2023,RCM7F4ZZWB,217,3462
W20229,2,3/24/2023,RCO6KGXKLQ,100,3362
W20229,2,3/24/2023,RCO5KGZOXR,117,3245
W20229,2,3/26/2023,RCQ8PGLQJ6,100,3145
W20229,2,3/26/2023,RCQ7PGO8NL,100,3045
W20229,2,3/26/2023,RCQ7PGQWPD,17,3028
W20229,2,3/27/2023,RCR2S0IFVU,117,2911
W20229,2,3/27/2023,RCR3S0LINX,117,2794
W20229,2,3/27/2023,RCR1S0OFW7,100,2694
W20229,2,3/27/2023,RCR4S0QG8G,100,2594
W20229,2,3/28/2023,RCS4UPA12Q,100,2494
W20229,2,3/28/2023,RCS6UPDANK,117,2377
W20229,2,3/29/2023,RCT2XC6TUW,100,2277
W20229,2,3/29/2023,RCT1XC9EG7,117,2160
W20229,2,3/30/2023,RCU7ZWVB7V,900,1260
W20229,2,3/31/2023,RCV03UUGYW,100,1160
W20229,2,3/31/2023,RCV43UXO4K,117,1043
W20229,2,4/1/2023,RD1557BLXX,1043,0
W20229,3,4/4/2023 21:59:55,RD41EWDLRT,17,6483
W20229,3,4/4/2023 21:58:54,RD42EWAUY2,100,6383
W20229,3,4/4/2023 21:55:53,RD46EW20C6,100,6283
W20229,3,5/4/2023 21:57:44,RD55HRN0W1,17,6266
W20229,3,5/4/2023 21:56:12,RD51HRJ8CX,100,6166
W20229,3,5/4/2023 21:54:31,RD50HREDWW,100,6066
W20229,3,6/4/2023 22:19:43,RD63KPHLPP,100,5966
W20229,3,6/4/2023 22:18:24,RD60KPEH9K,17,5949
W20229,3,6/4/2023 22:16:37,RD65KPAPA5,100,5849
W20229,3,7/4/2023 22:02:01,RD76NHJGIS,100,5749
W20229,3,7/4/2023 22:01:01,RD70NHH39Q,100,5649
W20229,3,8/4/2023 22:00:08,RD82Q8I0B4,17,5632
W20229,3,8/4/2023 21:58:36,RD86Q8EQLG,100,5532
W20229,3,8/4/2023 21:57:07,RD85Q8B39N,100,5432
W20229,3,9/4/2023 22:21:14,RD96SQS4R8,100,5332
W20229,3,9/4/2023 22:18:42,RD95SQN5XF,100,5232
W20229,3,10/4/2023 22:29:26,RDA5VD1GYZ,17,5215
W20229,3,10/4/2023 22:28:09,RDA9VCZ0FV,100,5115
W20229,3,10/4/2023 22:17:50,RDA8VCGJ14,100,5015
W20229,3,11/4/2023 22:09:17,RDB0Y28KW4,17,4998
W20229,3,11/4/2023 22:07:47,RDB9Y24U1X,100,4898
W20229,3,11/4/2023 22:06:46,RDB6Y22Z12,100,4798
W20229,3,12/4/2023 22:32:13,RDC71SIABJ,17,4781
W20229,3,12/4/2023 22:31:27,RDC61SHMKS,100,4681
W20229,3,12/4/2023 22:30:17,RDC31SFJ3R,100,4581
W20229,3,13-04-2023 21:50:18,RDD24E43WU,17,4564
W20229,3,13-04-2023 21:49:08,RDD04E0UMU,100,4464
W20229,3,13-04-2023 21:47:37,RDD64DWFT8,100,4364
W20229,3,14-04-2023 22:23:42,RDE476U132,100,4264
W20229,3,14-04-2023 22:15:01,RDE876C76K,17,4247
W20229,3,15-04-2023 23:18:55,RDF9A4099R,100,4147
W20229,3,15-04-2023 23:16:19,RDF2A3WTZ8,100,4047
W20229,3,16-04-2023 22:12:28,RDG8CJ72FI,17,4030
W20229,3,16-04-2023 22:10:25,RDG0CJ34D4,100,3930
W20229,3,16-04-2023 22:08:57,RDG2CJ0920,100,3830
W20229,3,16-04-2023 08:52:49,RDG5AFVCDT,17,3813
W20229,3,17-04-2023 22:20:58,RDH6F93CMU,17,3796
W20229,3,17-04-2023 22:19:18,RDH5F90LG9,100,3696
W20229,3,17-04-2023 22:17:43,RDH5F8XABX,100,3596
W20229,3,18-04-2023 22:23:33,RDI4I03KFS,17,3579
W20229,3,18-04-2023 22:22:32,RDI3I01SB5,100,3479
W20229,3,18-04-2023 22:20:50,RDI0HZZ076,100,3379
W20229,3,19-04-2023 22:08:58,RDJ2KQVKZ0,17,3362
W20229,3,19-04-2023 22:07:01,RDJ5KQR4B7,100,3262
W20229,3,19-04-2023 21:59:42,RDJ3KQ8E4B,100,3162
W20229,3,20-04-2023 22:38:48,RDK5NOZBST,17,3145
W20229,3,20-04-2023 22:37:11,RDK0NOWK38,100,3045
W20229,3,20-04-2023 22:35:57,RDK6NOU5MC,100,2945
W20229,3,21-04-2023 21:52:39,RDL0QFMKEI,17,2928
W20229,3,21-04-2023 21:51:09,RDL3QFIBNZ,100,2828
W20229,3,21-04-2023 21:49:27,RDL4QFCTXE,100,2728
W20229,3,22-04-2023 22:51:00,RDM1T8EDO3,100,2628
W20229,3,22-04-2023 22:49:24,RDM1T8C74V,100,2528
W20229,3,22-04-2023 22:44:22,RDM8T858HQ,17,2511
W20229,3,23-04-2023 22:25:33,RDN2VMSW5E,17,2494
W20229,3,23-04-2023 22:24:03,RDN9VMQ6GN,100,2394
W20229,3,23-04-2023 22:22:52,RDN0VMOAEE,100,2294
W20229,3,24-04-2023 23:06:50,RDO6YD9050,17,2277
W20229,3,24-04-2023 23:05:06,RDO0YD6NJK,100,2177
W20229,3,24-04-2023 23:03:09,RDO8YD4BEC,100,2077
W20229,3,25-04-2023,RDP51Z7R0F,17,2060
W20229,3,25-04-2023,RDP61ZDD04,100,1960
W20229,3,25-04-2023,RDP11ZFVOP,100,1860
W20229,3,26-04-2023,RDQ24N854S,217,1643
W20229,3,27-04-2023,RDR37FR0KT,217,1426
W20229,3,28-04-2023,RDS0A5QHAW,100,1326
W20229,3,28-04-2023,RDS2A5U6YC,100,1226
W20229,3,28-04-2023,RDS3A5WPG5,17,1209
W20229,3,29-04-2023,RDT8D0Z2WQ,100,1109
W20229,3,29-04-2023,RDT3D11P6H,100,1009
W20229,3,29-04-2023,RDT3D14OWJ,17,992
W20229,3,30-04-2023,RDU9FJ34AX,100,892
W20229,3,30-04-2023,RDU7FJ4V6R,100,792
W20229,3,30-04-2023,RDU6FJ6N76,17,775
W20229,3,30-04-2023,RDU4FJ9GVO,100,675
W20229,3,30-04-2023,RDU0FJD5CQ,100,575
W20229,3,30-04-2023,RDU9FJF7ET,17,558
W20229,3,2/5/2023,RE23KXLVS5,100,458
W20229,3,2/5/2023,RE24KXO638,100,358
W20229,3,2/5/2023,RE22KXSONO,90,268
W20229,3,2/5/2023,RE27KXX7NB,100,168
W20229,3,2/5/2023,RE23KY5VTT,100,68
W20229,3,2/5/2023,RE28KYJ13G,70,2
W20229,4,4/5/23 22:06,RE45QPJK3R,17,6483
W20229,4,4/5/23 22:06,RE41QPHUWV,100,6383
W20229,4,4/5/23 22:04,RE47QPDVIT,100,6283
W20229,4,5/5/23 22:17,RE50TPRY50,100,6183
W20229,4,5/5/23 22:16,RE58TPOR30,17,6166
W20229,4,5/5/23 22:14,RE59TPKWNZ,100,6066
W20229,4,7/5/23 21:59,RE70ZCK1Y8,17,6049
W20229,4,7/5/23 21:57,RE79ZCGWVN,100,5949
W20229,4,7/5/23 21:56,RE77ZCCMVP,100,5849
W20229,4,7/5/23 5:49,RE78WX70CE,17,5832
W20229,4,7/5/23 5:47,RE73WX68Q3,100,5732
W20229,4,7/5/23 5:46,RE79WX64KJ,100,5632
W20229,4,8/5/23 22:08,RE893BQ74N,17,5615
W20229,4,8/5/23 22:06,RE883BN2PY,100,5515
W20229,4,8/5/23 22:05,RE803BJS40,100,5415
W20229,4,9/5/23 22:11,RE9669D46S,17,5398
W20229,4,9/5/23 22:10,RE99699X9N,100,5298
W20229,4,9/5/23 22:08,RE9569666R,100,5198
W20229,4,10/5/23 22:16,REA0945WRS,17,5181
W20229,4,10/5/23 22:15,REA294356K,100,5081
W20229,4,10/5/23 22:14,REA993ZUEX,100,4981
W20229,4,11/5/23 23:01,REB4BYUDNI,100,4881
W20229,4,11/5/23 23:00,REB3BYSPLT,100,4781
W20229,4,11/5/23 22:55,REB9BYM2OL,17,4764
W20229,4,12/5/23 22:45,REC3ESWJ05,100,4664
W20229,4,12/5/23 22:44,REC7ESUSHF,100,4564
W20229,4,12/5/23 22:42,REC8ESS698,100,4464
W20229,4,12/5/23 22:31,REC5ES7OON,34,4430
W20229,4,12/5/23 22:29,REC7ES4OMZ,100,4330
W20229,4,14-05-2023 22:37:26,REE3KDJGXR,17,4313
W20229,4,14-05-2023 22:36:12,REE5KDHFS7,100,4213
W20229,4,14-05-2023 22:34:56,REE5KDFFZH,100,4113
W20229,4,15-05-2023 22:20:54,REF5N5VX7B,100,4013
W20229,4,15-05-2023 22:13:53,REF3N5HLZ7,17,3996
W20229,4,15-05-2023 22:12:22,REF3N5E28B,100,3896
W20229,4,16-05-2023 22:11:29,REG2PW72SI,17,3879
W20229,4,16-05-2023 22:09:54,REG9PW4HH9,100,3779
W20229,4,16-05-2023 22:08:54,REG9PW1SS5,100,3679
W20229,4,17-05-2023 21:59:10,REH3SM5N0P,17,3662
W20229,4,17-05-2023 21:57:35,REH0SM0TWO,100,3562
W20229,4,17-05-2023 21:55:52,REH6SLWIY8,100,3462
W20229,4,18-05-2023 22:50:54,REI3VHUXCF,17,3445
W20229,4,18-05-2023 22:49:37,REI3VHT7OZ,100,3345
W20229,4,18-05-2023 22:48:02,REI8VHR5GW,100,3245
W20229,4,19-05-2023 22:02:24,REJ0Y7W6YC,17,3228
W20229,4,19-05-2023 22:00:56,REJ5Y7SQE1,100,3128
W20229,4,19-05-2023 21:59:33,REJ5Y7P3BP,100,3028
W20229,4,20-05-2023 22:08:10,REK823YMAM,100,2928
W20229,4,20-05-2023 22:06:00,REK923T1U9,100,2828
W20229,4,20-05-2023 22:02:44,REK423KESW,17,2811
W20229,4,21-05-2023 21:31:31,REL54M1SQ9,17,2794
W20229,4,21-05-2023 21:29:15,REL04LVV8A,100,2694
W20229,4,21-05-2023 21:27:31,REL24LQQ78,100,2594
W20229,4,22-05-2023 22:02:46,REM27FG05Y,17,2577
W20229,4,22-05-2023 22:01:01,REM87FCFKO,100,2477
W20229,4,22-05-2023 21:59:37,REM57F9667,100,2377
W20229,4,23-05-2023 22:50:10,REN4A7B8VC,100,2277
W20229,4,23-05-2023 22:48:37,REN8A79C9G,100,2177
W20229,4,23-05-2023 22:47:24,REN1A77OZ3,17,2160
W20229,4,24-05-2023 21:44:08,REO0CTUI7O,17,2143
W20229,4,24-05-2023 21:43:15,REO1CTRXMD,100,2043
W20229,4,24-05-2023 21:42:11,REO1CTOFNX,100,1943
W20229,4,25-05-2023 21:34:32,REP5FKSQAL,17,1926
W20229,4,25-05-2023 21:32:28,REP9FKLV0H,100,1826
W20229,4,25-05-2023 21:31:09,REP1FKI3OV,100,1726
W20229,4,26-05-2023 22:16:26,REQ4IJCVTK,17,1709
W20229,4,26-05-2023 22:15:00,REQ7IJ9X3F,100,1609
W20229,4,26-05-2023 22:13:25,REQ5IJ68J5,100,1509
W20229,4,27-05-2023,RER4LFKRTC,17,1492
W20229,4,27-05-2023,RER3LFTSUF,100,1392
W20229,4,27-05-2023,RER1LFWH6P,100,1292
W20229,4,28-05-2023,RES5NTEW8J,100,1192
W20229,4,28-05-2023,RES6NTN83A,100,1092
W20229,4,28-05-2023,RES7NTUU8R,17,1075
W20229,4,29-05-2023,RET7QTF84F,100,975
W20229,4,29-05-2023,RET8QTH1U0,100,875
W20229,4,29-05-2023,RET0QTJBWS,17,858
W20229,4,30-05-2023,REU1TN84HZ,100,758
W20229,4,30-05-2023,REU9TNASDB,100,658
W20229,4,30-05-2023,REU0TNCXLM,17,641
W20229,4,31-05-2023,REV6WGBOAI,100,541
W20229,4,31-05-2023,REV8WGHFWQ,100,441
W20229,4,31-05-2023,REV3WGKI1V,17,424
W20229,4,6/2/2023,RF223F79T4,100,324
W20229,4,6/2/2023,RF263FB0BQ,100,224
W20229,4,6/2/2023,RF273FE1OZ,100,124
W20229,4,6/2/2023,RF203FHVJA,100,24
W20229,4,6/2/2023,RF263FOJCS,24,0
W20229,5,18-06-2023 21:39:26,RFI1EEGL79,60,7740
W20229,5,18-06-2023 21:37:12,RFI5EE9S87,100,7640
W20229,5,18-06-2023 21:35:57,RFI7EE648B,100,7540
W20229,5,17-06-2023 22:26:36,RFH8BVNZJO,60,7480
W20229,5,17-06-2023 22:25:08,RFH8BVKUBU,100,7380
W20229,5,17-06-2023 22:14:57,RFH0BUZDMO,100,7280
W20229,5,16-06-2023 22:10:30,RFG68Y75XY,60,7220
W20229,5,16-06-2023 22:09:10,RFG18Y47TJ,100,7120
W20229,5,16-06-2023 22:05:58,RFG88XVMRC,100,7020
W20229,5,15-06-2023 22:40:37,RFF562KZ7F,60,6960
W20229,5,15-06-2023 22:37:22,RFF962F6G9,100,6860
W20229,5,15-06-2023 22:34:02,RFF162946J,100,6760
W20229,5,14-06-2023 21:31:26,RFE732PS45,60,6700
W20229,5,14-06-2023 21:29:57,RFE032L07C,100,6600
W20229,5,14-06-2023 21:26:35,RFE232B02Y,100,6500
W20229,5,13-06-2023 21:44:23,RFD1ZB90LP,60,6440
W20229,5,13-06-2023 21:39:22,RFD6ZAUO34,100,6340
W20229,5,13-06-2023 21:36:34,RFD0ZAM2BA,100,6240
W20229,5,12/6/23 23:22,RFC1WMEJGD,60,6180
W20229,5,12/6/23 23:20,RFC6WMC9B0,100,6080
W20229,5,12/6/23 23:19,RFC0WMAPCO,100,5980
W20229,5,11/6/23 21:44,RFB4TMQ4BM,60,5920
W20229,5,11/6/23 21:40,RFB9TMF2BP,100,5820
W20229,5,11/6/23 21:38,RFB1TM8HNR,100,5720
W20229,5,10/6/23 22:21,RFA1R0FNX3,60,5660
W20229,5,10/6/23 22:18,RFA7R0BBMV,100,5560
W20229,5,10/6/23 22:10,RFA5QZQ3Q9,100,5460
W20229,5,9/6/23 22:02,RF92NXMCVQ,60,5400
W20229,5,9/6/23 22:01,RF91NXJ5WT,100,5300
W20229,5,9/6/23 21:59,RF93NXGNAN,100,5200
W20229,5,8/6/23 22:53,RF86L0O0Y2,60,5140
W20229,5,8/6/23 22:52,RF87L0M9NR,100,5040
W20229,5,8/6/23 22:51,RF85L0KNSX,100,4940
W20229,5,7/6/23 21:36,RF72HWWRCM,60,4880
W20229,5,7/6/23 21:35,RF70HWPZRY,100,4780
W20229,5,7/6/23 21:33,RF78HWLTBS,100,4680
W20229,5,6/6/23 21:53,RF63F0Q1KL,60,4620
W20229,5,6/6/23 21:52,RF66F0MF40,100,4520
W20229,5,6/6/23 21:50,RF69F0HYAD,100,4420
W20229,5,5/6/23 21:52,RF54C2CPKI,60,4360
W20229,5,5/6/23 21:50,RF51C288PL,100,4260
W20229,5,5/6/23 21:48,RF57C22WT5,100,4160
W20229,5,4/6/23 18:16,RF428CDUJU,60,4100
W20229,5,4/6/23 18:15,RF428C6U6A,100,4000
W20229,5,4/6/23 18:13,RF438BW88L,100,3900
W20229,5,3/6/23 21:38,RF326BOOX4,60,3840
W20229,5,3/6/23 21:37,RF366BLMLK,100,3740
W20229,5,3/6/23 21:35,RF356BFPY9,100,3640
W20229,5,19/06/2023,RFJ5H8ZP87,100,3540
W20229,5,19/06/2023,RFJ6H93KQQ,100,3440
W20229,5,19/06/2023,RFJ5H96WUB,60,3380
W20229,5,20-06-2023 23:13:05,RFK6K5SS4Q,100,3280
W20229,5,20-06-2023 23:11:30,RFK8K5QT8A,100,3180
W20229,5,20-06-2023 23:10:05,RFK8K5PKUI,60,3120
W20229,5,21-06-2023 22:21:01,RFL8MXGBHO,100,3020
W20229,5,21-06-2023 22:19:34,RFL9MXDTKH,100,2920
W20229,5,21-06-2023 22:16:47,RFL3MX7NKD,60,2860
W20229,5,22-06-2023 22:57:34,RFM1PV0P9L,100,2760
W20229,5,22-06-2023 22:52:31,RFM7PUTEHH,100,2660
W20229,5,22-06-2023 22:50:32,RFM1PUR2L1,60,2600
W20229,5,23-06-2023,RFN7SRH3JX,100,2500
W20229,5,23-06-2023,RFN5SRK7NF,100,2400
W20229,5,23-06-2023,RFN6SRONMC,60,2340
W20229,5,24-06-2023,RFO4VRGEUQ,100,2240
W20229,5,24-06-2023,RFO0VRK6KG,100,2140
W20229,5,24-06-2023,RFO2VRO528,60,2080
W20229,5,25-06-2023,RFP4YBQ5OY,100,1980
W20229,5,25-06-2023,RFP6YBTS8Q,100,1880
W20229,5,25-06-2023,RFP7YC4RV9,60,1820
W20229,5,26-06-2023,RFQ02ABK16,100,1720
W20229,5,26-06-2023,RFQ42AF7Z0,100,1620
W20229,5,26-06-2023,RFQ82AM1HG,60,1560
W20229,5,27-06-2023,RFR859IAVA,100,1460
W20229,5,27-06-2023,RFR459Q3QU,100,1360
W20229,5,27-06-2023,RFR259S884,60,1300
W20229,5,28-06-2023,RFS2826Y98,100,1200
W20229,5,28-06-2023,RFS682BE1A,100,1100
W20229,5,28-06-2023,RFS982DSO9,60,1040
W20229,5,29-06-2023,RFT5AX085J,100,940
W20229,5,29-06-2023,RFT8AX4ZP6,100,840
W20229,5,29-06-2023,RFT5AX8V7B,60,780
W20229,5,30-06-2023,RFU6E0PMCI,100,680
W20229,5,30-06-2023,RFU3E0T6BN,100,580
W20229,5,30-06-2023,RFU8E0Z4T6,60,520
W20229,5,1/7/2023,RG12H2PME2,100,420
W20229,5,1/7/2023,RG13H2TQ0T,100,320
W20229,5,1/7/2023,RG13H39U09,60,260
W20229,5,2/7/2023,RG27JUNOCT,100,160
W20229,5,2/7/2023,RG26JUR80C,100,60
W20229,5,2/7/2023,RG27JUSN25,60,0
W20229,6,30-07-2023 21:14:54,RGU7TYJ5XH,60,7740
W20229,6,30-07-2023 21:13:28,RGU3TYDRMN,100,7640
W20229,6,30-07-2023 21:12:01,RGU8TY8M4Q,100,7540
W20229,6,29-07-2023 22:05:28,RGT0RDLI3S,100,7440
W20229,6,29-07-2023 22:04:39,RGT2RDJ6R0,60,7380
W20229,6,29-07-2023 22:03:57,RGT0RDGZKE,100,7280
W20229,6,28-07-2023 21:54:29,RGS1ODWFZR,60,7220
W20229,6,28-07-2023 21:53:36,RGS1ODTH21,100,7120
W20229,6,27-07-2023 21:48:04,RGR6LEQJO2,60,7060
W20229,6,27-07-2023 21:46:35,RGR2LEKBWY,100,6960
W20229,6,27-07-2023 21:44:57,RGR9LED88F,100,6860
W20229,6,26-07-2023 22:44:03,RGQ9IMEKY1,60,6800
W20229,6,26-07-2023 22:41:51,RGQ1IMAXAN,100,6700
W20229,6,26-07-2023 22:39:41,RGQ7IM6BZP,100,6600
W20229,6,25-07-2023 21:56:14,RGP3FNCRX3,60,6540
W20229,6,25-07-2023 21:54:45,RGP9FN85MB,100,6440
W20229,6,25-07-2023 21:53:34,RGP8FN4QVO,100,6340
W20229,6,24-07-2023 21:47:10,RGO9CSP7KH,60,6280
W20229,6,24-07-2023 21:46:04,RGO1CSLUIH,100,6180
W20229,6,24-07-2023 21:44:51,RGO8CSI7IK,100,6080
W20229,6,23-07-2023 22:01:55,RGN0A0PUP0,60,6020
W20229,6,23-07-2023 22:00:01,RGN9A0LDEV,100,5920
W20229,6,23-07-2023 21:58:19,RGN9A0HGNN,100,5820
W20229,6,22-07-2023 22:46:47,RGM97I45P5,100,5720
W20229,6,22-07-2023 22:46:03,RGM67I3GAM,60,5660
W20229,6,22-07-2023 22:45:33,RGM77I24V5,100,5560
W20229,6,21-07-2023 22:01:14,RGL64I3178,100,5460
W20229,6,21-07-2023 22:00:18,RGL54I0SM3,60,5400
W20229,6,21-07-2023 21:58:28,RGL34HW2NZ,100,5300
W20229,6,20-07-2023 21:41:26,RGK71OHJ8N,60,5240
W20229,6,20-07-2023 21:40:22,RGK71OE03P,100,5140
W20229,6,20-07-2023 21:38:33,RGK41O8K1U,100,5040
W20229,6,19-07-2023 21:58:27,RGJ7Y063BD,60,4980
W20229,6,19-07-2023 21:57:21,RGJ5Y03MI3,100,4880
W20229,6,19-07-2023 21:54:44,RGJ9XZX431,100,4780
W20229,6,18-07-2023 22:24:53,RGI0VG4MK2,60,4720
W20229,6,18-07-2023 22:23:33,RGI9VG21SB,100,4620
W20229,6,18-07-2023 22:22:28,RGI5VFZ7JD,100,4520
W20229,6,17-07-2023 22:34:08,RGH1SK91FX,60,4460
W20229,6,17-07-2023 22:32:24,RGH9SK5M63,100,4360
W20229,6,17-07-2023 22:30:29,RGH5SK1REF,100,4260
W20229,6,16-07-2023 22:41:05,RGG2PN9GVS,60,4200
W20229,6,16-07-2023 22:39:28,RGG9PN6Q59,100,4100
W20229,6,16-07-2023 22:38:00,RGG6PN4K2M,100,4000
W20229,6,15-07-2023 21:55:37,RGF6MXB32A,100,3900
W20229,6,15-07-2023 21:54:50,RGF3MX8SB1,60,3840
W20229,6,15-07-2023 21:52:45,RGF5MX27PV,100,3740
W20229,6,14-07-2023 22:26:59,RGE4JZFQUY,60,3680
W20229,6,14-07-2023 22:25:28,RGE2JZCTJI,100,3580
W20229,6,14-07-2023 22:21:44,RGE9JZ4HEP,100,3480
W20229,6,13-07-2023 21:58:16,RGD3GZMZ2X,60,3420
W20229,6,13-07-2023 21:57:11,RGD9GZK0N5,100,3320
W20229,6,13-07-2023 21:55:01,RGD3GZE8PF,100,3220
W20229,6,12/7/23 21:55,RGC3E2NCLL,60,3160
W20229,6,12/7/23 21:53,RGC2E2JDZY,100,3060
W20229,6,12/7/23 21:52,RGC1E2FK2X,100,2960
W20229,6,11/7/23 22:29,RGB2BE9OOK,60,2900
W20229,6,11/7/23 22:27,RGB3BE77VD,100,2800
W20229,6,11/7/23 22:26,RGB5BE5A69,100,2700
W20229,6,10/7/23 21:45,RGA78DSJLN,60,2640
W20229,6,10/7/23 21:43,RGA88DNDB0,100,2540
W20229,6,10/7/23 21:42,RGA68DJU24,100,2440
W20229,6,9/7/23 22:21,RG995ID413,100,2340
W20229,6,9/7/23 22:20,RG995IAJ8T,60,2280
W20229,6,9/7/23 22:19,RG935I84HB,100,2180
W20229,6,8/7/23 22:13,RG852SFCPD,60,2120
W20229,6,8/7/23 22:11,RG862SA7MC,100,2020
W20229,6,8/7/23 22:09,RG872S53KT,100,1920
W20229,6,7/7/23 22:25,RG78YTGVOY,60,1860
W20229,6,7/7/23 22:24,RG71YTEP1X,100,1760
W20229,6,7/7/23 22:19,RG70YT4NZA,100,1660
W20229,6,6/7/23 22:59,RG65VYC823,60,1600
W20229,6,6/7/23 22:57,RG64VY9XN4,100,1500
W20229,6,6/7/23 22:56,RG69VY8E25,100,1400
W20229,6,5/7/23 22:12,RG52SW00GQ,60,1340
W20229,6,5/7/23 22:10,RG53SVWSH7,100,1240
W20229,6,5/7/23 22:09,RG52SVSLNQ,100,1140
W20229,6,8/1/2023,RH1311Y237,100,1040
W20229,6,8/1/2023,RH1712265L,100,940
W20229,6,8/1/2023,RH19126RHV,60,880
W20229,6,8/2/2023,RH2241F2EG,100,780
W20229,6,8/2/2023,RH2941HR19,100,680
W20229,6,8/2/2023,RH2741KPH5,60,620
W20229,6,8/3/2023,RH356ZEUH3,1000,380
W20229,6,8/3/2023,RH386ZJGXY,100,480
W20229,6,8/3/2023,RH346ZOT0A,40,520
W20229,7,7/8/2023 22:18,RH73J22HUN,60,7740
W20229,7,7/8/23 22:16,RH76J1X9WW,100,7640
W20229,7,7/8/23 22:14,RH75J1RXVJ,100,7540
W20229,7,10/8/23 23:05,RHA3S8K91H,100,7440
W20229,7,10/8/23 23:04,RHA9S8IYBZ,60,7380
W20229,7,10/8/23 23:04,RHA1S8IE3P,100,7280
W20229,7,9/8/23 22:57,RH96P7BEM2,100,7180
W20229,7,9/8/23 22:56,RH90P79Y32,60,7120
W20229,7,9/8/23 22:55,RH98P77Q5I,100,7020
W20229,7,8/8/23 22:17,RH83M3EMMF,60,6960
W20229,7,8/8/23 22:15,RH88M3B0DO,100,6860
W20229,7,8/8/23 22:13,RH81M35LFZ,100,6760
W20230,1,2/11/2023,RBB3FVUAQB,"1519",6381
W20231,1,3/10/2023,RCA5GGAN0Z,"1750",5050
W20231,1,3/10/2023,RCA5GIHVWV,"5000",50
W20231,1,3/10/2023,RCA7GKIE6N,50,0
W20232,1,31-03-2023,RCV33NNXBP,"1650",4850
W20232,1,7/4/23 21:13,RD72NDDU8A,"1600",3250
W20232,1,14-04-2023,RDE871CNKK,"1000",2250
W20232,1,4/15/2023,RDF77DYW9R,375,1875
W20232,1,4/15/2023,RDF980OU4X,250,1625
W20232,1,4/21/2023,RDL6OS1DGE,1625,0
W20232,2,5/1/2023,RE18GFBGVY,"3250",3250
W20232,2,5/17/2023,REH3QK24ZB,"3250",0
W20232,3,6/5/2023,190005,"5700",0
W20232,4,7/5/2023,RG57QORZ73,"2000",4350
W20232,4,7/17/2023,RGH2QE6LKU,"4350",0
W20232,5,7/28/2023,RGS1MCCG0J,"1350",4450
W20232,5,7/31/2023,RGV6VRI26C,"4150",300
W20232,5,7/31/2023,RGV7VS3BYF,300,0
W20233,1,4/21/2023,RDL2OCFVL4,"1625",4875
W20233,1,4/28/2023,RDS189E83J,"1625",3250
W20233,1,5/6/2023,RE69V0DH5N,"1625",1625
W20233,1,5/12/2023,REC8CB0YLK,"1625",0
W20233,2,5/19/2023,REJ8Y7UYK8,"1625",4875
W20233,2,6/3/2023,RF394OMNHT,"3250",1625
W20233,2,6/9/2023,RF99M8PXCT,"1625",0
W20233,3,6/23/2023,RFN1SVHMXZ,"3250",3550
W20233,3,7/8/2023,RG87ZJTXUV,"1700",1850
W20233,3,0710/2023,RGA36U61WD,"1550",300
W20233,3,7/14/2023,RGE3I3XD1F,300,0
W20233,4,8/11/2023,RHB1V6Y0WN,"4000",2800
W20233,4,8/15/2023,RHF464FEJG,"2500",300
W20233,4,8/15/2023,RHF16CD415,300,0
W20234,1,,,"3000",10600
W20234,1,5/29/2023,RET9PYQ1OJ,"1000",9600
W20234,1,8/1/2023,RH15YZIVDT,"3000",6600
W20235,1,5/13/2023,RED2FG940S,"12500",0
W20235,2,6/7/2023,RF72FQVINO,"12600",0
W20235,3,7/6/2023,RG67UW4H5T,"13000",0
W20235,4,8/9/2023,RH93NJ5ML3,"16320",0
W20236,1,6/28/2023,RFS385GVHV,"3250",10350
W20236,1,7/20/2023,RGK511AJHH,500,9850
W20236,1,7/21/2023,RGL62LMDU8,"9850",0
W20237,1,6/27/2023,RFR44PDUIY,"2000",11000
W20237,1,6/28/2023,RFS76XWDYJ,"1250",9750
W20237,1,7/6/2023,RG61TYD2UN,"3250",6500
W20237,1,7/12/2023,RGC5BUVW7J,"3250",3250
W20237,1,7/14/2023,RGE7HIQ04R,3250,0
W20237,2,8/5/2023,RH53B5ONAZ,"3000",10600
W20238,1,6/29/2023,RFT2A0V3NK,425,13175
W20238,1,6/30/2023,RFU6CQHNU8,250,12925
W20238,1,7/1/2023,RG17GNH5N3,425,12500
W20238,1,7/2/2023,RG27JM50NX,425,12075
W20238,1,7/3/2023,RG32LS6W1E,425,11650
W20238,1,7/4/2023,RG47PYXT1Z,300,11350
W20238,1,7/5/2023,RG58SXIBVW,300,11050
W20238,1,7/10/2023,RGA07G44FY,430,10620
W20238,1,7/13/2023,RGD4H426SW,250,10370
W20238,1,7/18/2023,RGI6VI8X24,280,10090
W20238,1,7/20/2023,RGK9ZXIRV5,250,9840
W20238,1,7/21/2023,RGL82XVBFQ,9850,10
W20238,2,7/24/2023,RGO2CXNJD2,300,12700
W20238,2,8/1/2023,RH15XVZD35,450,12250
W20238,2,8/3/2023,RH307476NS,300,11950
W20239,1,6/29/2023,RFT08HVG2G,"3450",10150
W20239,1,7/27/2023,RGR9JGHSXB,500,9650
W20240,1,6/29/2023,RFT19KQIOT,"2550",10450
W20240,1,6/30/2023,RFU8BVCJKK,700,9750
W20240,1,7/6/2023,RG60VTG7O8,"2500",7250
W20240,1,7/9/2023,RG945G2WJU,750,6500
W20240,1,7/16/2023,RGG4PKSVF0,2550,3950
W20240,1,7/19/2023,RGJ9Y01DWT,1200,2750
W20240,1,7/20/2023,RGK2YDKPXC,2750,0
W20240,2,7/30/2023,RGU0TY653I,"2000",11000
W20240,2,8/9/2023,RH95P2RGGT,"4000",7000
W20240,2,8/14/2023,RHE32WZ0I1,"2000",5000
W20241,1,8/3/2023,RH336FTMSX,800,6500
W20241,1,8/4/2023,RH429Q1Q7S,"1000",5500
W20242,1,7/6/2023,RG65VMG7G3,220,6580
W20243,1,7/7/2023,RG79YQE0EV,310,9210
W20243,1,7/9/2023,RG915FQVWR,310,8900
W20243,1,7/10/2023,RGA08ESJQ0,310,8590
W20243,1,7/11/2023,RGB2BH309C,310,8280
W20244,1,7/10/2023,RGA35UXVHH,220,6580
W20244,1,7/13/2023,RGD0EGYJ98,220,6360
W20245,1,7/19/2023,RGJ5W2W4B9,"3250",10350
W20246,1,7/14/2023,RGE1K00XLR,500,13100
W20246,1,7/17/2023,RGH9SM2X1X,500,12600
W20246,1,7/19/2023,RGJ2XVI7LC,"1000",11600
W20246,1,7/22/2023,RGM966QL4V,500,11100
W20247,1,7/17/2023,RGH2QX2XZI,850,12150
W20247,1,7/19/2023,RGJ0W0YR8Y,440,11710
W20247,1,7/25/2023,RGP7E1U7S7,500,11210
W20247,1,7/31/2023,RGV1UTURJB,800,10410
W20247,1,8/5/2023,RH56D4RIG8,1000,9410
W20248,1,7/18/2023,RGI7UX1ZKD,440,12560
W20248,1,7/19/2023,RGJ7XUN349,440,12120
W20248,1,7/20/2023,RGK01I9PFC,440,11680
W20248,1,7/21/2023,RGL84KGPQ2,440,11240
W20248,1,7/24/2023,RGO0CMNXKU,500,10740
W20248,1,7/28/2023,RGS6O2L554,640,10100
W20248,1,8/1/2023,RH17XWQ0YH,2000,8100
W20248,1,8/3/2023,RH35759YBT,650,7450
W20249,1,7/24/2023,RGO1B6BX69,"2000",6190
W20249,1,7/31/2023,RGV7X01887,"2500",3690
W20249,1,8/1/2023,RH19Y5OISZ,"3690",0
W20250,1,7/20/2023,RGK3ZPVZZ7,180,5020
W20250,1,7/21/2023,RGL947QRB9,180,4840
W20250,1,8/2/2023,RH2440274W,90,4750
W20250,1,8/2/2023,RH23405FZT,40,4710
W20250,1,8/5/2023,RH57COM5C7,800,3910
W20250,1,8/10/2023,RHA2S65508,280,3630